TGTGCGAGAGAGAAAAAAGGAATGAAGAGATATAGTGGCTACGGTCGGCAAATGCCTTTCGACCCCTGG	CAREKKGMKRYSGYGRQMPFDPW	IGHV1-2	IGHJ5
TGTACTCATGTGTTAGTGGTGGTAGCTGCTACTCCCGGTCAGAACAGGTTTGACTACTGG	CTHVLVVVAATPGQNRFDYW	IGHV3-9	IGHJ4
TGTGCGAGACAGGGGAGCTACTACTCGGTTGACTACTGG	CARQGSYYSVDYW	IGHV4-34	IGHJ4
TGTGCGAAAGATTCTCTAGTGGTGGTAGCTGCTCCTCGCTACTTTGACTACTGG	CAKDSLVVVAAPRYFDYW	IGHV3-23	IGHJ4
TGTGCGAGAGAGTTGTTGAATATTGTAGTAGTACCAGCTGCTCCAGACTACTGG	CARELLNIVVVPAAPDYW	IGHV3-20	IGHJ4
TGTGCGAGAAGCTACCGTATTGTGGTGGTGACTCACGCTTTTGATATCTGG	CARSYRIVVVTHAFDIW	IGHV1-2	IGHJ3
TGTGCGAGGTTGGGCCGCTTTGACTACTGG	CARLGRFDYW	IGHV1-2	IGHJ4
TGTGCAAGAGATGGGGGGACCCTTGTAGTAGTACCAGCGCCCTCGTCGTCTCCATATTACTACTACTACTACTACATGGACGTCTGG	CARDGGTLVVVPAPSSSPYYYYYYYMDVW	IGHV3-13	IGHJ6
TGTGCGAGCCCCATTGTAGTAGTACCAGCTGCTATACCCATGAAGGGGGACTACTGG	CASPIVVVPAAIPMKGDYW	IGHV3-20	IGHJ4
TGTGCGAATAACAGACAGGCCGCGGGAGCCTATGATTACATTTGGGGGAGTTACCACTACTGG	CANNRQAAGAYDYIWGSYHYW	IGHV3-23	IGHJ4
TGTGCGAGAGCTATGCTAGAGAGTTCGGGTAGCAGTGGCTGGTACGGGGACAGGTTCGACCCCTGG	CARAMLESSGSSGWYGDRFDPW	IGHV3-30	IGHJ5
TGTGCGAAAGGTATTACGATTTTTGGAGTGGTTATTACCCATGATGCTTTTGATATCTGG	CAKGITIFGVVITHDAFDIW	IGHV3-23	IGHJ3
TGTGCGAGACTCTCGAGTATAGCAGCCCCCTCTGACTGG	CARLSSIAAPSDW	IGHV7-4-1	IGHJ4
TGTGCACGGATACGGATTCTCCCCTACTACTTTGACTACTGG	CARIRILPYYFDYW	IGHV2-70	IGHJ4
TGTGCGGGAGTGATACCAGCTGCTATACTTGTGTCAGACTACTACTACTACATGGACGTCTGG	CAGVIPAAILVSDYYYYMDVW	IGHV1-69	IGHJ6
TGTGCGAGAATGCAAGTGGGAGCTACTCCCCGGTACGGCGTTACGCCTCCCTCCGTGGTTAATGATGCTTTTGATATCTGG	CARMQVGATPRYGVTPPSVVNDAFDIW	IGHV4-61	IGHJ3
TGTACTAGGAGGACCGAGGGTACTTGTTTTAAAATATGGCCTTGTGGTGGTGACTGCTATTACCATTCCTGG	CTRRTEGTCFKIWPCGGDCYYHSW	IGHV3-49	IGHJ4
TGTGCAAGAGGTGGTATTGTAGTGGTGGTAGCTGCTACAAGCCTTCTTAACTATGCCCGGGAGGGATACTTTGACTACTGG	CARGGIVVVVAATSLLNYAREGYFDYW	IGHV3-13	IGHJ4
TGTACGGGGGTATTTAGTGGTGGTAGCTGCTACGCCTACTACTACTACTACTACATGGACGTCTGG	CTGVFSGGSCYAYYYYYYMDVW	IGHV3-9	IGHJ6
TGTACTAGAGTAAAACTAGGCATAGCAGTGGCTGGTACGGGAAATGACTACTGG	CTRVKLGIAVAGTGNDYW	IGHV3-49	IGHJ4
TGTGCGAGACATTCCTTTACCCGGGCCAGCTATGGTTACGCGCGGGGCTGGTACTTCGATCTCTGG	CARHSFTRASYGYARGWYFDLW	IGHV4-39	IGHJ2
TGTGCGAGATGCGAGAGCGGGGGGGACTACTTTGACTACTGG	CARCESGGDYFDYW	IGHV5-51	IGHJ4
TGTGCGAATTCAATACGGTATTACGATTTTTGGAGTGGTTATGGTCCTGTAGGGGGGGCCCGGATAGACTACTGG	CANSIRYYDFWSGYGPVGGARIDYW	IGHV3-23	IGHJ4
TGTAGGGCACGTATTACTATGATAGTAGTGGTTATTACTACGTGGGACGACTGGTACTTCGATCTCTGG	CRARITMIVVVITTWDDWYFDLW	IGHV3-30-3	IGHJ2
TGTGCGAGACTCTATTACTATGATAGTAGTGGAGGGTACTGG	CARLYYYDSSGGYW	IGHV3-20	IGHJ4
TGTGCAAGAACCGTTAGTACCAGCTGCTATGGTCCCTTTGACTACTGG	CARTVSTSCYGPFDYW	IGHV3-74	IGHJ4
TGTGCGAGATCGGAGGCCGGGTATAGCAGTGGCTGGCTCAAAGACTACTACTACTACTACATGGACGTCTGG	CARSEAGYSSGWLKDYYYYYMDVW	IGHV1-2	IGHJ6
TGTGCGAAACCCATAGTGGCTACGATTAACTTCCGGCAAACGCTCAACTACTTTGACTACTGG	CAKPIVATINFRQTLNYFDYW	IGHV5-10-1	IGHJ4
TGTGCGAAAGCCACCCAGGGTGGTGGTAGCTGCTACTCCGAGGAACGGTACTTTGACTACTGG	CAKATQGGGSCYSEERYFDYW	IGHV3-NL1	IGHJ4
TGTGCGAGAGATTGCCGAGTACCAGCTGCTATCTGGTTCGACCCCTGG	CARDCRVPAAIWFDPW	IGHV4-59	IGHJ5
TGTGCGAGATCGCTAGTGGTGGTAGCTGCTACCAGGAACTACATGGACGTCTGG	CARSLVVVAATRNYMDVW	IGHV1-2	IGHJ6
TGTGCGAGAGATCCTACGATTTTTGGAGACGACTACTACTACTACATGGACGTCTGG	CARDPTIFGDDYYYYMDVW	IGHV1-2	IGHJ6
TGTGCAAGAGATCGCGTGGCTTTGACATTGTACTGGTGGTGTATGCTATCCACCGCCCACTACTACTACTACTACATGGACGTCTGG	CARDRVALTLYWWCMLSTAHYYYYYMDVW	IGHV3-74	IGHJ6
TGTGCGAGTGGCGCTAAGGGTTATTGTAGTGGTGGTAGCTGGGGGTTTGACTACTGG	CASGAKGYCSGGSWGFDYW	IGHV4-39	IGHJ4
TGTGCGAGAGAGCTTGGAAACAAGTGGGAGCTACTTACACGCGGGGACAGGTTTGACTACTGG	CARELGNKWELLTRGDRFDYW	IGHV3-7	IGHJ4
TGTGCGAGGGGGGCCATAGCAGCAGCTGGTAGACGGGCCTACTGG	CARGAIAAAGRRAYW	IGHV1-18	IGHJ4
TGTGCGAGAGAAAGAGATCGACCTATTACGATTTTTGGAGTGGTTATTATGTCTCTTATCCAGCAAGGGGATGGCTTTGACTACTGG	CARERDRPITIFGVVIMSLIQQGDGFDYW	IGHV3-21	IGHJ4
TGTGCGAAAAAAGGCCCTATTGTAGTAGTACCAGCTGCTATTTTAGGATATTCCAAAACTCCAGGTCCCTGG	CAKKGPIVVVPAAILGYSKTPGPW	IGHV3-NL1	IGHJ5
TGTGCGAGACATTCGTACCGATATTTTGACTGGTTAGGGAGTTACTACATGGACGTCTGG	CARHSYRYFDWLGSYYMDVW	IGHV4-39	IGHJ6
TGTGCGAGAGCTTGGATACAGCTATGGTTCTCGGCTAACTGGTTCGACCCCTGG	CARAWIQLWFSANWFDPW	IGHV4-61	IGHJ5
TGTGCGAAGGTTGGTATACAGCTACAGGGTGGCCGCTACTGG	CAKVGIQLQGGRYW	IGHV3-NL1	IGHJ4
TGTGCGAAAGATGTTTTTGGAGTGGTTATTATATCTGCAAAGAAGAACTACTACTACTACATGGACGTCTGG	CAKDVFGVVIISAKKNYYYYMDVW	IGHV3-NL1	IGHJ6
TGTGCGAACCGATGTTATAGCAGTGGCTGGTACTCGAAACTCTACTACTGG	CANRCYSSGWYSKLYYW	IGHV3-NL1	IGHJ4
TGTACCACAGATTATGATTACATTTGGGGGAGTTATCGTTATACCGTGGTTAACTACTACTACTACTACATGGACGTCTGG	CTTDYDYIWGSYRYTVVNYYYYYMDVW	IGHV3-15	IGHJ6
TGTGCGAGGATACCGGCTTTTTTTGGAGTGGTTAAGAACCGGCTTGACTACTGG	CARIPAFFGVVKNRLDYW	IGHV1-3	IGHJ4
TGTGCGAGAGAGGACGTATTACTATGGTTCGGGGAGATGTACAACTGGTTCGACCCCTGG	CAREDVLLWFGEMYNWFDPW	IGHV1-18	IGHJ5
TGTGCGGAGTTCCCCCCGGGAGGGGTATTACTATGGTTCAGGTTCCCGCAACATTACTACTACTACTACTACATGGACGTCTGG	CAEFPPGGVLLWFRFPQHYYYYYYMDVW	IGHV4-59	IGHJ6
TGTGCGAGCCGATATAGCAGGTTGCAATTTTGCGGGGGGGCTAACTGGTTCGACCCCTGG	CASRYSRLQFCGGANWFDPW	IGHV4-59	IGHJ5
TGTGCGAGATCCCCACATATTGTGGTGGTGATTGCTAGTTACTTTGACTACTGG	CARSPHIVVVIASYFDYW	IGHV1-18	IGHJ4
TGTGCGAAAGGTCTAGGAAGGGACAAGGGGGAGTTGTGTCGATACTACTTTGACTACTGG	CAKGLGRDKGELCRYYFDYW	IGHV3-23	IGHJ4
TGTACTAGAGAGCGATATTGTAGTGGTGGTAGCTGCTACGAACTGCGCTACTACTACTACTACATGGACGTCTGG	CTRERYCSGGSCYELRYYYYYMDVW	IGHV3-49	IGHJ6
TGTGCGAAATCTACGTGGCTGGTACGCCACGTGGCTTTTGATATCTGG	CAKSTWLVRHVAFDIW	IGHV3-NL1	IGHJ3
TGTGCACACAAGGCGGGGATAGTAGTGGTTACCCCCTTCTGCTACTTTGACTACTGG	CAHKAGIVVVTPFCYFDYW	IGHV2-5	IGHJ4
TGTGCGAGAGTGTCCCCCTTACGATTTTTGGAGTGGTTATTATCTTATTACTACTACTACTACTACATGGACGTCTGG	CARVSPLRFLEWLLSYYYYYYYMDVW	IGHV3-53	IGHJ6
TGTACCACAGATGACCGTCGAACGGGATATTGTAGACTCTACTACATGGACGTCTGG	CTTDDRRTGYCRLYYMDVW	IGHV3-15	IGHJ6
TGTGCGAAAGATGGGAGAGAAGACTACAATTGTAGTAGTACCAGCTGCTATCCCCGCAATGACTACTGG	CAKDGREDYNCSSTSCYPRNDYW	IGHV3-23	IGHJ4
TGTGCGAGAGCTTACTATGGTTCGGGGAGCCCGGGTGCTTTTGATATCTGG	CARAYYGSGSPGAFDIW	IGHV4-34	IGHJ3
TGTGCGAGACTTAAGGGGGCTCAATATTGTAGTGGTGGTAGCTGCTACTCCCCGTTGGTTGACTACTGG	CARLKGAQYCSGGSCYSPLVDYW	IGHV4-38-2	IGHJ4
TGTGCAAGAGAGACTATAGCAGCTCGTCCCCCCGGGTTTCCTTTATGGCTGGACTTTGACTACTGG	CARETIAARPPGFPLWLDFDYW	IGHV3-13	IGHJ4
TGTGCGAGAGGCTTTGGAGTGGTTAGGCCAAAGGGCTGGTTCGACCCCTGG	CARGFGVVRPKGWFDPW	IGHV4-34	IGHJ5
TGTGCGAAAGGCGAAACCTTGACTCGGTGGATACAGCTATGGTTACGACGAGGGTTTGGTGACTACTGG	CAKGETLTRWIQLWLRRGFGDYW	IGHV3-23	IGHJ4
TGTGCACGGATACGGAGGTACCAGCTGCTATGGTTGACCATGGTGCCGGGTTGGTTCGACCCCTGG	CARIRRYQLLWLTMVPGWFDPW	IGHV2-26	IGHJ5
TGTGCAAGAGCGGAAGTGGGAGCTACCAACTCTCCTTATTCCGGTGCCGGAGGTGACTACTGG	CARAEVGATNSPYSGAGGDYW	IGHV3-74	IGHJ4
TGTGCGAAGGAGGCTCTGGGTATTACTATGGTTCGGGGAGTTATCAGACAAGTTGGGTTCGACCCCTGG	CAKEALGITMVRGVIRQVGFDPW	IGHV3-23	IGHJ5
TGTGCGAGAGATCCCCCGACCTATAACTGGAACTACGTTTTGAGCGATTACTACTACTACTACTACATGGACGTCTGG	CARDPPTYNWNYVLSDYYYYYYMDVW	IGHV4-61	IGHJ6
TGTGCGCTCAGTGTAGTAGTACCAGCTGCTATTTGGAGTAGGAGCTGGTTCGACCCCTGG	CALSVVVPAAIWSRSWFDPW	IGHV1-3	IGHJ5
TGTGCGAAAGTTTTCTCCGATTGTAGTAGTACCAGCTGGGCGCGGTACTACATGGACGTCTGG	CAKVFSDCSSTSWARYYMDVW	IGHV3-23	IGHJ6
TGTGCGAGAGTAATCCTAGCAGCTCATACTTTTGACTACTGG	CARVILAAHTFDYW	IGHV1-2	IGHJ4
TGTACCACGACGCGTATTGTAGTGGTGGTAGCTGCGCAGGGATTTGACTACTGG	CTTTRIVVVVAAQGFDYW	IGHV3-15	IGHJ4
TGTGCGAGAGGGACGTATAGCAGCTCGTCTCTCGGCTGG	CARGTYSSSSLGW	IGHV7-4-1	IGHJ5
TGTGCGAGAGAAGCCATGGATACGATTTTTGGAGTGGTGTGGCGAAGGCGCTACTGG	CAREAMDTIFGVVWRRRYW	IGHV1-3	IGHJ4
TGTGCGAGAGAGTCTGGCTCGTACGGTGACTACGTCAGGGGTTGTAACTGGACCTCAATTGACTACTGG	CARESGSYGDYVRGCNWTSIDYW	IGHV4-4	IGHJ4
TGTGTCCCTACGATATATAGTGGCTATGGCAAATACTACTACTACTACATGGACGTCTGG	CVPTIYSGYGKYYYYYMDVW	IGHV3-30-3	IGHJ6
TGTGCGAGAGATCCCCCACCACCCCATAGAGTGGTGGTAGCTGCTATAAGGAACTTTGACTACTGG	CARDPPPPHRVVVAAIRNFDYW	IGHV1-46	IGHJ4
TGTACCACAGCACCTACGGGTGGTTTGTGGCTGGTACCCGTTCGGGGTTTTGACTACTGG	CTTAPTGGLWLVPVRGFDYW	IGHV3-15	IGHJ4
TGTGCAACAGTTCTGCCTATTGTAGTAGTAGGCCACTACTACTACATGGACGTCTGG	CATVLPIVVVGHYYYMDVW	IGHV1-24	IGHJ6
TGTGCGAAAGATAGCACCCACCCGACAGATATTGTAGTAGTACCAGCTGCTAGGCGTTTTTACTACTTTGACTACTGG	CAKDSTHPTDIVVVPAARRFYYFDYW	IGHV3-23	IGHJ4
TGTGCGAGAGGGGAATTACGATTTTGGGTCCCCTACTACATGGACGTCTGG	CARGELRFWVPYYMDVW	IGHV4-34	IGHJ6
TGTGCGAGAAACGTATTACGATTTTTGGAGTGGTTATTATTGTGCTACTACTACATGGACGTCTGG	CARNVLRFLEWLLLCYYYMDVW	IGHV7-4-1	IGHJ6
TGTGCGAAGGGATATTGTAGTGGTGGTAGCTGCTCTTCCGCACGCTGGTTCGACCCCTGG	CAKGYCSGGSCSSARWFDPW	IGHV3-7	IGHJ5
TGTGCGAAAAGGCCCCCGTACGAGTACCAGCTGCTATTGACTTTCCCCTACTGGTTCGACCCCTGG	CAKRPPYEYQLLLTFPYWFDPW	IGHV3-NL1	IGHJ5
TGTGCGAGAGTACGTGGTGGTAGCTGCTATTTGTACTACTTTGACTACTGG	CARVRGGSCYLYYFDYW	IGHV4-39	IGHJ4
TGTGCGAGAGATGGGAAATGGCCCTACGGTGAGAGCTCTCCCAATTCGAACTGGTTCGACCCCTGG	CARDGKWPYGESSPNSNWFDPW	IGHV3-48	IGHJ5
TGTGCGAGACATGTTAGAGCATCTAGTGGTGGTAGCTGCTGGACCCGGATTAATTGGTACTTCGATCTCTGG	CARHVRASSGGSCWTRINWYFDLW	IGHV4-39	IGHJ2
TGTGCGAGAAAAAGGGGGTATTGTAGTGGTGGTAGCTGCTACCTCTACTACTTTGACTACTGG	CARKRGYCSGGSCYLYYFDYW	IGHV1-3	IGHJ4
TGTGCGAGAGATGACTGGCGTATTGTAGTAGTACCAGCTGCTTACTACTACTACTACTACATGGACGTCTGG	CARDDWRIVVVPAAYYYYYYMDVW	IGHV3-21	IGHJ6
TGTGCGAGAATTGAGCGTTGGCTTGTAGTGGTGGTAGCTGCAAATACCGATAACTGGTTCGACCCCTGG	CARIERWLVVVVAANTDNWFDPW	IGHV4-61	IGHJ5
TGTGCGAGACTGACGGTTCTGAGGTGTAGTGGTGGTAGCTGCTACTTTGACTACTGG	CARLTVLRCSGGSCYFDYW	IGHV3-30	IGHJ4
TGTACTAGAAAACGTCGAACCCCACGAAGAGTGGTTATTAATCACTACTACTTTGACTACTGG	CTRKRRTPRRVVINHYYFDYW	IGHV3-49	IGHJ4
TGTGCAAGATACGATTTTTGGAGACGAGACTACTACTACTACTACATGGACGTCTGG	CARYDFWRRDYYYYYMDVW	IGHV1-45	IGHJ6
TGTGCAAGAGATCGGGCTGGAACAGACTGGTTATCAATAACTAAGGGTACCCACAACTGGTTCGACCCCTGG	CARDRAGTDWLSITKGTHNWFDPW	IGHV3-13	IGHJ5
TGTGCGAGACCATCCCCACCCATCCTCTTAGTAGCAGTGGCTGGTACTAAGAGCTTCCGGCACTACTGG	CARPSPPILLVAVAGTKSFRHYW	IGHV5-51	IGHJ4
TGTACCACAGGTAAAAGTGGCTACGATTATTGGAACTTTGACTACTGG	CTTGKSGYDYWNFDYW	IGHV3-15	IGHJ4
TGTGCGAGAGATATTGCCCGGGGGCTGGTACTATACTACTACTACTACATGGACGTCTGG	CARDIARGLVLYYYYYMDVW	IGHV3-7	IGHJ6
TGTGCACGGATATATGATATTGTAGTGGTCCCTCTACGTGACTACTGG	CARIYDIVVVPLRDYW	IGHV2-26	IGHJ4
TGTGCGAAAGGCCGTATTGTAGTAGTCACTTACGACTACTACTACTACTACATGGACGTCTGG	CAKGRIVVVTYDYYYYYMDVW	IGHV3-NL1	IGHJ6
TGTGCGAGAGGGGCCTCTTATTACTATGGTTCAGGGAGTTATAGGGGTGGCTACTACTACTACTACATGGACGTCTGG	CARGASYYYGSGSYRGGYYYYYMDVW	IGHV3-7	IGHJ6
TGTGCGAGAGATCCCGCCCACCCTGGACACAAGGGCATAGTGGCTACGATTGATACGACTGCTTTTGACAGGAGGAACTACTACTACTACATGGACGTCTGG	CARDPAHPGHKGIVATIDTTAFDRRNYYYYMDVW	IGHV1-2	IGHJ6
TGTGCGAGAGATGTCAAAGTGGTTATTACTATTGCCAAAGAGTACTGG	CARDVKVVITIAKEYW	IGHV3-21	IGHJ4
TGTGCAAGAGGGTGCAGTGGCTGCCCCTCCTTGGGATACTGG	CARGCSGCPSLGYW	IGHV3-13	IGHJ4
