TGTGCGATCCCAATAGCAGTGGCTGCGTGG	CAIPIAVAAW	IGHV4-61	IGHJ4
TGTGCGTGGACGGTAACTAAGTGGACCTGGGGGACGGGGGACATCCCTTTTGACTACTGG	CAWTVTKWTWGTGDIPFDYW	IGHV3-20	IGHJ4
TGTGCGAGAACCGTGCTGGGTAGCAGCTCGTCCGGACCCCACCCCTACTGG	CARTVLGSSSSGPHPYW	IGHV1-2	IGHJ4
TGTGCACGGATAAGGGAATATTACGATATTTTGACTGGACGGACTGACTACTACTACTACTACATGGACGTCTGG	CARIREYYDILTGRTDYYYYYMDVW	IGHV2-26	IGHJ6
TGTGCAAAAGGTAGGGTTCGGTATTACTATGGTTCAGGGAGTTATGGAGGACCGAATAGTGTAACGACAAACTGGTTCGACCCCTGG	CAKGRVRYYYGSGSYGGPNSVTTNWFDPW	IGHV3-43	IGHJ5
TGTGCACACATTCGTATTACGATTTTTGGAGTGGTTAATCAGGGACCCTTTGACTACTGG	CAHIRITIFGVVNQGPFDYW	IGHV2-5	IGHJ4
TGTGCGAAATGCCGGCTAGATGTCTACGGTGACTACCGTGACTACTGG	CAKCRLDVYGDYRDYW	IGHV3-NL1	IGHJ4
TGTACTAGAGATCAGGCCGAACGTCTCCACTTCGCGGCCGGATACAGCTATGGTTACGGGTTGTTTTGGTACTGG	CTRDQAERLHFAAGYSYGYGLFWYW	IGHV3-49	IGHJ4
TGTGCGAGGTTAGGGGAAAGTACGGTGACAACCAAAGTGATGCGACTGAACTGG	CARLGESTVTTKVMRLNW	IGHV5-10-1	IGHJ4
TGTGCGAGAGATTTGGGTCGTATTACGATTTTTGGAGTGGTTATTATACTGCACTGGTTCGACCCCTGG	CARDLGRITIFGVVIILHWFDPW	IGHV1-46	IGHJ5
TGTGCAAGAGATCGGGGAGTAGGATATAGTGGCGTAATCTTTGACTACTGG	CARDRGVGYSGVIFDYW	IGHV3-13	IGHJ4
TGTGCGAAAGGTTTCGTGGAGTATAGCAGCTCGTCCCGCTGG	CAKGFVEYSSSSRW	IGHV3-NL1	IGHJ5
TGTGCGAAATGGGTTCTAGACATAGCAGCTCGTACGGTCCTTTTCATCTTCTTTGACTACTGG	CAKWVLDIAARTVLFIFFDYW	IGHV3-23	IGHJ4
TGTGCGAGAGGCCAGGGGTGTATGCTAGACGGCAGAACCTGCTGG	CARGQGCMLDGRTCW	IGHV4-34	IGHJ5
TGTGCGAGAGATCGGGGTGGGAGTAGTCCTATTACGATTTTTGGAGTGGGGAACTACTACTACTACTACATGGACGTCTGG	CARDRGGSSPITIFGVGNYYYYYMDVW	IGHV1-3	IGHJ6
TGTGCGGGACGAGTCGACCTTCATAGCCCGTCGTGGTTGCAGTGGCTGGTACACCGGAACTGGTTCGACCCCTGG	CAGRVDLHSPSWLQWLVHRNWFDPW	IGHV3-53	IGHJ5
TGTGCGAGAGTGGGTATAGTGGCTACGAGGCGGGGGGTTCACTACATGGACGTCTGG	CARVGIVATRRGVHYMDVW	IGHV1-2	IGHJ6
TGTGCGAGCCCTTATTACTATGATAGTAGTGGTTATTTATACTGG	CASPYYYDSSGYLYW	IGHV1-18	IGHJ4
TGTGCACGAAATATAGTGGCTACCGCGGGGCACGACTACTGG	CARNIVATAGHDYW	IGHV3-23	IGHJ4
TGTGCGAGACATGTCGGTGTGTGTAGTAGTACCAGCTGCTATGAAAATTACTACTACTACTACTACATGGACGTCTGG	CARHVGVCSSTSCYENYYYYYYMDVW	IGHV5-51	IGHJ6
TGTGCGAGAGATAAGTTAGAGGTGGTAGCTGTTTCCTACTTTGACTACTGG	CARDKLEVVAVSYFDYW	IGHV4-59	IGHJ4
TGTGCGAGAGTATGGGGAACCAGCAGTGGCTGGTACCTTTCGGTAAATCTAAACTGGTTCGACCCCTGG	CARVWGTSSGWYLSVNLNWFDPW	IGHV3-11	IGHJ5
TGTGCGAGAGTCTGTAGTGATACTTCTACTATGGTTCAGGGAGTTATTTACCGCTACTACTTTGACTACTGG	CARVCSDTSTMVQGVIYRYYFDYW	IGHV3-11	IGHJ4
TGTGCGAGATACCCCGCTCCGGGTGCGTACTACTTTGACTACTGG	CARYPAPGAYYFDYW	IGHV5-10-1	IGHJ4
TGTGCGAGAGAAAGGGCAGTGGCTGACTGG	CARERAVADW	IGHV3-7	IGHJ5
TGTGCGAGACATGTAGATTATTACTACTACTACTACTACATGGACGTCTGG	CARHVDYYYYYYYMDVW	IGHV5-51	IGHJ6
TGTGCGAGAACTGCCCTCGATTTTGATAGCTGGGACACTGAGTTTAGGTATTACTATGATAGTAGTGGTACTGTAGTCTGG	CARTALDFDSWDTEFRYYYDSSGTVVW	IGHV4-38-2	IGHJ4
TGTGCGAGAGCGGTAGGAGGGCCAGTCAACAAGCAGCTGGTGGCTGTGGTTGACTACTGG	CARAVGGPVNKQLVAVVDYW	IGHV1-2	IGHJ4
TGTACCACAGAGGGGAGTGGTCCGTGGGACCACCTTTACTACTACTACTACATGGACGTCTGG	CTTEGSGPWDHLYYYYYMDVW	IGHV3-15	IGHJ6
TGTGCGGCAGATCAAGTAAACATTGGGGTTGACTACTGG	CAADQVNIGVDYW	IGHV1-58	IGHJ4
TGTGCGAGGTCTAAGTGCCGGCACGGTATAGCAGCAGCTGGTACACTGGGAAGTGGCTGG	CARSKCRHGIAAAGTLGSGW	IGHV5-51	IGHJ5
TGTGCGAAAGAGTTATTTGGGGGAGTTACTATTGACTACTGG	CAKELFGGVTIDYW	IGHV3-23	IGHJ4
TGTGCGAGAGATGTTAGGCCGGGATCTTCCGAAGGATATTGTACTGGTGGTGTATGCTATCTCCCCTACTACTACATGGACGTCTGG	CARDVRPGSSEGYCTGGVCYLPYYYMDVW	IGHV3-11	IGHJ6
TGTACCCACACTACAGCTATGGTTAAGGATGGCACTCCCACCCGTGTGGACTACTGG	CTHTTAMVKDGTPTRVDYW	IGHV3-49	IGHJ4
TGTGGCCACATGGGGTATAACTGGAACTGCGGGGACTACTGG	CGHMGYNWNCGDYW	IGHV3-30	IGHJ4
TGTGCGAGAGATTGTCATAACCGACACTACTGG	CARDCHNRHYW	IGHV3-7	IGHJ4
TGTTATTATCGTATTACTATGATAGTAGTGGTTATGGTAAACAATGATGCTTTTGATATCTGG	CYYRITMIVVVMVNNDAFDIW	IGHV3-30-3	IGHJ3
TGTGCGAGGATTACTCATATTGTGGTGGTGATTCCGGGTGACTACTGG	CARITHIVVVIPGDYW	IGHV3-7	IGHJ4
TGTGCGAAGGGTTTCCAAGGATATTGTAGTAGTACCAGCTGCTATGTCAGGGGCCTCTACTACTACTACATGGACGTCTGG	CAKGFQGYCSSTSCYVRGLYYYYMDVW	IGHV3-NL1	IGHJ6
TGTACTAGAGATGAACTCTGTTCCCCGTTTTGTACCTTTATTGTACTGGTGGTGTATGCTATAGCTTCGCAATATTACTACTACTACTACTACATGGACGTCTGG	CTRDELCSPFCTFIVLVVYAIASQYYYYYYYMDVW	IGHV3-49	IGHJ6
TGTGCGGCAATACCTCGAGATAACGGACCCCCGTGGTTCGACCCCTGG	CAAIPRDNGPPWFDPW	IGHV1-58	IGHJ5
TGTGCACGGATACGCGTCGGGGGGACGTATTATGATTACATTTGGGGGAGTTACCTTGACTACTGG	CARIRVGGTYYDYIWGSYLDYW	IGHV2-70	IGHJ4
TGTGCGAAAGAAGATTGTAGTAGTACCAGCTGCTATTCACCTGACTACTGG	CAKEDCSSTSCYSPDYW	IGHV3-NL1	IGHJ4
TGTGCAAGAGAGGAGTGGCTGGGACTTTTAGACTACTGG	CAREEWLGLLDYW	IGHV3-74	IGHJ4
TGTAGTGCACGGGATGCCTCCCCCGTCACCAACTGGTTCGACCCCTGG	CSARDASPVTNWFDPW	IGHV3-15	IGHJ5
TGTGCGAGGTATTCGGCCGGCTTGTTCTACTTTGACTACTGG	CARYSAGLFYFDYW	IGHV4-39	IGHJ4
TGTGCGAAAGCGGCAGGATTGGCCTACTACTACTACTACATGGACGTCTGG	CAKAAGLAYYYYYMDVW	IGHV3-23	IGHJ6
TGTGCAAAAGATATCCTATGGTTCAGGGAGTTATTATACGAGGCTTTTGATATCTGG	CAKDILWFRELLYEAFDIW	IGHV3-43	IGHJ3
TGTGCGAGAGATCACACCGGAGAAATAACTGGAACGACCGGGTACTGG	CARDHTGEITGTTGYW	IGHV1-69	IGHJ4
TGTGCGAGAGATCTAATGGACCCTAAGCCCCAGCTGCTATGGAAGTACGGGGACTACTGG	CARDLMDPKPQLLWKYGDYW	IGHV1-2	IGHJ4
TGTCTTCCATGGTTCAGGGAGTTATTATGTCCTCTGTACTGG	CLPWFRELLCPLYW	IGHV3-30-3	IGHJ4
TGTGCGAGCTATATTGTAGTGGTGGTAGCTGCTACCGGTAGGGGTGATATCTGG	CASYIVVVVAATGRGDIW	IGHV1-69	IGHJ3
TGTGCGATATGGGATTCCGGCTGGTACTTTCGCTTTGACTACTGG	CAIWDSGWYFRFDYW	IGHV3-21	IGHJ4
TGTGCGAGAGGCAGGTGCAGCAGCTGGTCCCCACCACGGTTCGACCCCTGG	CARGRCSSWSPPRFDPW	IGHV7-4-1	IGHJ5
TGTGCAAAAGACGCTGAATTTATAGCAGCAGCTGGTACTCACTGG	CAKDAEFIAAAGTHW	IGHV3-43D	IGHJ4
TGTGCGAGAGATCTGCCCCTAACGGATATTGTAGTGGTCTGGTTCGACCCCTGG	CARDLPLTDIVVVWFDPW	IGHV3-11	IGHJ5
TGTGCGAGAGATACCTATTGTACTGGTGGTGTATGCGGGAACCATAGCCATCAATGGCACCAACGGCGCTGGTTCGACCCCTGG	CARDTYCTGGVCGNHSHQWHQRRWFDPW	IGHV4-59	IGHJ5
TGTGCGAGACCTGTACCGGCCTACTTTGACTACTGG	CARPVPAYFDYW	IGHV7-4-1	IGHJ4
TGTGCGAAAGCCATGACTACGGTGACTACGTTAGTCTACTGG	CAKAMTTVTTLVYW	IGHV3-NL1	IGHJ4
TGTGCGAGAGTGCCCCATAGCAGCTCGTCGTGCGACCCCGGCTGGTTCGACCCCTGG	CARVPHSSSSCDPGWFDPW	IGHV4-61	IGHJ5
TGTGCGAGAGATCGAAGTATAGCAGTGGCTGGCCGTCACTACTTTGACTACTGG	CARDRSIAVAGRHYFDYW	IGHV4-59	IGHJ4
TGTGCGAGAGGTAGGCGTATTACTATGATAGTAGTGGTTATTTGGGTCTGG	CARGRRITMIVVVIWVW	IGHV4-34	IGHJ5
TGTGCGAGACAAACTAATAGCAGCAGCTGGTACCTAAGGACCCACACGGCTCTCTGGTTCGACCCCTGG	CARQTNSSSWYLRTHTALWFDPW	IGHV3-20	IGHJ5
TGTGCGAGACTCCTAGCCGGATATTGTAGTAGTACCAGCTGCTATTTATATTGGCGAACATTGAATTACTACTACTACTACTACATGGACGTCTGG	CARLLAGYCSSTSCYLYWRTLNYYYYYYMDVW	IGHV5-51	IGHJ6
TGTGGGATGATCCAGGCCCGAGAGTCGGGGTCTTCGCTCGTGTTTCCCGATGACTACAGTAACCGTCGATACTGGTTCGACCCCTGG	CGMIQARESGSSLVFPDDYSNRRYWFDPW	IGHV3-43	IGHJ5
TGTGCGAGGATCGGACCTATTGTAGTAGTACCAGCTGCTATGAGCTACTACTACTACATGGACGTCTGG	CARIGPIVVVPAAMSYYYYMDVW	IGHV3-30	IGHJ6
TGTGCGAGAATTGAATGGTCCAGACCGAACTACTACAACTGGTTCGACCCCTGG	CARIEWSRPNYYNWFDPW	IGHV1-3	IGHJ5
TGTGCGAGAGATTTTAGCTTGCCACGTGAGGATAGCAGTGGCTGGTACCGCCGGGACGCCGATGACTACTGG	CARDFSLPREDSSGWYRRDADDYW	IGHV3-21	IGHJ4
TGTGCGAGACGCGGGTGCTACTATGGTTCAGGGAACCTCAACTGGTTCGACCCCTGG	CARRGCYYGSGNLNWFDPW	IGHV4-39	IGHJ5
TGTACTAGAGTAACAGTAGTACCAGCTGCTCCCAACTACTACTACTACATGGACGTCTGG	CTRVTVVPAAPNYYYYMDVW	IGHV3-49	IGHJ6
TGTCCGGGTGAATTAACTACGGTGACTACGAGTCGCCTTGCCCGGGAAAAATGGTTCGACCCCTGG	CPGELTTVTTSRLAREKWFDPW	IGHV3-30-3	IGHJ5
TGTGCACACATGGGGGGGATCCCCGATTACGATATTTTGACTGGTTATTATATACCCTACTACTACTACTACATGGACGTCTGG	CAHMGGIPDYDILTGYYIPYYYYYMDVW	IGHV2-5	IGHJ6
TGTGCGAAAGATGGGAGCCCGGCTACGCTCTACTGG	CAKDGSPATLYW	IGHV3-NL1	IGHJ4
TGTGCAAGACGTGTTTTGTACTGGTGGTGTATGCGCCACTACTACTACTACATGGACGTCTGG	CARRVLYWWCMRHYYYYMDVW	IGHV1-45	IGHJ6
TGTGCGAGAAAAACCGGACTACCCCCTGGTCGGCATATTGTGGTGGTGACTGCTATACGAGTGGACTACTGG	CARKTGLPPGRHIVVVTAIRVDYW	IGHV3-11	IGHJ4
TGTGCGAGACGGCCGAAGGTGGTAGGACTGGGCGCCCTTATCCACGGGGTTCTTGGGTTTGACTACTGG	CARRPKVVGLGALIHGVLGFDYW	IGHV5-51	IGHJ4
TGTGCGAGAGTCCTTTCCCATATTATAACTGGAACTACGGCCCCTGCCCAAGAGACAAGGATCATGTTGTTTGACTACTGG	CARVLSHIITGTTAPAQETRIMLFDYW	IGHV4-61	IGHJ4
TGTGCGAGAGACCCTTACTATGATAGTAGTGGTTATTACTATTGTGTTCTCTCCGACTGGTACTTCGATCTCTGG	CARDPYYDSSGYYYCVLSDWYFDLW	IGHV1-69	IGHJ2
TGTGCACGGATACAAAGGCCTATAGCAGTGGCTGGTCGGGGATATGACTACTGG	CARIQRPIAVAGRGYDYW	IGHV2-70	IGHJ4
TGTGCACACAGTTGGGTAGCGTGGGGGTACTATGGATCCCTTCGTGACTACTGG	CAHSWVAWGYYGSLRDYW	IGHV2-5	IGHJ4
TGTGCGAGACGTAGAGCCTACTATGGTTCAGGGAGGTTGATTTACATGGACGTCTGG	CARRRAYYGSGRLIYMDVW	IGHV5-51	IGHJ6
TGTGCGAGACCCCTCTTGATGCAGCAGCTGGTACGGCGAACTCTTCCCTGG	CARPLLMQQLVRRTLPW	IGHV7-4-1	IGHJ4
TGTGCAACAGGATTGATATTGTACTGGTGGTGTATGCGCCCCGGGTTTTACTACTTTGACTACTGG	CATGLILYWWCMRPGFYYFDYW	IGHV1-24	IGHJ4
TGTGCGAAGTTTCCTGGAGTGGTTATTCCACAGCATCTTTGGTTTGACTACTGG	CAKFPGVVIPQHLWFDYW	IGHV3-23	IGHJ4
TGTGGGAGTCCCGTAGCAGCAGCTGGTACCGAAGATCCCTCGGACCTGGTAAACTTTGACTACTGG	CGSPVAAAGTEDPSDLVNFDYW	IGHV3-53	IGHJ4
TGTGCGAGAGATTGTAGCAGTGGCTGGTACAATGCTTTTGATATCTGG	CARDCSSGWYNAFDIW	IGHV4-4	IGHJ3
TGTACCACATTCCCTTCCGTAGAGGATATTGTAGTAGTACCAGCTGCTGGCAACTGGTTCGACCCCTGG	CTTFPSVEDIVVVPAAGNWFDPW	IGHV3-15	IGHJ5
TGTGCGAGAGATCCTGGGGGTTATCGCTACAGTAACTACCCGTGGAAGATACCCGAACCCATGCTCCGCTTTGACTACTGG	CARDPGGYRYSNYPWKIPEPMLRFDYW	IGHV1-18	IGHJ4
TGTGCGAGCGGTGTTGGAGCGAGTTTTAGCATGGACGTCTGG	CASGVGASFSMDVW	IGHV4-34	IGHJ6
TGTGCGAGAGGAACGATTTTTGGAGTGGTTAATCCGGACTTTGACTACTGG	CARGTIFGVVNPDFDYW	IGHV4-59	IGHJ4
TGTGCGGCAGTTTTCAGTGGCTGGACCTGGATCGGAATGTTCGGAGACCCCCCGTTCGACCCCTGG	CAAVFSGWTWIGMFGDPPFDPW	IGHV1-58	IGHJ5
TGTGCGAGACCCGAGTGGCTGGTACGGGGTTTTGACTACTGG	CARPEWLVRGFDYW	IGHV4-4	IGHJ4
TGTGCGAGAGGGGGGGCCAGACCACGGGAAGGGGACGGTCTATGGTTCAGGGAGTTATTATTTCCGGCCCTCGTATTTATGGTCCGGCGATTTGACTACTGG	CARGGARPREGDGLWFRELLFPALVFMVRRFDYW	IGHV4-34	IGHJ4
TGTGCGAGAGACTGGCCGGGAAGGCATGGTTCAGGGAGTTATTATCTAAGTTACTACTACTACTACATGGACGTCTGG	CARDWPGRHGSGSYYLSYYYYYMDVW	IGHV4-34	IGHJ6
TGTGCGAGACCCGCTTATAGTGGCTACGCGCAACCCCCGTTTGACTACTGG	CARPAYSGYAQPPFDYW	IGHV4-38-2	IGHJ4
TGTACCACAGATTTTCGTACAGGGGTCATGGGTGACTATTCGTATTGGTCTATTAGTGACTACTGG	CTTDFRTGVMGDYSYWSISDYW	IGHV3-15	IGHJ4
TGTGCACGGTATAGCAGCAGCTGGGCGAACTACTACTACTACTACATGGACGTCTGG	CARYSSSWANYYYYYMDVW	IGHV2-70	IGHJ6
TGTGCGAGAGTTTTGCTAGGAAGTTCGTATAGCAGTGGCTGGTACGTGGGCAGTTGGAACTGGTTCGACCCCTGG	CARVLLGSSYSSGWYVGSWNWFDPW	IGHV3-20	IGHJ5
TGTGCGAGTGTGGCTATAGCAGCTCGGAATCATTACTACTACTACTACTACATGGACGTCTGG	CASVAIAARNHYYYYYYMDVW	IGHV1-18	IGHJ6
TGTGCGAAAGAACCGGGAGAGTCACGTATTACGATTTTTGGAGTGGTTATTATCCGGTACTACTACTACTACTACATGGACGTCTGG	CAKEPGESRITIFGVVIIRYYYYYYMDVW	IGHV3-NL1	IGHJ6
