TGTGCGAGAGCTCCGGTCACTGGTAGCTGCCCCCCCTTGGCTATGAAGAACTGGTTCGACCCCTGG	CARAPVTGSCPPLAMKNWFDPW	IGHV3-66	IGHJ5
TGTGCGAACGGATTAGCCCGAACTGGAACGACACGGACCCTCTTTGACTACTGG	CANGLARTGTTRTLFDYW	IGHV1-2	IGHJ4
TGTGCACACACGGCGGGATTGTCCGTAAGAGGATATTGTAGTAGTACCAGCTGCTATAGTGCGAGCTGG	CAHTAGLSVRGYCSSTSCYSASW	IGHV2-5	IGHJ4
TGTGCACGGATAGCAGTGGCTGGCCCAGCCACCTTTGACTACTGG	CARIAVAGPATFDYW	IGHV2-26	IGHJ4
TGTGCGAGACAAGGTGTTATTGTAGTGGTGGTAGCTGCTAACCCCCCTAACTGGTTCGACCCCTGG	CARQGVIVVVVAANPPNWFDPW	IGHV5-51	IGHJ5
TGTGCGAGAGTGATGTATAGCAGCTCGAGCCCAGAGTTTGACTACTGG	CARVMYSSSSPEFDYW	IGHV1-2	IGHJ4
TGTGCCGCATCGAGCTATTGTAGTGGTGGTAGCTGCTACACTCCCAACTACTGG	CAASSYCSGGSCYTPNYW	IGHV3-21	IGHJ4
TGTGCGAGAATGGGGTATAGCAGAAACTTCCACCCGACCTTTGACTACTGG	CARMGYSRNFHPTFDYW	IGHV4-38-2	IGHJ4
TGTGCGAGTCTGAATAGCAGCCCGCAGTACTGGTTCGACCCCTGG	CASLNSSPQYWFDPW	IGHV4-59	IGHJ5
TGTGCGAGGGACTATTGTAGTAGTACCAGCTGCCGGCCCACGGGATATTACTACTACTACTACTACATGGACGTCTGG	CARDYCSSTSCRPTGYYYYYYYMDVW	IGHV3-21	IGHJ6
TGTGCGAGAGCGTACCAGCCTTACGGTGACTACTGTTTCTTATACTACTACTACTACTACATGGACGTCTGG	CARAYQPYGDYCFLYYYYYYMDVW	IGHV3-21	IGHJ6
TGTGGGGCATGGTGGGGGGTGTACTGGTGGTGTATGCTATCTTTTGATATCTGG	CGAWWGVYWWCMLSFDIW	IGHV1-8	IGHJ3
TGTGCGAGGGATTCTTGTAGTGGTGGTAGCTGCTACCGTTTAGCCATGTATTACTACTACTACTACTACATGGACGTCTGG	CARDSCSGGSCYRLAMYYYYYYYMDVW	IGHV4-38-2	IGHJ6
TGTGCGAAAAATACGATTTTTGGAGTGGTTATGGCCCTCGCTGACTACTACTACTACATGGACGTCTGG	CAKNTIFGVVMALADYYYYMDVW	IGHV3-NL1	IGHJ6
TGTAAGCTATATTGTAGTAGTACCAGCTGCTACACGAGCCGCTACTGG	CKLYCSSTSCYTSRYW	IGHV3-30-3	IGHJ4
TGTGCACGGATTGTGCTTACTATGGTTCGGGGAGTTAAAGGGTCTGACTACTGG	CARIVLTMVRGVKGSDYW	IGHV2-26	IGHJ4
TGTGGGATAGTGGCTACGAGCGGTAGGTACTACTACTACTACATGGACGTCTGG	CGIVATSGRYYYYYMDVW	IGHV3-30	IGHJ6
TGTGCGAAAGAGAGACATAGCAGCTCACATGACTTTGACTACTGG	CAKERHSSSHDFDYW	IGHV3-23	IGHJ4
TGTGCGAGACATTACGATTTTTGGAGTGGTTATTCTTTTACTCGACAAAGTCACTACTACTACTACTACATGGACGTCTGG	CARHYDFWSGYSFTRQSHYYYYYMDVW	IGHV4-34	IGHJ6
TGTGCGAGAGGTACAGAGGTAAACTTACATTTGGGGGAGGCCCATTGG	CARGTEVNLHLGEAHW	IGHV4-59	IGHJ5
TGTCACTGGCCCAGTATATTAGATTATGATTACATTTGGGGGAGTTATCGTTATACCGATAACCATAGGCGTACTTTTGTTGGACGATACTACTACTACTACTACATGGACGTCTGG	CHWPSILDYDYIWGSYRYTDNHRRTFVGRYYYYYYMDVW	IGHV3-30-3	IGHJ6
TGTGCGAGTTTATATAGCAGTGGCTGGCTAAGTCCAATTGACTACTGG	CASLYSSGWLSPIDYW	IGHV1-46	IGHJ4
TGTGCGAAACCATCAGCCAAGCGTGGATATAGTGGCTACGATCGAGCGTACTTCCAGCACTGG	CAKPSAKRGYSGYDRAYFQHW	IGHV3-23	IGHJ1
TGTGCGAGAAGATACGGGCCTACGCTGTGTCAATTGGGTACTATGATAGTAGTGGTGTACTGG	CARRYGPTLCQLGTMIVVVYW	IGHV4-38-2	IGHJ4
TGTGCGAGAAGGCCTCTGACTACGGTGACTGACTACTGG	CARRPLTTVTDYW	IGHV7-4-1	IGHJ4
TGTGCGAGAGAAGCGCGACTGACGGATTATTTAAGTCCAGTAGTACCAGCTGCTATGTTTACCCCCTTTGACTACTGG	CAREARLTDYLSPVVPAAMFTPFDYW	IGHV3-20	IGHJ4
TGTGCGAAAGATGGGAGTATAGCAGCAGCTGGGGAGTGGTTCGACCCCTGG	CAKDGSIAAAGEWFDPW	IGHV3-NL1	IGHJ5
TGTGCGAGTGTGGTGGTGACTGCTGGATTTGACTACTGG	CASVVVTAGFDYW	IGHV1-69	IGHJ4
TGTGCGACCGGGTATAGCAGCAGCTGGTACAGGTACTGGTTCGACCCCTGG	CATGYSSSWYRYWFDPW	IGHV3-23	IGHJ5
TGTGCGAGAGGCAGGGTTCGGGGAGTTTATGGCTCGTCCTTAAGGGGGTTTGACTACTGG	CARGRVRGVYGSSLRGFDYW	IGHV4-34	IGHJ4
TGTGCAGGATATTGTAGTAGTACCAGCTGCTATTGGTACTGG	CAGYCSSTSCYWYW	IGHV3-NL1	IGHJ4
TGTGCGAGACTAGGGAGCCGATTGGGCTACGGGGACTACTGG	CARLGSRLGYGDYW	IGHV4-34	IGHJ4
TGTGCGAGCCAGATCTCCGGTTCGGGGAGTTACTACGGTTTCCACTACTGG	CASQISGSGSYYGFHYW	IGHV1-46	IGHJ4
TGTGCGGCAGATCAAGAGGGGCGTTTCCCCTTCACGCGGGTTTCGTTCCCCGGGGTGGATACAACCTCGTTTTTTGACTACTGG	CAADQEGRFPFTRVSFPGVDTTSFFDYW	IGHV1-58	IGHJ4
TGTGCGAGAGATAATAGGGGTCTAGCAGGGTATAGCAGTGGCAGGAAAATTTTTACCTTTGACTACTGG	CARDNRGLAGYSSGRKIFTFDYW	IGHV3-30	IGHJ4
TGTGCGAGACGCCTCGAGTATAGCAGCTCGTCCTCCTTTGACTACTGG	CARRLEYSSSSSFDYW	IGHV7-4-1	IGHJ4
TGTGCGAGAGGGCTTTACGATATTTTGACTGGTTATTATTGCGAGAAGTACGTGTTCGACCCCTGG	CARGLYDILTGYYCEKYVFDPW	IGHV1-2	IGHJ5
TGTACTCAACTGTATTACTATGATAGTAGTGGTTCCGGCTTTGACTACTGG	CTQLYYYDSSGSGFDYW	IGHV3-49	IGHJ4
TGTGCGAGAGTCCCTATTACGATTTTTGGAGTGGTTATTAGAATCCTGTACTACTTTGACTACTGG	CARVPITIFGVVIRILYYFDYW	IGHV3-20	IGHJ4
TGTGCGAGCACCTATGCCGTGTATTACTATGGTTCAGGGAGTTATTGCGCAACCGGGTACTACTACTACTACATGGACGTCTGG	CASTYAVYYYGSGSYCATGYYYYYMDVW	IGHV3-7	IGHJ6
TGTGCGAAAGATGGTATAGATATTGTAGTGGTGGTAGCTGCTACTCGGGACTACTGG	CAKDGIDIVVVVAATRDYW	IGHV3-23	IGHJ4
TGTGCAAGAGAGTCTTGCCCCCTAGGATATTGTAGTGGTGGTAGCTGCTACTACTTTGACTACTGG	CARESCPLGYCSGGSCYYFDYW	IGHV3-74	IGHJ4
TGTGCGAGCGTGGATATAGTGGCTACGATTAGCTCATATTACTACTACTACTACTACATGGACGTCTGG	CASVDIVATISSYYYYYYYMDVW	IGHV1-3	IGHJ6
TGTGCAAGAGACCCCCCGAGTCGTGCTTTTGATATCTGG	CARDPPSRAFDIW	IGHV3-74	IGHJ3
TGTGCGAGAGTAGGACTTCTGTCCCCTGACGATTTTTGGAGTGGTTATTATCCACATGGGAGGGCTTCCCCCTTTGACTACTGG	CARVGLLSPDDFWSGYYPHGRASPFDYW	IGHV4-34	IGHJ4
TGTGCACACAGACGGGCGAAGAGGCAGAAATTCCACACGGTCAACAACTGGTTCGACCCCTGG	CAHRRAKRQKFHTVNNWFDPW	IGHV2-5	IGHJ5
TGTGCGAGACGATCTTATTACGATTTTTGGAGTGGATCGCGGTATTTTGACTACTGG	CARRSYYDFWSGSRYFDYW	IGHV5-51	IGHJ4
TGTGCGAGAGGTCAACTACGATTTTTGGAGTGGTTGTTTGACTACTGG	CARGQLRFLEWLFDYW	IGHV1-3	IGHJ4
TGTGCGAGAGGCCAAAGACTCGGACATAGCAGCAGCTGGAATGTCTTTGACTACTGG	CARGQRLGHSSSWNVFDYW	IGHV5-10-1	IGHJ4
TGTACTAGACGGTATAGCAGTGGCCCGTACGTGGGACCCGCCGGTGACTTTGACTACTGG	CTRRYSSGPYVGPAGDFDYW	IGHV3-73	IGHJ4
TGTGCGAGAGGGAGTGCTTTAGGGGATAGAGTGGCTGGCGCGGACTACTACTACTACTACATGGACGTCTGG	CARGSALGDRVAGADYYYYYMDVW	IGHV4-61	IGHJ6
TGTGCAAAAGCGCGACCCGCGGGGTGGCTGGTTCCGCGCCACTGG	CAKARPAGWLVPRHW	IGHV3-43	IGHJ4
TGTGCGAGAGCGTACATGTGGCTGGTAAGATGCTACTGG	CARAYMWLVRCYW	IGHV4-4	IGHJ4
TGTGCGAAAGGATTCGGCAATGGAGGATATTGTAGTAGTACCAGCTGCTATAAACGAAACTACTACTACTACATGGACGTCTGG	CAKGFGNGGYCSSTSCYKRNYYYYMDVW	IGHV3-23	IGHJ6
TGTGCGAAATGGGAGACGTTACGATTTTTGGAGTGGTTATTATTAGGCGGTCTCCCGGGCTACTACTACTACTACATGGACGTCTGG	CAKWETLRFLEWLLLGGLPGYYYYYMDVW	IGHV3-23	IGHJ6
TGTGCGAGAGATGGGTATTACGATTTTTGGAGTGATGGGGGAAGGTACTACATGGACGTCTGG	CARDGYYDFWSDGGRYYMDVW	IGHV3-7	IGHJ6
TGTGCGAATTTCCGCTGGCGGATACAGCTATGGTTCCCCTACTACTACTACATGGACGTCTGG	CANFRWRIQLWFPYYYYMDVW	IGHV3-NL1	IGHJ6
TGTGCGAGATACCGGGGAATGGTGAACAGGCGGCGGGGTATAGTGGCTACAGTTGCAGTCATACGATTCTACTGG	CARYRGMVNRRRGIVATVAVIRFYW	IGHV4-38-2	IGHJ4
TGTACTAGAGATCCCCCCCTTACAGGAGTGGCTACTTTCTGG	CTRDPPLTGVATFW	IGHV3-49	IGHJ5
TGTGTCAAGGCTGGGGTCGAAGGGTGCCTTTCTCATGTGGCTTCGCAGTGGCTCCTCCAGACCGGAACCTACTGG	CVKAGVEGCLSHVASQWLLQTGTYW	IGHV3-11	IGHJ4
TGTACCACCGTTCCTTACTATGGTTACAGCTACTACTACTACTACTACATGGACGTCTGG	CTTVPYYGYSYYYYYYMDVW	IGHV3-15	IGHJ6
TGTGCGAGAGATCCCAGGAGTTCTTGGGGGAGTTATCGTCCCTTCTACTACTACTACTACATGGACGTCTGG	CARDPRSSWGSYRPFYYYYYMDVW	IGHV3-11	IGHJ6
TGTGCGAGCTACCCGGGCTACGGTGGTAACTCCGAAGTATTCCAGGACTACTGG	CASYPGYGGNSEVFQDYW	IGHV7-4-1	IGHJ4
TGTGCGAGAGTCGAGCCGTTACCTGACCCCACTGACTTTCAGATGATGACTACGGGGAAGTGTTACTACTACTACTACATGGACGTCTGG	CARVEPLPDPTDFQMMTTGKCYYYYYMDVW	IGHV1-2	IGHJ6
TGTGCGAGAGAAAGGGGGCAGCAGCTGTTATTTGACTACTGG	CARERGQQLLFDYW	IGHV3-53	IGHJ4
TGTGCGAGAGATTGTAGTAGTACCAGCTGCTTCAGTTCCTTTGACTACTGG	CARDCSSTSCFSSFDYW	IGHV4-59	IGHJ4
TGTGCGAGAGTAGGGGTTGGTCTCTTTGACTACTGG	CARVGVGLFDYW	IGHV1-2	IGHJ4
TGTGCGAGACCCTACGATTTTTCCAATGACTACTGG	CARPYDFSNDYW	IGHV4-39	IGHJ4
TGTGCGAAACGACAACGATTGTATAGCAGTGGCTGGTACATTTTTGACTACTGG	CAKRQRLYSSGWYIFDYW	IGHV3-NL1	IGHJ4
TGTGCACGGATAACAACGGGGGCGGATAACGTTGACTACTGG	CARITTGADNVDYW	IGHV2-70	IGHJ4
TGTGCGAGAGTCGCTGTGGCTACGCCCCGGCCAGGTGCTTTTGATATCTGG	CARVAVATPRPGAFDIW	IGHV3-21	IGHJ3
TGTGCGAGAGGGGCGTATCCATATTGTAGTGGTGGTGGGGAACGGGGCGGTACCTGG	CARGAYPYCSGGGERGGTW	IGHV3-20	IGHJ4
TGTGCGAGAGATGCGACATACAGCTACTACTTTGACTACTGG	CARDATYSYYFDYW	IGHV4-4	IGHJ4
TGTGCGAGAGTCCCCGGACCGTGGATACAGCTATGGATCGCGAGTGAAATTGATGCTTTTGATATCTGG	CARVPGPWIQLWIASEIDAFDIW	IGHV1-18	IGHJ3
TGTGCGAGACACAAGGGGATTGTAGTAGTACCAGCTGCTATGCTTCACGGCTTTGACTACTGG	CARHKGIVVVPAAMLHGFDYW	IGHV5-51	IGHJ4
TGTGCGAGAGATCACATCTATTATGATTACATTTGGGGGAGTTATCGCCTCGGGGTTGACTACTGG	CARDHIYYDYIWGSYRLGVDYW	IGHV4-59	IGHJ4
TGTGCGATGAGGGTTGGTGACGATTTTTGGAGTGGTTATTATACGTATTGGTACTACTACTACTACATGGACGTCTGG	CAMRVGDDFWSGYYTYWYYYYYMDVW	IGHV5-51	IGHJ6
TGTGCGAGAGATGGAACGAAAGGGCAGTGGCTGGTCCGCTACTACTGG	CARDGTKGQWLVRYYW	IGHV3-30	IGHJ4
TGTGCGAGACTTCTGACTACAGTAACTACGGCAGAAGGATTTGACTACTGG	CARLLTTVTTAEGFDYW	IGHV5-51	IGHJ4
TGTGCGAGAGCCGATCCCCCATCTATCCCTTTTGACTACTGG	CARADPPSIPFDYW	IGHV3-11	IGHJ4
TGTGCGGCCTGGAACGCGGGATATTGTAGTAGTACCAGCTGCTATATCTTTGACTACTGG	CAAWNAGYCSSTSCYIFDYW	IGHV1-18	IGHJ4
TGTGCGAGAGATCAAATAGGGGACGTATTACGATTTTTGGAGTGGTTAAACCGGTACTACTACATGGACGTCTGG	CARDQIGDVLRFLEWLNRYYYMDVW	IGHV3-21	IGHJ6
TGTACCACGGATTGTAGTGGTGGTAGCTGCTATTTCGGGAGATACTGGTACTTCGATCTCTGG	CTTDCSGGSCYFGRYWYFDLW	IGHV3-15	IGHJ2
TGTGCGAAATGCCCTTATAAATATAGCAGTGGCTGCTACTGG	CAKCPYKYSSGCYW	IGHV3-NL1	IGHJ4
TGTGCGAGAGTGGACGTTTCTAGCAGCTCGTCTAGGAGGAAAGGGGGATCAGCTGGCTTCCCTGACTACTGG	CARVDVSSSSSRRKGGSAGFPDYW	IGHV4-34	IGHJ4
TGTGCAAGAGTCCTTGGCATTACTATGATAGTGTACTTTGACTACTGG	CARVLGITMIVYFDYW	IGHV3-74	IGHJ4
TGTACCACAGCCATGATTAGTGTAGTAGTACCAGCTGCTATGACAGTGTTTGACTACTGG	CTTAMISVVVPAAMTVFDYW	IGHV3-15	IGHJ4
TGTGCGAGAGCGCACTTTCTACTCGCACCGGTGACTGATTCCTTCTTCAGCGCTTTTGATATCTGG	CARAHFLLAPVTDSFFSAFDIW	IGHV3-7	IGHJ3
TGTGCGAGACCAGTTATGGTTCAGGGAGTTACTTCATACTACTACTACTACATGGACGTCTGG	CARPVMVQGVTSYYYYYMDVW	IGHV5-51	IGHJ6
TGTGCGAGAAAACCCGATATTTTGACTGGTGAACAAAACTGGTTCGACCCCTGG	CARKPDILTGEQNWFDPW	IGHV3-21	IGHJ5
TGTGCGAGAGATAGTAATAGCAGCAGCTGTTACCTATCCTTTGGGTGG	CARDSNSSSCYLSFGW	IGHV3-53	IGHJ5
TGTGCGAAAGATTTGGGAATCGCGTATTATGATTACATTTGGGGGAGTTATCGTAGGTTGGACCCGGCGAACTACTACTACTACATGGACGTCTGG	CAKDLGIAYYDYIWGSYRRLDPANYYYYMDVW	IGHV3-NL1	IGHJ6
TGTGCGAGGCCGGGACTAAAGTGG	CARPGLKW	IGHV4-34	IGHJ4
TGTGCGAGAGATTTGAAGCCAATAGCAGCAGCTTGGAGAGATGCTTTTGATATCTGG	CARDLKPIAAAWRDAFDIW	IGHV3-21	IGHJ3
TGTGCGAGACCCATTGAGGTTCAAGTACCAGCTGTAAATGTCGAGCGTTACTACTACTACATGGACGTCTGG	CARPIEVQVPAVNVERYYYYMDVW	IGHV3-11	IGHJ6
TGTGCGAGAGTTTATTGTAGTAGTACCAGCTGCTATGAGTCCGGCCCATACTACTTTGACTACTGG	CARVYCSSTSCYESGPYYFDYW	IGHV4-38-2	IGHJ4
TGTACTAGAGTCACGGCTATTACTATGGTTCGGGGAGTTATTATAACGACACGGCAAGACTGG	CTRVTAITMVRGVIITTRQDW	IGHV3-73	IGHJ4
TGTGCAAGAGATCTTCCTCACTATGGTTCAGGGAGTTATAATCCACTTCGAGACAACTGGTTCGACCCCTGG	CARDLPHYGSGSYNPLRDNWFDPW	IGHV6-1	IGHJ5
TGTGCGAGAGACCTAACCCCACCATGGTTCGGCTCGCGCTTTGACTACTGG	CARDLTPPWFGSRFDYW	IGHV1-3	IGHJ4
TGTGCGAAAAATGTACTTGGTTTACGGCTTACTATGGTTCAGGGAGTTAATCACTACTACTACTACATGGACGTCTGG	CAKNVLGLRLTMVQGVNHYYYYMDVW	IGHV3-23	IGHJ6
