TGTACCAACCCCCGGCCCGTCTGG	CTNPRPVW	IGHV3-9	IGHJ3
TGTGCACTAGGCCGTGGTCCGGTAGTACCAGCTGCCATTTACTACTACTACTACTACATGGACGTCTGG	CALGRGPVVPAAIYYYYYYMDVW	IGHV2-26	IGHJ6
TGTGCGTCCTCCCTTTTGGTGGTAGCTGCTAGGGGGAACTGGTTCGACCCCTGG	CASSLLVVAARGNWFDPW	IGHV5-10-1	IGHJ5
TGTGCACGGATGGGCGAAGCCTATTGTAGTAGTACCAGCTGCTACTACTACTACTACATGGACGTCTGG	CARMGEAYCSSTSCYYYYYMDVW	IGHV2-26	IGHJ6
TGTGCGAGAGAGGAGGCTATAGTGGCTACGAGAGTAAGCCGGTTGGTCCCCAACCGGGGGGGCGCACTCCTATGGTACTACTTTGACTACTGG	CAREEAIVATRVSRLVPNRGGALLWYYFDYW	IGHV4-4	IGHJ4
TGTGCGAGAGATAATTACTATGGTTCAGGGAGTTATTGGTCTAAACGACCGACTAACTGGTTCGACCCCTGG	CARDNYYGSGSYWSKRPTNWFDPW	IGHV1-3	IGHJ5
TGTGCGAGGGGTAAATGTCCTAGCAGTGGCTGGTACGCGTGG	CARGKCPSSGWYAW	IGHV3-7	IGHJ4
TGTGCGAGACCCCGCTCCCCGGCGGACCACTGG	CARPRSPADHW	IGHV4-39	IGHJ4
TGTGCGAGAGAGCGATCGGCATATTACTATGATAGTAGTGGTTATTCGGTTGACTACTGG	CARERSAYYYDSSGYSVDYW	IGHV3-11	IGHJ4
TGTACCACATATACTAATAGCAGCGTCCGGGACTACTACTACTACATGGACGTCTGG	CTTYTNSSVRDYYYYMDVW	IGHV3-15	IGHJ6
TGTGCGAAAGAGATTGGAAATGGGGGGCAAACTACGGTGACTGGCGATGCTTTTGATATCTGG	CAKEIGNGGQTTVTGDAFDIW	IGHV3-23	IGHJ3
TGTGCACGCCTGGACGTACTATCCGATTTTTGGAGTGGTTATTGTGTTGACTACTGG	CARLDVLSDFWSGYCVDYW	IGHV2-70	IGHJ4
TGTGCGAGAGATGGCTCGTATTGTAGTAGTACCAGCTGCTCCCACTTTGACTACTGG	CARDGSYCSSTSCSHFDYW	IGHV3-30	IGHJ4
TGTGCGAAAGATGGGAATGACGGTGTAGTACCAGCTGCTATGACTCGCGATTACTACATGGACGTCTGG	CAKDGNDGVVPAAMTRDYYMDVW	IGHV3-23	IGHJ6
TGTGCGAGACCCGGACGGTCTATTGTGGTGGTGACTGCTTCATCGGTTAACTGGTTCGACCCCTGG	CARPGRSIVVVTASSVNWFDPW	IGHV5-51	IGHJ5
TGTGCGAAAGCCTTTATTGGCGCCTACGAGGATATTGTAGTAGTACCAGCTGCTACTTACTACTACTACTACTACATGGACGTCTGG	CAKAFIGAYEDIVVVPAATYYYYYYMDVW	IGHV3-23	IGHJ6
TGTGCGAAAGCAAGCCACTATTACGATTTTTGGAGTGGTTATGAGGGGGGAGGGGCCAAATTCGATGCTTTTGATATCTGG	CAKASHYYDFWSGYEGGGAKFDAFDIW	IGHV3-NL1	IGHJ3
TGTGCGAGACTCCTTGGAACGACGCCCCGAGCTAACCACTTTGACTACTGG	CARLLGTTPRANHFDYW	IGHV4-38-2	IGHJ4
TGTGCGAGAGGGGGGTATTCCGACACTAATGGTGTATGCTATAATTTTGACTACTGG	CARGGYSDTNGVCYNFDYW	IGHV4-4	IGHJ4
TGTGCGAAAGATTTCGGGTACTACGGTGACTATATCCAAAGCTACTACTACTACTACATGGACGTCTGG	CAKDFGYYGDYIQSYYYYYMDVW	IGHV3-23	IGHJ6
TGTACTAGAGCAACCCTTTGCAGCTGGTTTAAGTTTGACTACTGG	CTRATLCSWFKFDYW	IGHV3-49	IGHJ4
TGTGCGAGAGATGCCATGCCATTCCGTTCGGTCCCATTTGGGAAGTTTAGGATCCCGATTGACTGGTTCGACCCCTGG	CARDAMPFRSVPFGKFRIPIDWFDPW	IGHV1-2	IGHJ5
TGTGCGAGAGACACGGGGAGTATTGTAGTGGTGGTAGCTGCTACTGAAAGACACTGGTTCGACCCCTGG	CARDTGSIVVVVAATERHWFDPW	IGHV3-7	IGHJ5
TGTGCGAGAGGTATGGAGGACCTCAAGCATGACTACGGTGACAACACGGTTGACTACTGG	CARGMEDLKHDYGDNTVDYW	IGHV4-34	IGHJ4
TGTGCAAGAGTGGTGCACAGCATTGTAGTAGTACCAGCTGCTATGACCCCCTTTGACTACTGG	CARVVHSIVVVPAAMTPFDYW	IGHV3-74	IGHJ4
TGTGCGAATCCAAGTAGTGGTTATTACGCAGACTGGTTCGACCCCTGG	CANPSSGYYADWFDPW	IGHV3-23	IGHJ5
TGTGCACGGATACATGTGACTCCGCAGGCCAGTGGTGTAGTGGTGGTAGCTGCTAGGGACTACTGG	CARIHVTPQASGVVVVAARDYW	IGHV2-70	IGHJ4
TGTGCGAAACCCGATCGGCTTGGTATAGCAGCTCCTTTGGGGGCGTTTGACTACTGG	CAKPDRLGIAAPLGAFDYW	IGHV3-NL1	IGHJ4
TGTGCGAGATGCAGCCCCATTGTACTGGTGGTGTATGCGGGTTTTTTTAAGGCTGAATACTTCCAGCACTGG	CARCSPIVLVVYAGFFKAEYFQHW	IGHV5-10-1	IGHJ1
TGTGCGAGAGTTGCTGTATTACGATTTTTGGAGTGGTTATTATACCGGTGCATTTGCGCCGAGTTCTTTGACTACTGG	CARVAVLRFLEWLLYRCICAEFFDYW	IGHV3-66	IGHJ4
TGTGCGAGATTGGAGCAGTGGCTGGTACATCTCACTGCTTTTGATATCTGG	CARLEQWLVHLTAFDIW	IGHV1-3	IGHJ3
TGTGGGGGCGACTACGGTGACTTTAGGTACTACTACTACTACATGGACGTCTGG	CGGDYGDFRYYYYYMDVW	IGHV3-23	IGHJ6
TGTACCACCGATAGGCAAGGCCGAATGGATATTGTAGTAGTACCAGCTGCTACCCGAGTTACCCACTACTACTACTACATGGACGTCTGG	CTTDRQGRMDIVVVPAATRVTHYYYYMDVW	IGHV3-15	IGHJ6
TGTGCGAGAGCGCGATACGTGGATACAGCTATGGCCGCCTTCGTGTCACTTGACTACTGG	CARARYVDTAMAAFVSLDYW	IGHV3-20	IGHJ4
TGTGCGAAGATCACTATAGTGGCAAAAGCGGGTGACTACTGG	CAKITIVAKAGDYW	IGHV3-23	IGHJ4
TGTGCGAAAGATTTGACACCAAGGCAGTGGCTGGCACCACTAAATGACTACTGG	CAKDLTPRQWLAPLNDYW	IGHV3-NL1	IGHJ4
TGTGCGAGAGTGAATTGTAACGTACCGCACTTTGACTACTGG	CARVNCNVPHFDYW	IGHV1-69	IGHJ4
TGTGACCCGGCCCAAGTGGGAGCTACTTACTGG	CDPAQVGATYW	IGHV3-30	IGHJ4
TGTGCGAGATCCCCCACCGATATTGTAGTAGTACCAGCTGCTATACCGGGGCACTGGTTCGACCCCTGG	CARSPTDIVVVPAAIPGHWFDPW	IGHV3-11	IGHJ5
TGTGCGAAAGAAAGAACGATCGGATCCCGTAAAGCGGGTATAGCAGTGGCTGGTACCCCCTTATTCTGGAACGACTACTGG	CAKERTIGSRKAGIAVAGTPLFWNDYW	IGHV3-23	IGHJ4
TGTGCAAAAGTTACGAATATATTACTATGGTTCAGGGAGTTATTCCTCAGACCCTTTGACTACTGG	CAKVTNILLWFRELFLRPFDYW	IGHV3-43D	IGHJ4
TGTGCGAGAGTAGGTTTGTCGGGAATTTTGGAGTGGTTATTAGGGCAGGCGGGTGACTACTGG	CARVGLSGILEWLLGQAGDYW	IGHV4-4	IGHJ4
TGTGCGAAATTGGGGTTTCTGATAGTAGTGGTTATTAAAGGTGACTACTGG	CAKLGFLIVVVIKGDYW	IGHV3-NL1	IGHJ4
TGTGCGATTACCCCTCTTACTATGATAGTAGTGGTATGCTCCTACTACTTTGACTACTGG	CAITPLTMIVVVCSYYFDYW	IGHV4-34	IGHJ4
TGTGCAAAAGATACGGGCTCCGATTTTTGGAGTGGTTATTATCCCTACTTTGACTACTGG	CAKDTGSDFWSGYYPYFDYW	IGHV3-43	IGHJ4
TGTGCGAAAGATTTCCCTGTCTTGTACTGGTGGTGTATGCTATCGCCAACCTGG	CAKDFPVLYWWCMLSPTW	IGHV3-23	IGHJ4
TGTGCGAGGCACGCTGGGCCACACTACTACTACTACTACATGGACGTCTGG	CARHAGPHYYYYYMDVW	IGHV1-3	IGHJ6
TGTGCGACCACCGCACGTATAGCAGCAGCTGGTAGTAAGTCTCCTGACTACTACTACTACATGGACGTCTGG	CATTARIAAAGSKSPDYYYYMDVW	IGHV4-38-2	IGHJ6
TGTGCGAGAGCCTTCCGGGGGGGGGGGCAACCCCCCGGGTGTTTTGTAGTAGTACCAGCTGCTATTACATACTACTACTACTACATGGACGTCTGG	CARAFRGGGQPPGCFVVVPAAITYYYYYMDVW	IGHV1-2	IGHJ6
TGTGCGAGAGATTTAACCGTGACTACGGGGGCCCCATCTGACTACTGG	CARDLTVTTGAPSDYW	IGHV1-18	IGHJ4
TGTGCGAAAGATGTAACTAAGCTGCTTTGGAGTGGTTATTATACCGGGTACTGGTTCGACCCCTGG	CAKDVTKLLWSGYYTGYWFDPW	IGHV3-23	IGHJ5
TGTGCGGGGATTGTAGTGGTGGTAGCTGCTACGGAGGGCCCAAATGACTACTGG	CAGIVVVVAATEGPNDYW	IGHV3-NL1	IGHJ4
TGTGCGGAGTTGACTATGGTTCGGGGAGTTATTATTGACCCTGGGTACTGGTTCGACCCCTGG	CAELTMVRGVIIDPGYWFDPW	IGHV1-3	IGHJ5
TGTGCGAAAGATCGGGTGGGATATTGTAGTAGTACCAGCGTCGACTTTGACTACTGG	CAKDRVGYCSSTSVDFDYW	IGHV3-23	IGHJ4
TGTGCGAGAGTGGATCATCGACGAGGTAGTAGTACCAGCTGCTATTACTACTACTACTACTACATGGACGTCTGG	CARVDHRRGSSTSCYYYYYYYMDVW	IGHV4-4	IGHJ6
TGTGCGAGAGATACGGGTTATGATTACGTTTGGGGGAGTTATCGTTCCCAGGAAAGCAACTTTGACTACTGG	CARDTGYDYVWGSYRSQESNFDYW	IGHV3-7	IGHJ4
TGTGCGAGAGACGCCGAAGAAGCAGCAGCTGGCGGGTACTACTTTGACTACTGG	CARDAEEAAAGGYYFDYW	IGHV4-59	IGHJ4
TGTGCGAGAGGGCAGTGGCTGGCCCAGGATAGATACTACTACTACTACTACATGGACGTCTGG	CARGQWLAQDRYYYYYYMDVW	IGHV1-18	IGHJ6
TGTACTAGAGTGGGCGACTACTGG	CTRVGDYW	IGHV3-49	IGHJ4
TGTCCCGGGGTTTTTGGAGTGGCAGCTTATGCCCGCCCCCGTATCTTTGACTACTGG	CPGVFGVAAYARPRIFDYW	IGHV3-11	IGHJ4
TGTGCGAGCTTCCAATACCTATACTATGGTTCAGGGAGTTACCTGCCGAGGGAAATGTCGTACTACTACTACATGGACGTCTGG	CASFQYLYYGSGSYLPREMSYYYYMDVW	IGHV3-7	IGHJ6
TGTGCGAGAGATAGGACGCCAGTTTTTGGAGTGGTTATTAATTCCTTTGACTACTGG	CARDRTPVFGVVINSFDYW	IGHV3-7	IGHJ4
TGTGCGAGAGAATTTCATTGTAGTAGTACCAGCTGCCGACCCACGGGCAGACTCTTCGACCCCTGG	CAREFHCSSTSCRPTGRLFDPW	IGHV1-46	IGHJ5
TGTGCGAGACGGGCATGGGTGGTTAGATTAGCCCCCCCCATAGCAGCTCGTCCCCGGCTTTGGGTCTGGTTCGACCCCTGG	CARRAWVVRLAPPIAARPRLWVWFDPW	IGHV5-51	IGHJ5
TGTGCGAGAGGTCACCCGAGGTCGGACCTTATTGTAGTGGTGGTAGCTGCTCCTGGGACTTATGTTGGTTACTGG	CARGHPRSDLIVVVVAAPGTYVGYW	IGHV3-30	IGHJ4
TGTGCAAGAGATGGGCCCACGGGAGCCTTCCCCGACTTAGGGTCCCCTAGTGGCTGCTTTGACTACTGG	CARDGPTGAFPDLGSPSGCFDYW	IGHV3-74	IGHJ4
TGTGCAAAAGTGGGGAGTCCCGTGTGTATAGCAGTGGCTGGAAGCATTGCCGGGGGATTCGGGCATGGCTACTGG	CAKVGSPVCIAVAGSIAGGFGHGYW	IGHV3-43	IGHJ4
TGTACCATTAGAAGGGGCTCGCCCATAGCAGTGGCTGGTACGCGACCTCCGTACTTTGACTACTGG	CTIRRGSPIAVAGTRPPYFDYW	IGHV3-15	IGHJ4
TGTGCGAGAAGTAGTTATCATGGTTCGGGGGCAGACTTTGACTACTGG	CARSSYHGSGADFDYW	IGHV7-4-1	IGHJ4
TGTGCGAGAGATTACATTGTACTAATGGTGTATGCTAGAGACCCCGCCAACTGGTTCGACCCCTGG	CARDYIVLMVYARDPANWFDPW	IGHV1-46	IGHJ5
TGTGCGGGTACCCCACGTGGTGGTAGCTGCTACTCTGGAATTCCCGTTGACTACTGG	CAGTPRGGSCYSGIPVDYW	IGHV3-23	IGHJ4
TGTGCGAAAACTGAATTTTCACCGGCAGCAGCTGGTAGAACCCCACCGGACTACATGGACGTCTGG	CAKTEFSPAAAGRTPPDYMDVW	IGHV3-NL1	IGHJ6
TGTGCGAGAGAGCGTATTACGATTTGTTTCCACTGGTACTTCGATCTCTGG	CARERITICFHWYFDLW	IGHV1-2	IGHJ2
TGTGCGAAAGAAGAGAGTACCAGCTGCTATACGCGGACTTTATGGCGTTCCTGGTTCGACCCCTGG	CAKEESTSCYTRTLWRSWFDPW	IGHV3-23	IGHJ5
TGTCGGTCTCCATGTAGTGGTGGTAGCTGCTATGGGTACAACTGGTTCGACCCCTGG	CRSPCSGGSCYGYNWFDPW	IGHV3-33	IGHJ5
TGTGCGAAAGTGTTCGAGGGTTGTAGTAGTACCAGCTGCTATTTGGAGTACTACTTTGACTACTGG	CAKVFEGCSSTSCYLEYYFDYW	IGHV3-23	IGHJ4
TGTGCGAGAGAAGGGATTTTTCCGACTACAGTGCACTACTACTTTGACTACTGG	CAREGIFPTTVHYYFDYW	IGHV1-2	IGHJ4
TGTGCGAGACCCCCCAATCCAGATATTACTATGGTTCAGGGAGTTCGCTACTACTACTACTACATGGACGTCTGG	CARPPNPDITMVQGVRYYYYYMDVW	IGHV7-4-1	IGHJ6
TGTGCGAGAGCAACTACGGAGATGGCTACAATTAGGGTAAGTGACTACTGG	CARATTEMATIRVSDYW	IGHV5-10-1	IGHJ4
TGTGCGAGAAGTGGGGGTTATAGCAGCAGCTGGTACGGGCTCTTTGACTACTGG	CARSGGYSSSWYGLFDYW	IGHV3-7	IGHJ4
TGTGCGAGGGGGATGGGATCCCGTAGTACCAGCTGCTACTTTCTTTGGCGGTCAAACTTTGACTACTGG	CARGMGSRSTSCYFLWRSNFDYW	IGHV4-34	IGHJ4
TGTGCGAGCTTCCGCGGCACGTATTACTATGGTTCAGGCCACTGGTTCGACCCCTGG	CASFRGTYYYGSGHWFDPW	IGHV4-59	IGHJ5
TGTGCGAAAGACTTTCTTAATATTGTAGTGGTGGTAGCTGCTACTCAGGGCACAATGTACAACTGGTTCGACCCCTGG	CAKDFLNIVVVVAATQGTMYNWFDPW	IGHV3-23	IGHJ5
TGTGCAAAAGAAATTTGCATCAATTGGGGAGGATATTGTAGTGGTGGTAGCTGCTACTCCTACTACTACTACATGGACGTCTGG	CAKEICINWGGYCSGGSCYSYYYYMDVW	IGHV3-43	IGHJ6
TGTTTTTGTTCAGGGAGTTGTCCGGCTAGAGAACGGTCCCGAACAGGGGGGAGTTACTACTACTACTACTACATGGACGTCTGG	CFCSGSCPARERSRTGGSYYYYYYMDVW	IGHV3-74	IGHJ6
TGTGCGAGAGACGAGGTGAGAAGGGATTGTGGTGGTGATTGCTATTTAAAAGGGACCCACGGACGGTTTGCTTTTGATATCTGG	CARDEVRRDCGGDCYLKGTHGRFAFDIW	IGHV5-10-1	IGHJ3
TGTACCACAGATAATCGGGAGTGGCTGGGGGGCTGG	CTTDNREWLGGW	IGHV3-15	IGHJ4
TGTGCGAGAGATGGCGGGTATAGCAGTGGCTGGTACAGGCCCTGG	CARDGGYSSGWYRPW	IGHV1-69	IGHJ4
TGTGCGAAAGATATTCCCCGGGCATATAGCAGCAGCTTCACTTGCCTTGACTACTGG	CAKDIPRAYSSSFTCLDYW	IGHV3-23	IGHJ4
TGTGCGAGTATATGGGGCCCCCATAGCAGCTCGTCCTTATTACCCACACGTTCGGGCTTTGACTACTGG	CASIWGPHSSSSLLPTRSGFDYW	IGHV1-46	IGHJ4
TGTACTAGGAGTCCGGGGGGAGTGGTTCATCTCTGGTACTTCGATCTCTGG	CTRSPGGVVHLWYFDLW	IGHV3-49	IGHJ2
TGTGCGAGCAGTATGTTCCAAGTGGGAGACGCCGGGGTATACCATTTGGGGGAGTTATCGTTAGGCGTGCAGCAAATTGACTACTGG	CASSMFQVGDAGVYHLGELSLGVQQIDYW	IGHV1-2	IGHJ4
TGTGCGAGAGGAGCCATTACTATGGTTCGGGGCGTAGACTACTGG	CARGAITMVRGVDYW	IGHV3-7	IGHJ4
TGTGCGATTTATTCCCCTACATTTGGGGGAGTTATCGAGGCGAAGCAGTCCTACTTTGACTACTGG	CAIYSPTFGGVIEAKQSYFDYW	IGHV7-4-1	IGHJ4
TGTGCGGGCCCGGTGATTACATTTGGGGGAGTTATCGTTATACCCCTTGATTTGCACTACGTACCACGCAGGAATTTCTACTGG	CAGPVITFGGVIVIPLDLHYVPRRNFYW	IGHV1-18	IGHJ4
TGTGCGAGACCGGGTATAGCAGTGGCTGGTACGAGTAGCCCACTCTGG	CARPGIAVAGTSSPLW	IGHV4-38-2	IGHJ4
TGTGCGAGACAAACCAGTAGTACCAGCTGCTACTTTGGAAAGAGGGGTTTGGCTGCTTTTGATATCTGG	CARQTSSTSCYFGKRGLAAFDIW	IGHV4-39	IGHJ3
TGTGCGAGACAGTGTAACGCCATTGTAGTGGTGGTAGCTGCTAGCTTTGACTACTGG	CARQCNAIVVVVAASFDYW	IGHV5-51	IGHJ4
TGTGCGACGGGGCCATCGTTTGAATATTGTAGTAGTACCAGCTGCTACTGGCCAGTAACGCCCAGTAGCGTATCTGTGGAAAAACTACTGGGGGGGTTTTACTACTTTGACTACTGG	CATGPSFEYCSSTSCYWPVTPSSVSVEKLLGGFYYFDYW	IGHV4-4	IGHJ4
TGTGCGAGATGGGGATTACGATTTTTGGAGTGGTTATTAATGCGATACCAACCGGACTACTACTACTACTACATGGACGTCTGG	CARWGLRFLEWLLMRYQPDYYYYYMDVW	IGHV7-4-1	IGHJ6
