TGTACCTGGGGTCGTATTACTATGGTTCAGGGAGTTATTAAAGGGTCAAACTACTACTTTGACTACTGG	CTWGRITMVQGVIKGSNYYFDYW	IGHV3-15	IGHJ4
TGTGCAAGACCTCACTGCCAATGGAGTACTAATGGTGTATGCTATTTACACTTTGACTACTGG	CARPHCQWSTNGVCYLHFDYW	IGHV1-45	IGHJ4
TGTGCGAAACGGAACATACCGGGGCCCAGAGACTACTGG	CAKRNIPGPRDYW	IGHV3-23	IGHJ4
TGTGCGGAACCCCTATACAGTAAATGTGACTACTGG	CAEPLYSKCDYW	IGHV1-18	IGHJ4
TGTGCGAGAGGGGGGAGGAGTGTGACCGGCTACTGG	CARGGRSVTGYW	IGHV1-2	IGHJ4
TGTGCGAAAGAGATTACTATGGTTCAGGGAGTTATTATTCCGCGATGG	CAKEITMVQGVIIPRW	IGHV3-NL1	IGHJ4
TGTACCACACGCCGCGATAGTACGTATTACTATGATAGTAGTGGTTATTACTGTACGAACAACTGGTTCGACCCCTGG	CTTRRDSTYYYDSSGYYCTNNWFDPW	IGHV3-15	IGHJ5
TGTGCGAGAGTTTGTACTATGAACCTAGGCTACTGG	CARVCTMNLGYW	IGHV3-30	IGHJ4
TGTGCGAGAGGCCTCCCGCGGACGGTGGTAGCTGCTACAAGGCCATACTACTACTACATGGACGTCTGG	CARGLPRTVVAATRPYYYYMDVW	IGHV3-48	IGHJ6
TGTACCACAGCCCCGGATATTGTAGTAGTACCAGCTGCTATGAACTACTACTACTACTACTACATGGACGTCTGG	CTTAPDIVVVPAAMNYYYYYYMDVW	IGHV3-15	IGHJ6
TGTACCACAGGAGTTATTGTAGTAGTACCAGCTGTATTCGGGGGGACTATTTACTCCAATGACTACTGG	CTTGVIVVVPAVFGGTIYSNDYW	IGHV3-15	IGHJ4
TGTGCGAGAGATCGTACTGGTGGTGTATGCCACCGAACCCCCTTTGACTACTGG	CARDRTGGVCHRTPFDYW	IGHV3-21	IGHJ4
TGTGCGAGAGACATTGCTAGTAGTGGTTATTTGGCTGGTGCGTGTACCATGAACTTCTTTGACTACTGG	CARDIASSGYLAGACTMNFFDYW	IGHV1-3	IGHJ4
TGTACCACAGCTAGGGCGGATATTGTAGTAGTACCAGCTGCTATCGGGCATGATGCTTTTGATATCTGG	CTTARADIVVVPAAIGHDAFDIW	IGHV3-15	IGHJ3
TGTGCGAAAGATCTAAATATTGTAGTAGTACCAGCTGCTAGTGTTACTTCATTACTATGGCTGGACTTGGGGGCCTACTGG	CAKDLNIVVVPAASVTSLLWLDLGAYW	IGHV3-23	IGHJ4
TGTGCGAGAGATCCCCGGAGACGACTTAGTAGTGGTGGTAGCTGCTACTCAAGTTGCTGG	CARDPRRRLSSGGSCYSSCW	IGHV4-59	IGHJ4
TGTGCGAAGGCCCGGTGTATGGGGGTCAACGACTACTGG	CAKARCMGVNDYW	IGHV3-23	IGHJ4
TGTGCGAGAGTATCGGGGAGCCCGGCTCCCATTACTATGGTTCAGGGAGTTATTAGGGAGGTAAGCGGGGGTGTTCAAATTAGGGCCCCATTTACGCGGTGTATGTACAACTGGTTCGACCCCTGG	CARVSGSPAPITMVQGVIREVSGGVQIRAPFTRCMYNWFDPW	IGHV3-7	IGHJ5
TGTGCGAAATGGCAGTATTACTATGATAGTAGTGGTTATTCGGTTGTCTACTGG	CAKWQYYYDSSGYSVVYW	IGHV3-NL1	IGHJ4
TGTGCGAAAGATGTTTCTAAGGTGGGGTTGTATTACTATGGTTCAGGGAGTTCAGCTCTAGACTACTGG	CAKDVSKVGLYYYGSGSSALDYW	IGHV3-NL1	IGHJ4
TGTGCAAGACCCGATACCTGGGGTAACTACTTCCGTGCAACTAACTGGTTCGACCCCTGG	CARPDTWGNYFRATNWFDPW	IGHV6-1	IGHJ5
TGTACTCCCAATTTTGTACGGAAATTACGATATTTTGACTGGGTACACCACTACTACTACATGGACGTCTGG	CTPNFVRKLRYFDWVHHYYYMDVW	IGHV3-49	IGHJ6
TGTGCGAGAGGGGGGGCCTTTTCCGGGTATAGCAGTGGCTGCCTTGACTACTGG	CARGGAFSGYSSGCLDYW	IGHV4-59	IGHJ4
TGTGCGAGAGAATCCCCAGCGGGGGTGGTCACTCCGGGTAGTAGTACCAGCTGCTATGCTGGGGATTACTACTACTACTACTACATGGACGTCTGG	CARESPAGVVTPGSSTSCYAGDYYYYYYMDVW	IGHV4-59	IGHJ6
TGTGCGAGAGATGATAGGTCGCTAGTGAAATATTACGATATTTTGACTGGTTATTACTATTGTTACTACTTTGACTACTGG	CARDDRSLVKYYDILTGYYYCYYFDYW	IGHV3-66	IGHJ4
TGTGCAAAAGATACAGTGGCACCATTGGTCCGCTACTTTGACTACTGG	CAKDTVAPLVRYFDYW	IGHV3-43	IGHJ4
TGTGCGAGACCGTTAAAAAGGCCTGCACCAGCTGCTATGCCCGGAGTTTTGAACTACTGG	CARPLKRPAPAAMPGVLNYW	IGHV1-69	IGHJ4
TGTGCGAGACAGCCATGGGGTAAGAGTGGCTACGATAAACGCCCCTATTACTACTACTACATGGACGTCTGG	CARQPWGKSGYDKRPYYYYYMDVW	IGHV4-34	IGHJ6
TGTCCCCGGGTCCAAGTGGCTACGATATACTACTACTACTACATGGACGTCTGG	CPRVQVATIYYYYYMDVW	IGHV1-3	IGHJ6
TGTGCGAGATCCCCTTTGGTAACGGCTGGTAACCTGAATGGAATTCCCTGGTCCCTGACCCACTACTGG	CARSPLVTAGNLNGIPWSLTHYW	IGHV4-38-2	IGHJ4
TGTACCACAGGCTTCGATACGATTTTTGGAGTGGTTATTGTGGACAAAGCAAACAACTGGTTCGACCCCTGG	CTTGFDTIFGVVIVDKANNWFDPW	IGHV3-15	IGHJ5
TGTGCAAGAGACCCCGCTTGTAGTGGTGGTAGCTGCTACCCTGGCATCTGG	CARDPACSGGSCYPGIW	IGHV1-45	IGHJ5
TGTGCACGGATACACCCCCTCTCCGTTGTAGACCCCTGGTTCGACCCCTGG	CARIHPLSVVDPWFDPW	IGHV2-70	IGHJ5
TGTGCGAGAATTCCCGGGGGATATAGCAGTGGCTGGTACGTGCTGATCCGAACTTACTACTACTACTACTACATGGACGTCTGG	CARIPGGYSSGWYVLIRTYYYYYYMDVW	IGHV7-4-1	IGHJ6
TGTGCGAGAGATGCCGGCTTGGGGCGGTGGTCTTTTTACTACTTTGACTACTGG	CARDAGLGRWSFYYFDYW	IGHV3-21	IGHJ4
TGTGGGGTCTCCTATTGTAGTAGTACCAGCTGCCAGCCTCCACGCTACTTTGACTACTGG	CGVSYCSSTSCQPPRYFDYW	IGHV3-30	IGHJ4
TGTTTCCGGAAATGGTTAAGTAGCTGCTACTCGGGGTCGGGATTAGTTGACTACTGG	CFRKWLSSCYSGSGLVDYW	IGHV3-30-3	IGHJ4
TGTGCGAGAGGCAACTATAGCAGCAGCACCGATTACTACTACTACTACTACATGGACGTCTGG	CARGNYSSSTDYYYYYYMDVW	IGHV3-7	IGHJ6
TGTGCACGGATACAATACGAATATAGTGGCTACGATAAACTTGTTGACTACTGG	CARIQYEYSGYDKLVDYW	IGHV2-70	IGHJ4
TGTGCTGCGGTGACTACACCAAGACTCTACTGG	CAAVTTPRLYW	IGHV1-69	IGHJ4
TGTGCACGGATACGGGGCGGTTCTTATTTAGTGTATTACTATGGTTCAGGGAGTTATTATGCCGGGTACTACTACTACTACATGGACGTCTGG	CARIRGGSYLVYYYGSGSYYAGYYYYYMDVW	IGHV2-70	IGHJ6
TGTGCGAGAAGTAGGGCGGTATTACGATATTTTGACTGGAATTTCTGGCGGGCTCCTGCTTGGGCTGATGCTTTTGATATCTGG	CARSRAVLRYFDWNFWRAPAWADAFDIW	IGHV7-4-1	IGHJ3
TGTGCGAGAGAGTGTATAGCAGCAGACATCGACTACATGGACGTCTGG	CARECIAADIDYMDVW	IGHV1-18	IGHJ6
TGTGCGAGCCCGAGATGTGGTGGTGACTGCTATTGGAGGGCTTTTGATATCTGG	CASPRCGGDCYWRAFDIW	IGHV1-69	IGHJ3
TGTACTAGACATGGATACTATGATAGTAGTGGTTATGTCTTCTTTGACTACTGG	CTRHGYYDSSGYVFFDYW	IGHV3-73	IGHJ4
TGTGCGAAAGAGTTCATTCCTGGATTTGGGCGTTTGGGGGAGTTAAGCTTTGACTACTGG	CAKEFIPGFGRLGELSFDYW	IGHV3-23	IGHJ4
TGTGCGAGAGATCTTCCACCGGCAGCAGCTGGTAGAGTTGACTACTGG	CARDLPPAAAGRVDYW	IGHV4-59	IGHJ4
TGTGCGAGACATAAAGATGAAAGTATAGCAGCAGCTGGTACGTATTTCTTTGACTACTGG	CARHKDESIAAAGTYFFDYW	IGHV5-51	IGHJ4
TGTGCGAGAGCCCGGACGAATATTACGATTTTTGGAGTGGTTAGGGTCCAATACTACTACTACATGGACGTCTGG	CARARTNITIFGVVRVQYYYYMDVW	IGHV3-21	IGHJ6
TGTGCGAGAGGCTTATCGTGGCTGGATAACTGGTTCGACCCCTGG	CARGLSWLDNWFDPW	IGHV4-34	IGHJ5
TGTGCGAACCGTGGATATAGTGGCTACGATCTGTTCTACTGG	CANRGYSGYDLFYW	IGHV3-23	IGHJ4
TGTGCGAGAGCCTATTCAGTAGTAGTACCAGCTGCAACTGACTACTGG	CARAYSVVVPAATDYW	IGHV3-7	IGHJ4
TGTGCGAGAGATGCTAGTATTGTAGTGGTGGTAGCTGCTACTCAGGAAGGCTACTACTACTACATGGACGTCTGG	CARDASIVVVVAATQEGYYYYMDVW	IGHV3-53	IGHJ6
TGTACCTACCATATTGTGGTGGTGACTGCTAGACCCGGTTTTGACTACTGG	CTYHIVVVTARPGFDYW	IGHV3-15	IGHJ4
TGTGCGGTCTGCCATCACGGTGACTACGATCCTAATTTCCGGAACCGCCGAGTTGCTTTTGATATCTGG	CAVCHHGDYDPNFRNRRVAFDIW	IGHV3-11	IGHJ3
TGTGCGAGGTACTTTTTTTTTCCCTCCGGACGGGTGCACAGGTTCGACCCCTGG	CARYFFFPSGRVHRFDPW	IGHV3-23	IGHJ5
TGTGCACGGATAGGAAACTACAGTAAGCCAGAGCCCACCGTAGAACCCTCCTGG	CARIGNYSKPEPTVEPSW	IGHV2-70	IGHJ4
TGTGCGAGAATTCGCCCCCAGGGTCCTATTGTAGTGGTGGTAGCTGCTACTATGAGGTCACGGTCCCGGTACTTCGATCTCTGG	CARIRPQGPIVVVVAATMRSRSRYFDLW	IGHV5-10-1	IGHJ2
TGTGCGAAAGATCATAATGGGTCGGCGAGCTGTGGTAGCTGCTACTCCGCCAAACCCACGCAATCGGAACCCAATGAAAAGCTACGTTGGGACTTTGACTACTGG	CAKDHNGSASCGSCYSAKPTQSEPNEKLRWDFDYW	IGHV3-NL1	IGHJ4
TGTGCGAGACGGCGAGATATTGTAGTGGTGGTAGCTGCTACTCCTGACTACTGG	CARRRDIVVVVAATPDYW	IGHV5-51	IGHJ4
TGTGCGAGGCCCCGCTACGGTGAGATGGTTGACTACTGG	CARPRYGEMVDYW	IGHV3-64	IGHJ4
TGTGCGAGACGTATTACTATGATAGTAGTGGTTATTACCCGGGCATACTGGTTCGACCCCTGG	CARRITMIVVVITRAYWFDPW	IGHV3-7	IGHJ5
TGTGCGAACGTATTACGATATTTTGACTGGTTATTACCGCCCGATTACTACTACTACTACATGGACGTCTGG	CANVLRYFDWLLPPDYYYYYMDVW	IGHV3-23	IGHJ6
TGTGCGAGGAAAAGTTTACGATTTTTGGAGTGGTTATTACCTGCCTTTGACTACTGG	CARKSLRFLEWLLPAFDYW	IGHV3-64	IGHJ4
TGTGCGAGGCGGATAGTAGTGGTTATTACCCCTCTAAGCTTTGACTACTGG	CARRIVVVITPLSFDYW	IGHV4-4	IGHJ4
TGTGCGAGAGATCGGGGGCCGTATAGCAGTGGCTGGTACTTTGGTGACTGG	CARDRGPYSSGWYFGDW	IGHV3-21	IGHJ4
TGTGCGAGAGATGGGCGTATTACTATGATAGTAGTGGTTATTAGACACGCCCCCCCTCGCCCCGATATGCTTGACTACTGG	CARDGRITMIVVVIRHAPPRPDMLDYW	IGHV3-53	IGHJ4
TGTGCACGGAAGGGGGAAACCCCCAGACATGAGATCCCGTATTACGATATTTTGACTGGAAGGGGGGACAACTGGTTCGACCCCTGG	CARKGETPRHEIPYYDILTGRGDNWFDPW	IGHV2-70	IGHJ5
TGTGCGAGAGATGTGTGTTTAGGAATTCCTACAGTACCACTTCCGGTTTATGACTACTGG	CARDVCLGIPTVPLPVYDYW	IGHV3-20	IGHJ4
TGTGCGGCCCCTTATAGCAGCAGCTGGTATTTTTTTGACTACTGG	CAAPYSSSWYFFDYW	IGHV3-30-3	IGHJ4
TGTGCGACGGCCTGGTTCGGGGAGTTCCGTTGTGACTACTGG	CATAWFGEFRCDYW	IGHV3-23	IGHJ4
TGTGCGGGGAGGCTGGTAGGGGATGCTTTTGATATCTGG	CAGRLVGDAFDIW	IGHV3-53	IGHJ3
TGTACTAGAGATGCCGTATTACGATTTTTGGAGTGGTTATTATCGGCTTTTGACTACTGG	CTRDAVLRFLEWLLSAFDYW	IGHV3-49	IGHJ4
TGTGCGAGAGAAAACCCTTATGGGTGGGGCTTTGACTACTGG	CARENPYGWGFDYW	IGHV1-3	IGHJ4
TGTGCGAAAGACCGGCGAGTAGTGGTTATTACGTGGGGGTGGAACTACTTTGACTACTGG	CAKDRRVVVITWGWNYFDYW	IGHV3-23	IGHJ4
TGTGCAAAACGACCTCTGGGTTTTCTTTCGACTATGATAGTAGTGGTTATTACTGGGTTCCTTACCTTGGATCTCTGG	CAKRPLGFLSTMIVVVITGFLTLDLW	IGHV3-43D	IGHJ2
TGTGCGCGGCTATGGTATAGCAGTGGCTGGTACAAGGACTACTACTACTACTACATGGACGTCTGG	CARLWYSSGWYKDYYYYYMDVW	IGHV1-69	IGHJ6
TGTGCGAGTCCTGGTGAAGCAGGCGTTACTATGGTCCCTGGGTACTTTGACTACTGG	CASPGEAGVTMVPGYFDYW	IGHV1-69	IGHJ4
TGTGCGAGATGGTCCCTCGACAGGACGATAGTAGTGGTTATTCCCCCCCCTGACTACTGG	CARWSLDRTIVVVIPPPDYW	IGHV1-2	IGHJ4
TGTGCGAGAGATCAGGGGGCCCCGATGGGATATTGTAGTGGTGGTAGCTGCTCCGGCTGGTTCGACCCCTGG	CARDQGAPMGYCSGGSCSGWFDPW	IGHV4-4	IGHJ5
TGTACGGAGTACCAGACGTATTACGATTTTTGGAGTGGCTCAATTTTTGACTACTGG	CTEYQTYYDFWSGSIFDYW	IGHV3-30-3	IGHJ4
TGTGCGAGAGTAAGTTCTATTGTAGTAGTACCAGCTGCTATCGAGGATGATGCTTTTGATATCTGG	CARVSSIVVVPAAIEDDAFDIW	IGHV3-53	IGHJ3
TGTGCGAGAGGCCTATCTCGTATAGCAGCAGCTGGTACTAGCCACTTCGATCTCTGG	CARGLSRIAAAGTSHFDLW	IGHV4-34	IGHJ2
TGTGGAATCTCTTACTACCCTGGTATAGCAGCAGCTGAGTTTGACTACTGG	CGISYYPGIAAAEFDYW	IGHV3-30-3	IGHJ4
TGTGCGCTAGGCATTATTACTATGGTTCAGGGAGTTATTGCCTTTGACTACTGG	CALGIITMVQGVIAFDYW	IGHV5-10-1	IGHJ4
TGTGCAAGAGATCGGCGTATAGCAGTGGCTGGTACCGTTCGTACGTTCTACTGG	CARDRRIAVAGTVRTFYW	IGHV3-74	IGHJ4
TGTGCGAAAGCAAGTTTACCGCATGGTCCTACCTGGTTCGACCCCTGG	CAKASLPHGPTWFDPW	IGHV3-NL1	IGHJ5
TGTGCGAGACCCATCTTTCCCATTAGGAGCAACAGCAGCTCCGGCGAAGACTTTGACTACTGG	CARPIFPIRSNSSSGEDFDYW	IGHV4-39	IGHJ4
TGTGCGAGAGATTCCTCGATACGATTTTTGGAGTGGTTATTCCTCCGAACCGGTTCCTACATGGACGTCTGG	CARDSSIRFLEWLFLRTGSYMDVW	IGHV3-53	IGHJ6
TGTGCGAAAGATAGACGGACCTCCCATTACGATATTTTGACTGGCATTGGGAAAGTCGACTACTGG	CAKDRRTSHYDILTGIGKVDYW	IGHV3-23	IGHJ4
TGTGCGCCCGGACATTACTATGGTTCAGGGAGTTATCCCAACTACTACTACTACTACATGGACGTCTGG	CAPGHYYGSGSYPNYYYYYMDVW	IGHV4-59	IGHJ6
TGTGCGAGAGATGCCTTGAGATCGTATAGCAGCAGCTGGTACCAGGGGGACTGGTTCGACCCCTGG	CARDALRSYSSSWYQGDWFDPW	IGHV1-69	IGHJ5
TGTGCGAGAGGTCTAATCGTAACAAAGCTGAAGCCGTACTGG	CARGLIVTKLKPYW	IGHV1-69	IGHJ4
TGTGCGAGAGAGGACCGGGCCTTCCGAGCGGCTGACTACTGG	CAREDRAFRAADYW	IGHV1-3	IGHJ4
TGTGCGAGCTTCACTAACAGCAGCTCGTCCGAGCAGTTTGACTACTGG	CASFTNSSSSEQFDYW	IGHV1-2	IGHJ4
TGTGCGAAAGATCCGTGGAGGGATGATCACGTATTACGATTTTTGGAGTGGTTCGACTACTGG	CAKDPWRDDHVLRFLEWFDYW	IGHV3-NL1	IGHJ4
TGTGCGAGACTTGGCCCTAGTATTACTATGATAGTAGTGGTTATTCAAAATTCAAACTGGTTCGACCCCTGG	CARLGPSITMIVVVIQNSNWFDPW	IGHV4-38-2	IGHJ5
TGTGCGAAAGAGACAGTCGGTGACTGGTGGTATTTTGACTACTGG	CAKETVGDWWYFDYW	IGHV3-23	IGHJ4
TGTGCGAGAGTGGGGGATATTGTAGTGGTGGTAGCTGCTACTCGGTATGACTACTGG	CARVGDIVVVVAATRYDYW	IGHV3-7	IGHJ4
TGTGCGAAAACAGGGTTTATCCTCTTTCCGAATGTACCTACGGTGACTACGTGGCTCAACTGGTACTTCGATCTCTGG	CAKTGFILFPNVPTVTTWLNWYFDLW	IGHV3-NL1	IGHJ2
