TGTGCGAGACTCCATAGGTCCTGGAATATTGTAGTGGTGGTAGCTGCTAGGCCATACTACTACTACTACTACATGGACGTCTGG	CARLHRSWNIVVVVAARPYYYYYYMDVW	IGHV7-4-1	IGHJ6
TGTACCACAGCCCCCGCGTGGATACAGCTATGGGCTTACTACTACTACTACTACATGGACGTCTGG	CTTAPAWIQLWAYYYYYYMDVW	IGHV3-15	IGHJ6
TGTGCGAAAGATCGCCAGGCCACCCGCTCGTGGTATTTTGACTACTGG	CAKDRQATRSWYFDYW	IGHV3-NL1	IGHJ4
TGTGCAACAGCGGAACTGGGTGGTAGCTGCGGATCCTTTGACTACTGG	CATAELGGSCGSFDYW	IGHV1-24	IGHJ4
TGTGCGAGAGGCACCGGATATTGTAGTGGTGGTAGCTGCTACTCGGGTGACTACTGG	CARGTGYCSGGSCYSGDYW	IGHV1-69	IGHJ4
TGTGCGAACTTGGTAGCTCCAACGAACTGGTTCGACCCCTGG	CANLVAPTNWFDPW	IGHV4-38-2	IGHJ5
TGTGCGAGAGAACGCGATATTGTAGTGGTGGTAGCTGCTCCAATAGTCTGG	CARERDIVVVVAAPIVW	IGHV3-7	IGHJ4
TGTGCGAGACGCGACACCCTGGCTGGTAAACACTTTGACTACTGG	CARRDTLAGKHFDYW	IGHV5-51	IGHJ4
TGTGCGAGAGTTGATATAGCAGTGGCTGCGCTCGGGGGTCCCCCCGAGTACTTCCAGCACTGG	CARVDIAVAALGGPPEYFQHW	IGHV3-21	IGHJ1
TGTGCAAGAGCCGGCAGCAGCTGGTACGGGGAGAAGGAACCTGCAGGATTTGACTACTGG	CARAGSSWYGEKEPAGFDYW	IGHV3-74	IGHJ4
TGTGCGAGACATGGGATGCTTGTAGTGGTGGTAGCTGCGCCGGTTGACTACTGG	CARHGMLVVVVAAPVDYW	IGHV5-51	IGHJ4
TGTGCGGGCGGGACTATGGTTCAGGCTTCTGCTATGGGCCTTGACTACTGG	CAGGTMVQASAMGLDYW	IGHV4-4	IGHJ4
TGTGCGAGAGATCGTACCTCGAGGACCGGGAACTTTGACTACTGG	CARDRTSRTGNFDYW	IGHV4-59	IGHJ4
TGTGCGAGTTATTATGATTACATTTGGGGGAGTTATCGTTATTTGGGCGGTGACTACTGG	CASYYDYIWGSYRYLGGDYW	IGHV3-53	IGHJ4
TGTGCGAATTACTTACGATTTTTGGTAAAGTACTACTACTACTACATGGACGTCTGG	CANYLRFLVKYYYYYMDVW	IGHV1-2	IGHJ6
TGTGCGAGAGGCGGGAATCATTACTATGATAGTAGTGGTTATTACTACCTATGCTGG	CARGGNHYYDSSGYYYLCW	IGHV3-66	IGHJ3
TGTGAGACCAACACGTATTACTATGATAGTAGTGGTTATCCTCGGAGAGGTTTTCGCTACTTTGACTACTGG	CETNTYYYDSSGYPRRGFRYFDYW	IGHV4-59	IGHJ4
TGTGCGAAAGATCGACGGCTTTTCCTGGTTGTGGTGGTGACTGCCCGGTTTAGCATTTACCCCAACTGGTACTTCGATCTCTGG	CAKDRRLFLVVVVTARFSIYPNWYFDLW	IGHV3-NL1	IGHJ2
TGTGCAAAAGATAGAGGATATTGTACTGGTGGTGTATGCTATAAGGTCGGGGCCGACTGG	CAKDRGYCTGGVCYKVGADW	IGHV3-43	IGHJ4
TGTGCGACTCACCGGTCATATTACTATGATAGTAGTGGTTATTACTTCTACTGG	CATHRSYYYDSSGYYFYW	IGHV4-38-2	IGHJ4
TGTGCGAGAGATCCAGTCTCTGGGGGAGTTATCGTCCCGGGCTTTGACTACTGG	CARDPVSGGVIVPGFDYW	IGHV4-61	IGHJ4
TGTGCGAGGCTAGGGACGAACTACTTTGACTACTGG	CARLGTNYFDYW	IGHV1-46	IGHJ4
TGTGCGAGAGTCCAAAATATTGTAGTAGTACCACCGGACTACTACTACTACATGGACGTCTGG	CARVQNIVVVPPDYYYYMDVW	IGHV1-18	IGHJ6
TGTGCAAGAGATCATGATTACGATATTTTGACTGTGAGCTCCGAATACTACTACTACATGGACGTCTGG	CARDHDYDILTVSSEYYYYMDVW	IGHV3-74	IGHJ6
TGTGCGAAAGGGGGAGATAGTGGGAGCTACTCCCGTCGGCATGACTACTTTGACTACTGG	CAKGGDSGSYSRRHDYFDYW	IGHV3-NL1	IGHJ4
TGTGCGAGAGCAACCCATATTGTAGTAGTACCAGCTGGGGGACTGTGGTTCGACCCCTGG	CARATHIVVVPAGGLWFDPW	IGHV7-4-1	IGHJ5
TGTGCGAGAGCACCATATGCAGTAAGCCCGTATTGTAGTGGTGGTAGCTGCTACCGAATTTATGATCGTCGGGCCTGGCCTTACTACTACTACTACTACATGGACGTCTGG	CARAPYAVSPYCSGGSCYRIYDRRAWPYYYYYYMDVW	IGHV4-59	IGHJ6
TGTGCACGGATACAGGTGTACGGTGACTACGATTACTCTAACGACTACTGG	CARIQVYGDYDYSNDYW	IGHV2-70	IGHJ4
TGTGCGAGAGTATTGTTACGATTTTTGGAGTGGTTACCTTACTACTACTACTACTACATGGACGTCTGG	CARVLLRFLEWLPYYYYYYMDVW	IGHV4-34	IGHJ6
TGTGCGACCATTGTAGTAGTACCAGCTGCTATGCTGGGTCGGATATATAACTACTACTACTACATGGACGTCTGG	CATIVVVPAAMLGRIYNYYYYMDVW	IGHV3-11	IGHJ6
TGTCGCGGGGTTCTAGGATATTGTAGTGGTGGTAGCTGCTTGGGCTGGTTCGACCCCTGG	CRGVLGYCSGGSCLGWFDPW	IGHV3-15	IGHJ5
TGTGCACACAGACAGAAAATTTATTATGGTTCAGGGAGTTCGGCGAAGTACTACTTTGACTACTGG	CAHRQKIYYGSGSSAKYYFDYW	IGHV2-5	IGHJ4
TGTGCAAGAGAGTATCGGCCCGAACGGGGGGGGGCCATCATTTGGTATAATCGTAGTACCAGCTGCTATTGGGTTGACTACTGG	CAREYRPERGGAIIWYNRSTSCYWVDYW	IGHV3-74	IGHJ4
TGTGCGAGAGATCCGTTCGGTATAACTGGAACGACGTCCCGCCTATACTGG	CARDPFGITGTTSRLYW	IGHV3-66	IGHJ4
TGTGCGAGAGATCTTTTTCATCCTCCATACGCTGACTACTGG	CARDLFHPPYADYW	IGHV1-2	IGHJ4
TGTGCGAGAGAAACCGCCGCAGTGGCAGCCGGCGATCCTGCTTTTGATATCTGG	CARETAAVAAGDPAFDIW	IGHV4-34	IGHJ3
TGTGCGAAATTGACCCAGCTGGTACCTAAGGGCCTTTACTTTGACTACTGG	CAKLTQLVPKGLYFDYW	IGHV3-23	IGHJ4
TGTGCGAGAGATCCCTGGCTTCCTTTTCTATGGTTCGGGGAGTTAGGGGTCAGTGACGCCTGG	CARDPWLPFLWFGELGVSDAW	IGHV1-46	IGHJ5
TGTGCGAGAGATCTGGGGGTACCACTTTCCCTCTTTGACTACTGG	CARDLGVPLSLFDYW	IGHV4-61	IGHJ4
TGTGCAAGAGATAATGTGGCAGCAGTCTGGAGGGCGCTTGACTACTGG	CARDNVAAVWRALDYW	IGHV3-13	IGHJ4
TGTGCGAGACTACGCTATGATAGTAGTGGTTATTACTCCCCGGTGCCCTACTGG	CARLRYDSSGYYSPVPYW	IGHV4-39	IGHJ4
TGTGCGAGGCCCTCCAGCAGCTCGTCACTTAGAACGGAAGAGTACAACTGGTTCGACCCCTGG	CARPSSSSSLRTEEYNWFDPW	IGHV1-3	IGHJ5
TGTGCGAGACCCCAAATATTGTACTGGTGGTGTATGCAGGGGCGGGCGGAAAATAGGGGGTACTGGTACTTCGATCTCTGG	CARPQILYWWCMQGRAENRGYWYFDLW	IGHV3-20	IGHJ2
TGTGCGAGAGCGGGGGGAATTGTACTGGGCTGTGTTCCCTACTACTACTACTACATGGACGTCTGG	CARAGGIVLGCVPYYYYYMDVW	IGHV3-21	IGHJ6
TGTGCGAAAGATCAACCAGTATTACGATTTTTGGAGTGGTTATTGTTATCATGTATTGACTACTGG	CAKDQPVLRFLEWLLLSCIDYW	IGHV3-23	IGHJ4
TGTGCGAGAGGAGAGGGGGGGGTGACGTACTGGTGGCTTTGCGACTACTGG	CARGEGGVTYWWLCDYW	IGHV4-34	IGHJ4
TGTGCGGCAGATCCGGGTCGTATTACGATTTTTGGAGTGGTTATTACGGATGACTACTGG	CAADPGRITIFGVVITDDYW	IGHV1-58	IGHJ4
TGTGCGAGAGATTCCCCTTACGATATTTTGACTGGTTATTATGGGTCGTTCTACTACTACTACTACATGGACGTCTGG	CARDSPYDILTGYYGSFYYYYYMDVW	IGHV1-46	IGHJ6
TGTGCGAGACCTATTACTATGATAGTAGTGGTTATTACTACGTTCCCTCCGCCTTACTACTTTGACTACTGG	CARPITMIVVVITTFPPPYYFDYW	IGHV1-3	IGHJ4
TGTGCGAAAGATAATGCCCTGGGATACAGCTACAACTGGTTCGACCCCTGG	CAKDNALGYSYNWFDPW	IGHV3-23	IGHJ5
TGTGCGAAAGACGCATTTGGGGGAGTTATCGTTGGCATGAAGGCAGGGGGCAAAGATGACTACTGG	CAKDAFGGVIVGMKAGGKDDYW	IGHV3-23	IGHJ4
TGTGCGAGCACCCCCGGTGGCTACGATTTATTTGACTACTGG	CASTPGGYDLFDYW	IGHV3-53	IGHJ4
TGTGCGAGAGATGCGGGGGAAGACCCCCAGCTATGGCTAATAACTTGGACTCCTTTGATAATCCTCTACTTTGACTACTGG	CARDAGEDPQLWLITWTPLIILYFDYW	IGHV3-64	IGHJ4
TGTGCGAGAGTACGGTCTGGGGCTCGGAGCAGCTCGGGGGGCGGCGGATTTCTCTACTGG	CARVRSGARSSSGGGGFLYW	IGHV3-7	IGHJ4
TGTGCAAGAGATAGCCACTCATATTTTGGAGTGGTTTGGCCCCTCGGTCGCAGGTTCGACCCCTGG	CARDSHSYFGVVWPLGRRFDPW	IGHV3-74	IGHJ5
TGTGCACGGATCGGGCTATATTACGATTTTTGGAGTGGTTGGCGGGCTTACTACTACTACTACATGGACGTCTGG	CARIGLYYDFWSGWRAYYYYYMDVW	IGHV2-70	IGHJ6
TGTGCGAGAGATGGGTCGCGGGGGGATCCCAAACGTATGACTTTGGAGTGGTTATCTCGGGACTTCCAGCACTGG	CARDGSRGDPKRMTLEWLSRDFQHW	IGHV1-3	IGHJ1
TGTGCGAGAGCCCCCGGTTTGTACTGGTGGTGTATGCTTTACATCCAAGGGTTTACTTCCTACTACTACTACTACATGGACGTCTGG	CARAPGLYWWCMLYIQGFTSYYYYYMDVW	IGHV4-59	IGHJ6
TGTGCGAAAGATGCGGTTCCTCCCTACGGTGACTACGGGCTGCACTGG	CAKDAVPPYGDYGLHW	IGHV3-NL1	IGHJ4
TGTGCGAGATACCACAGAAATAGCAGTGGCTGGAATTCTGACTACTGG	CARYHRNSSGWNSDYW	IGHV4-34	IGHJ4
TGTGCGAGTCCCCCTTATTGTAGTAGTACCAGCTGCTATCCTAACCTGCTGAACTACTACATGGACGTCTGG	CASPPYCSSTSCYPNLLNYYMDVW	IGHV1-2	IGHJ6
TGTGCGAGAGATCTGGGACGGCCGCTAGGCTATGATAGTAGTGGTTATTGGATGGGTTGGTACTTCGATCTCTGG	CARDLGRPLGYDSSGYWMGWYFDLW	IGHV4-4	IGHJ2
TGTGCACGGGGTTATGGTTACGATTTTTGGAGTGGTGTTGTTGCTGGAAAAATGGTTGACTACTGG	CARGYGYDFWSGVVAGKMVDYW	IGHV2-70	IGHJ4
TGTGCGAGAGGCTACGGTGACTACGGCGAATACTTCCAGCACTGG	CARGYGDYGEYFQHW	IGHV4-34	IGHJ1
TGTGCGAGGGTGGTAACGTCTGGAGTTATCGTTAACCACTACTACTACTACTACTACATGGACGTCTGG	CARVVTSGVIVNHYYYYYYMDVW	IGHV7-4-1	IGHJ6
TGTGCGAGACCAGAGGGACGAATTACTATGATAGTAGTGGTTAACGTCTACTTTGACTACTGG	CARPEGRITMIVVVNVYFDYW	IGHV4-34	IGHJ4
TGTGCGAGAGACCATTGTAGTGGTGGTAGCACTGACTACTGG	CARDHCSGGSTDYW	IGHV3-64	IGHJ4
TGTGCGAGAGGCTACGATTTTTGGAGTGGTTATTATACCCCATGGGGGGAAGGGGGCTACTACTACTACTACATGGACGTCTGG	CARGYDFWSGYYTPWGEGGYYYYYMDVW	IGHV4-38-2	IGHJ6
TGTGCGAAAGATCCCAAACGCTACTACATGGACGTCTGG	CAKDPKRYYMDVW	IGHV3-23	IGHJ6
TGTGCGAGAGATCCGCTACGGTACAGCTATGGTTACGGCGACTACTGG	CARDPLRYSYGYGDYW	IGHV1-69	IGHJ4
TGTGCGAGATACAGATATTGTGGTGGTGACTGCTATGGGGGGAGATACTTCCAGCACTGG	CARYRYCGGDCYGGRYFQHW	IGHV4-61	IGHJ1
TGTGCGAGACACCCGGTGGCTACGATTTTTGGAGTGGTTATTCTAGCTCCGCACCACAACTGGTTCGACCCCTGG	CARHPVATIFGVVILAPHHNWFDPW	IGHV4-39	IGHJ5
TGTGCGATGCTATTGTACTACGGTGACTATATGGTTTATGACTACTGG	CAMLLYYGDYMVYDYW	IGHV3-NL1	IGHJ4
TGTGCGAGAGATCACAAGGGACTAAATATTACTATGGTTCAGGGGACCTACTGG	CARDHKGLNITMVQGTYW	IGHV3-7	IGHJ4
TGTGCGAGAGCTGGAGGGGGTATTACGATTTTTGGAGTGGTTATTATACCTATGGCCTACTACTACTACTACATGGACGTCTGG	CARAGGGITIFGVVIIPMAYYYYYMDVW	IGHV1-2	IGHJ6
TGTACGTCGGTAGCTGCTATCTACTACTTTGACTACTGG	CTSVAAIYYFDYW	IGHV3-9	IGHJ4
TGTGCTATTTCCTTCCCCTACCTAGGAGCTGAATACTTCCAGCACTGG	CAISFPYLGAEYFQHW	IGHV3-23	IGHJ1
TGTGCGAGAGATTTTGGGGCTGACTTTTTGGAGTGGTTAATGGCCCCCCATGATGCTTTTGATATCTGG	CARDFGADFLEWLMAPHDAFDIW	IGHV1-18	IGHJ3
TGTGCGAGGTTGGATAGTACCGTACTACGAGAACAGAGCCCTCAGTGCGACCTACTCCTCCCGCTCTGG	CARLDSTVLREQSPQCDLLLPLW	IGHV1-2	IGHJ3
TGTGCGAGAGATATAATTGTAGTAGTACCAGCTGCTTCTTATTACTACTACTACTACTACATGGACGTCTGG	CARDIIVVVPAASYYYYYYYMDVW	IGHV3-30	IGHJ6
TGTGCGAGAGATGGCAGTGGCTGGAACCCCTACTGG	CARDGSGWNPYW	IGHV3-53	IGHJ4
TGTGCAAGAGATGCAGAGGGGAATTGTAGTAGTACCAGCTGCTATCGGGGCTACTACTACTACATGGACGTCTGG	CARDAEGNCSSTSCYRGYYYYMDVW	IGHV3-13	IGHJ6
TGTACTATACCGGGCCGGTTCAGGGAGTTCGCCTACTACTACTACTACATGGACGTCTGG	CTIPGRFREFAYYYYYMDVW	IGHV3-49	IGHJ6
TGTGCGAGGACCGAAAGCAGTGGCTGGTACCTCTTGGACGACTACTGG	CARTESSGWYLLDDYW	IGHV1-69	IGHJ4
TGTACTAGACGATGGCCCACGGGATATAGTGGCTACCTGGCAGGCCCCGGCCTCCCAGTTGACTACTGG	CTRRWPTGYSGYLAGPGLPVDYW	IGHV3-73	IGHJ4
TGTGCACGGTACTATGATAGTAGTGGAGTTGACTACTGG	CARYYDSSGVDYW	IGHV2-70	IGHJ4
TGTGCGAGAGAAATAACTATGGTTCAGGGAGTTATGATATACTGGTGCCTTATGTACTACTACTACTACTACATGGACGTCTGG	CAREITMVQGVMIYWCLMYYYYYYMDVW	IGHV5-10-1	IGHJ6
TGTGCAACAGAAGAGCGGAAGGGTCGTAGTAACACCCCGGTCCGGGGGAATTACTATGATAGTAGTGGTGTGGACTACTGG	CATEERKGRSNTPVRGNYYDSSGVDYW	IGHV1-24	IGHJ4
TGTGCGAGTTGTATTGTAGTGGTGGTAGCTGCTGACCACTTTGACTACTGG	CASCIVVVVAADHFDYW	IGHV1-69	IGHJ4
TGTGCGAGAGTGCCTCTATACACGATTGTGGTGGTGACCAACAACTGGTTCGACCCCTGG	CARVPLYTIVVVTNNWFDPW	IGHV3-53	IGHJ5
TGTGCGAGAGAAAATTACTATGATAGTAGTGGTTATCGCAACTACTGG	CARENYYDSSGYRNYW	IGHV1-18	IGHJ4
TGTGCAAACTGTCGAGCTTGTACTAATGGTGTATGCTATATAGGGACCCGTGATGCTTTTGATATCTGG	CANCRACTNGVCYIGTRDAFDIW	IGHV3-43	IGHJ3
TGTGCGAGAGATGGAGTTGGCCCCACTGGTGGTGTATGCTATCCGGAGTGCGGTTTTGACTACTGG	CARDGVGPTGGVCYPECGFDYW	IGHV1-2	IGHJ4
TGTACCACAGAATGTAGAGGGGAAGACCCGTGTCAGTTGCTTGTATATAGCAGTGGCGTTCTTGACTACTGG	CTTECRGEDPCQLLVYSSGVLDYW	IGHV3-15	IGHJ4
TGTGCGAGAGATAATCCAACAACCGCTCGAATTGTATACTACTACTACTACATGGACGTCTGG	CARDNPTTARIVYYYYYMDVW	IGHV3-20	IGHJ6
TGTGCGAGAACCCGGAAACATGGGCAGTGGCTGGTACGTAACCTCCTTGTTGCTTTTGATATCTGG	CARTRKHGQWLVRNLLVAFDIW	IGHV4-61	IGHJ3
TGTGCGACCGGTACGATTTTTGGAGTGGTTATTATTTCCCGGGAGAACTACTGG	CATGTIFGVVIISRENYW	IGHV3-23	IGHJ4
TGTGCGAGAGGGGTTTTTGATACGGTGGTAACGAACACCGGGTACTGG	CARGVFDTVVTNTGYW	IGHV1-3	IGHJ4
TGTGCGAGACATAGTTTACGATTTTTGGAGTGGTACTACTACTACATGGACGTCTGG	CARHSLRFLEWYYYYMDVW	IGHV5-51	IGHJ6
TGTGCGAGACGATTCGAAGGGGATTACGATTTTTGGAGTGGTTATCTAATAAGTCTTGAGGGGGATACGGACAATTCTTATAACTACTACTACTACTACATGGACGTCTGG	CARRFEGDYDFWSGYLISLEGDTDNSYNYYYYYMDVW	IGHV4-38-2	IGHJ6
