TGTGCGAGAGCTCCACGTCATCGACACCTCCCCAATTACTATGATAGTAGTGGTTATTACCCCTACTGG	CARAPRHRHLPNYYDSSGYYPYW	IGHV4-4	IGHJ4
TGTGCGAGAGATGCATTACATGGGAAATTTGACTACTGG	CARDALHGKFDYW	IGHV1-18	IGHJ4
TGTGCGGGACAGGATTACTATGGTTCAGGGAGTAGCCCGTACTACTACTACTACTACATGGACGTCTGG	CAGQDYYGSGSSPYYYYYYMDVW	IGHV1-2	IGHJ6
TGTGCGAGAGAATTTGACTACGGTGACTACGCGGCCAGCCGCGGCTGG	CAREFDYGDYAASRGW	IGHV3-21	IGHJ4
TGTGCGAGAGTAAATATTTGCGGGGTAGTAGTACCAGCTGCTATGGGGTACTACTACTACATGGACGTCTGG	CARVNICGVVVPAAMGYYYYMDVW	IGHV3-7	IGHJ6
TGTGCACGGATACCCGATTTTTGGAGTGGTTATTATCCCTACTGG	CARIPDFWSGYYPYW	IGHV2-26	IGHJ4
TGTACCACAGATCACGCAACGTGGATACAGCTATGGACCAGGATTCGGGGGTCAGACTACTGG	CTTDHATWIQLWTRIRGSDYW	IGHV3-15	IGHJ4
TGTGCGAGTCGGGGGTGCCGATCCATTACTATGGTTCAGGGAGTTATTTACCATGATGCTTTTGATATCTGG	CASRGCRSITMVQGVIYHDAFDIW	IGHV4-59	IGHJ3
TGTGCGAGATATTGTAGTAGTACCAGCTGCTACCACTGGTTCGACCCCTGG	CARYCSSTSCYHWFDPW	IGHV1-69	IGHJ5
TGTGCAAGAAAATGTCATTGTACTGGTGGTGTATGCTATAAGGTTGACTACTGG	CARKCHCTGGVCYKVDYW	IGHV1-45	IGHJ4
TGTGCACCCCTGTATAGCAGTGGCTGGTACGGTACTTCACAATTTAATTGCTTTGACTACTGG	CAPLYSSGWYGTSQFNCFDYW	IGHV2-70	IGHJ4
TGTGCACGGATGTACAACCAGTGGCTGGTACGAACCTGCTGG	CARMYNQWLVRTCW	IGHV2-26	IGHJ4
TGTACTAGCGAGGTGGTGATTGCTTTCCTTGACTACTGG	CTSEVVIAFLDYW	IGHV3-73	IGHJ4
TGTGCGAGAGATCCTACCCGGACCGATAGCAGTGGCTGGCGGAAATCCCTTTTCGGGTGCCTAGATGACTACTGG	CARDPTRTDSSGWRKSLFGCLDDYW	IGHV3-21	IGHJ4
TGTGCAAGAGTCCGCTCGCGGTATAGCAGTGGCTGGTCGTTTGACTACTGG	CARVRSRYSSGWSFDYW	IGHV3-74	IGHJ4
TGTGCGAGCGCTGGGCATCGATTTTTGGAGTGTCCCCCGTCAGCCCGGTACTACTACTACTACATGGACGTCTGG	CASAGHRFLECPPSARYYYYYMDVW	IGHV4-34	IGHJ6
TGTGCGAGAGATTATAGCAGTGGCTGTAGGGGGAAAAATGCTTTTGATATCTGG	CARDYSSGCRGKNAFDIW	IGHV3-30	IGHJ3
TGTGCGAGACTTGTAGTGGTGGTAGCTGCTAGTTTCTCCTGGTACTTCGATCTCTGG	CARLVVVVAASFSWYFDLW	IGHV5-51	IGHJ2
TGTGCGAGAGCGTTAGAAAGTATAGGTTTTTTTGGAGTGGTTATTATACCGGTATATATTATTGACTACTGG	CARALESIGFFGVVIIPVYIIDYW	IGHV4-59	IGHJ4
TGTGCGACGGTCCTTGGTCTCCCGGGGGTCGAGTATAGCAGGCCGTACTACTTTGACTACTGG	CATVLGLPGVEYSRPYYFDYW	IGHV5-10-1	IGHJ4
TGTGCGAGAGGCTGGGGGGTAGTACCAGCTGCTACCGCCCCCGATGGACTTGACTACTGG	CARGWGVVPAATAPDGLDYW	IGHV4-34	IGHJ4
TGTGCGAGATGGATGACTCACTACTGG	CARWMTHYW	IGHV3-21	IGHJ4
TGTGCGAAAGATCCCAGGATTGTAGTAGTACCAGCTGCTATCGTTACCGCGTTCTCTTCGGCGGCTCTATATGATCAGTGG	CAKDPRIVVVPAAIVTAFSSAALYDQW	IGHV3-NL1	IGHJ4
TGTGCGAGAGATCTACTAAGGATAAAGGGAACTTCCCTTTGTAGTAGTACCAGCTGCTACCTGAGGAACTGGTTCGACCCCTGG	CARDLLRIKGTSLCSSTSCYLRNWFDPW	IGHV4-59	IGHJ5
TGTGCGAAAGATCCTTATAGCAGCAGCTGGTACCCTTGTGACTTTGACTACTGG	CAKDPYSSSWYPCDFDYW	IGHV3-23	IGHJ4
TGTGCGAGACATGGGTCGAATTGTAGTAGTACCAGCTGCTATGATGGGACTAAATTCGACCCCTGG	CARHGSNCSSTSCYDGTKFDPW	IGHV5-51	IGHJ5
TGTGCGAGAGATCATTTCCCCAAGCCCCCCCCGGAGCGTGGGAGCTACCCGGTGGGGTTTGACTACTGG	CARDHFPKPPPERGSYPVGFDYW	IGHV1-69	IGHJ4
TGTGCGAAAGATACTCCCTTGTATAGCAGCTCGTCTTACGGTGACTACTGG	CAKDTPLYSSSSYGDYW	IGHV3-NL1	IGHJ4
TGTGCACGGATACTACGATTTTTGGAGTGGTTATGCGGAGAGTGGTATTACTACTACTACTACTACATGGACGTCTGG	CARILRFLEWLCGEWYYYYYYYMDVW	IGHV2-26	IGHJ6
TGTGCGAGAGAGCCGAGAGCAGCAGCTGCTCCAATTTCGCGGTTCGACCCCTGG	CAREPRAAAAPISRFDPW	IGHV3-66	IGHJ5
TGTGCGAAAGATCATGCCGTATTACGATTTTTGCTTCCGGGCGGAGGCTGGTTCGACCCCTGG	CAKDHAVLRFLLPGGGWFDPW	IGHV3-23	IGHJ5
TGTGCGAGACCTTTGGGTAGACCAGTAGCAGCAATCTGTATCCAGCACTGG	CARPLGRPVAAICIQHW	IGHV5-51	IGHJ1
TGTGCACACAGACCTACGCACTGCTTACTATGGTTCAGGGAGTTATGGTCGTCCTGGTTCGACCCCTGG	CAHRPTHCLLWFRELWSSWFDPW	IGHV2-5	IGHJ5
TGTGCGAGAGACCTGGCCCGGCCTCAGTTAGCAGTGGCTGGCGCCTACTTTGACTACTGG	CARDLARPQLAVAGAYFDYW	IGHV3-7	IGHJ4
TGTGCAAGATACCTAGCAGCTCGTCCCAGCTCCTACTACTACTACATGGACGTCTGG	CARYLAARPSSYYYYMDVW	IGHV1-45	IGHJ6
TGTGCGAGAGCTAGTGTTGTAGTGGTGGTAGCTGCTACTGATTCCGACTACTGG	CARASVVVVVAATDSDYW	IGHV1-46	IGHJ4
TGTGCGAAACCCTCCGATTACGATATTTTGACTGGTTATCTTCGTCACTGGTTCGACCCCTGG	CAKPSDYDILTGYLRHWFDPW	IGHV3-23	IGHJ5
TGTGCGAAAGATTCAGTTCCAGAACGTATTACGATTTTTGGAGTGGTCTTTGCCAACTACTACTACTACTACATGGACGTCTGG	CAKDSVPERITIFGVVFANYYYYYMDVW	IGHV3-23	IGHJ6
TGTGCGAGAGTGTTGGGGGGTTACGATTTTTGGAGTGGTTATTATTTTTACTACTTTGACTACTGG	CARVLGGYDFWSGYYFYYFDYW	IGHV3-NL1	IGHJ4
TGTGCGAGACTGTTTAACGATTTTTGGAGTGGTTATTATGGGTACTACTACTACTACATGGACGTCTGG	CARLFNDFWSGYYGYYYYYMDVW	IGHV5-51	IGHJ6
TGTGCGAGAGGCGTGGCTACAATTATCTGG	CARGVATIIW	IGHV4-34	IGHJ4
TGTGCAAGAATCCCCCCCACGTATTACGATTTTTGGAGTGGTTATTATGGGTCCAATCCCGCATGGGGGGTAATAGTGGTGTCGACCAACTGGTTCGACCCCTGG	CARIPPTYYDFWSGYYGSNPAWGVIVVSTNWFDPW	IGHV3-13	IGHJ5
TGTGCGAGAGTGGTGGGGACAAGCCGGATAGCAGCAGCTGGTGCCACTTTTGCCGCGCAGTACTACTTTGACTACTGG	CARVVGTSRIAAAGATFAAQYYFDYW	IGHV4-34	IGHJ4
TGTACTAGAGACCGGGGGAGGAACCTTATTGTAGTAGTACCAGCTGCTATGAGGGAGAGGGGTCCTGGTGACTACTGG	CTRDRGRNLIVVVPAAMRERGPGDYW	IGHV3-49	IGHJ4
TGTGCTATTAAGGGGCCCCTTGTAGTGGTGGTAGCAGGTTCCGGAAGCGGCATTAATCCGGAGGGGGCCCCCTGG	CAIKGPLVVVVAGSGSGINPEGAPW	IGHV4-38-2	IGHJ5
TGTGCGAGACAGATTCAGCAGCTGGTACGCTGTGACTACTGG	CARQIQQLVRCDYW	IGHV3-11	IGHJ4
TGTGCAAAAGACGGTATTGATTACGATATTTTGACTGGTCGTGGCCGCCTTGGAGTGTTTGACTACTGG	CAKDGIDYDILTGRGRLGVFDYW	IGHV3-43	IGHJ4
TGTGCAAAAGGGGCCCAGACGCGGGGCTACTACTACATGGACGTCTGG	CAKGAQTRGYYYMDVW	IGHV3-43	IGHJ6
TGTGCGAGCGAACCTATGATAGTAGTGGTTATTACTACACAGGAAGTTACTGACTACTGG	CASEPMIVVVITTQEVTDYW	IGHV4-4	IGHJ4
TGTGCGAGTCTAACGATGATTACATTTGGGGGAGTTATCGCAGTCCCCTACTACTACATGGACGTCTGG	CASLTMITFGGVIAVPYYYMDVW	IGHV1-46	IGHJ6
TGTGCGAAATGGAGTGGTGTATGCTATAAAGGAAGGGACCGGGGGGCTGGCTACTACTACTACTACATGGACGTCTGG	CAKWSGVCYKGRDRGAGYYYYYMDVW	IGHV3-NL1	IGHJ6
TGTACCACAGATCACCGTAGCCCATATTGTAGTAGTACCAGCTGCTATGTGTACTACTACTACTACTACATGGACGTCTGG	CTTDHRSPYCSSTSCYVYYYYYYMDVW	IGHV3-15	IGHJ6
TGTGCGAGAGATTTATATCCCTATTGTAGTAGTACCAGCTGCTATGAATTCTGG	CARDLYPYCSSTSCYEFW	IGHV3-53	IGHJ5
TGTGCACACAGACCTGAATACCATTGTAGTGGTGGTAGCTGCTACCTAGATCTTGACTACTGG	CAHRPEYHCSGGSCYLDLDYW	IGHV2-5	IGHJ4
TGTGCGAGACATCAGGAGGATGAGGATATTGTAGTAGTACCAGCTGCCCGAGGCTACTACTACTACTACTACATGGACGTCTGG	CARHQEDEDIVVVPAARGYYYYYYMDVW	IGHV4-39	IGHJ6
TGTACCACTACCGTAGCAGCAGCTGGTACTTGTTTTGACTACTGG	CTTTVAAAGTCFDYW	IGHV3-15	IGHJ4
TGTGCGAAAGGCCTGACCCAGTATTGTAGTAGTACCAGCTGCTATAACGATGACTACTGG	CAKGLTQYCSSTSCYNDDYW	IGHV3-23	IGHJ4
TGTGCAAGAGATGAAGCCGTGGCAGGGCGGATACAGCTATGGAGATGGTTCGACCCCTGG	CARDEAVAGRIQLWRWFDPW	IGHV3-13	IGHJ5
TGTGCGAAAGGAGGGGGAATAGTAGTACCAGCTGCTATCGGGGCAACTGACTACTGG	CAKGGGIVVPAAIGATDYW	IGHV3-23	IGHJ4
TGTGCGAGAATGAGTGGTTCAGGGAGGGCACCCGGACCCTTTGACTACTGG	CARMSGSGRAPGPFDYW	IGHV3-11	IGHJ4
TGTGCGAGAAGCTATAGCAGCAGCTGGTACGTGGCCACGCGCTGG	CARSYSSSWYVATRW	IGHV4-38-2	IGHJ4
TGTGCGAAAGCCTCCTCTACTAATCTTATTCAAGGACAGGTGACGGTGACCAACCGGGGTCCGTACTTCGATCTCTGG	CAKASSTNLIQGQVTVTNRGPYFDLW	IGHV3-NL1	IGHJ2
TGTGCGAGATCCCAGACCGCGTTTGGGGGAGTTATCGGGGGATTAGGGGTGAAAACGGACTTTGACTACTGG	CARSQTAFGGVIGGLGVKTDFDYW	IGHV5-10-1	IGHJ4
TGTGCGAGAGGATCCGGGTTCCATTACTATGATAGTAGTGGTTATTACTACCGAATGGCTGACTACTGG	CARGSGFHYYDSSGYYYRMADYW	IGHV4-61	IGHJ4
TGTGCACGGAGGCGTAGTACCAGCTGCTATCAGTACTTTGACTACTGG	CARRRSTSCYQYFDYW	IGHV2-70	IGHJ4
TGTGCGAAAGATAGCGCGTTGGTTCGGGGAGTTATTAGTCATGACTACTGG	CAKDSALVRGVISHDYW	IGHV3-NL1	IGHJ4
TGTACTAGAGATCCCTCTCGCCACCAGTATTGTAGTGGTGGTAGCTGCTACTCGTTGCATTCCCCTTACATGTACTACTTTGACTACTGG	CTRDPSRHQYCSGGSCYSLHSPYMYYFDYW	IGHV3-49	IGHJ4
TGTGCGAGAAACATCGGATATTGTAGTAGTACCAGCTGCTCTCCGTCTTACTACTACTACTACTACATGGACGTCTGG	CARNIGYCSSTSCSPSYYYYYYMDVW	IGHV3-20	IGHJ6
TGTGCGAGACGCCTCGTGGTTATTACAACTTACTTTGACTACTGG	CARRLVVITTYFDYW	IGHV5-51	IGHJ4
TGTGCACGGATTTTGCAAGGGGCTCCCCAGGTTAGGCGGTCAAACCTAAAGGTGTATGCTAGGGGACTTGGTTACTGGTTCGACCCCTGG	CARILQGAPQVRRSNLKVYARGLGYWFDPW	IGHV2-26	IGHJ5
TGTGCGAGAGGGGCGGGGCGCAGCAGCTACCGGCCTCACTGGTTCGACCCCTGG	CARGAGRSSYRPHWFDPW	IGHV4-38-2	IGHJ5
TGTGCGAGAGACCCCCCCGATTTTTGGAGTGGTTATTATACCGACTACTACTACTACTACATGGACGTCTGG	CARDPPDFWSGYYTDYYYYYMDVW	IGHV1-69	IGHJ6
TGTGCGAGACTTACGATTTTTGGAGTGGTGGCCTACTACTACTACTACATGGACGTCTGG	CARLTIFGVVAYYYYYMDVW	IGHV5-51	IGHJ6
TGTGCGAGAGGGGCGCCTATACTCAGTAGCCGTACTATAGCAGCAGCTGGTACTACTGACTACTGG	CARGAPILSSRTIAAAGTTDYW	IGHV3-64	IGHJ4
TGTGCGAAAGAGGGAGCAAACACCATACAGCTATGGTTACCAAACTGGTTCGACCCCTGG	CAKEGANTIQLWLPNWFDPW	IGHV3-NL1	IGHJ5
TGTGCGAGAGCGAAGATCTGCCGGGACTTAGGGGATATTACTATGATAGTAGTGGTTATTACTCCGCGACGCGACTTTGACTACTGG	CARAKICRDLGDITMIVVVITPRRDFDYW	IGHV3-33	IGHJ4
TGTGCGAGAGATGGGCGGTATAGCAGTGGCTGGTACAGATTCTGG	CARDGRYSSGWYRFW	IGHV3-21	IGHJ4
TGTGCGAGAAAGGATATTGTAGTGGTGGTAGCTGCTCCCTTTTTTCAGGAAGACTACTGG	CARKDIVVVVAAPFFQEDYW	IGHV5-51	IGHJ4
TGTGCAAGAGATTCTGGGGCAAGAGCAGTGGCTGGGGTTTACTACTTTGACTACTGG	CARDSGARAVAGVYYFDYW	IGHV3-13	IGHJ4
TGTGCGAGAGATCGGGATAACTGGGGCATTCCCTGTAGCTACTGGTACTTCGATCTCTGG	CARDRDNWGIPCSYWYFDLW	IGHV4-59	IGHJ2
TGTGCGAGAGACGGGGTAGATTGTAGTAGTACCAGCTGCTATACATACTCTTTAATTCCCCTGGACAGTGACTACTGG	CARDGVDCSSTSCYTYSLIPLDSDYW	IGHV1-2	IGHJ4
TGTGCGAAAGATCAAAATTGTAGTGGTGGTAGCTGCTACGAGTCGCACTACTTTGACTACTGG	CAKDQNCSGGSCYESHYFDYW	IGHV3-23	IGHJ4
TGTGCGAGAGCCCGGTATTGTAGTAGTACCAGCTGCTATGTGTGTGTCTTCAACTGGTTCGACCCCTGG	CARARYCSSTSCYVCVFNWFDPW	IGHV1-2	IGHJ5
TGTGCACGGATACGTAGGGTACGATATTTTGACTGGTTACATTACTACTACTACTACATGGACGTCTGG	CARIRRVRYFDWLHYYYYYMDVW	IGHV2-70	IGHJ6
TGTGCGAGACAGGCGGCCTTGGCACGATGGCTACAATTTAGGTGCTACTGGTACTTCGATCTCTGG	CARQAALARWLQFRCYWYFDLW	IGHV1-3	IGHJ2
TGTGCGAGACCCCAATTTGTCCATAGCAGCTCGTCCAACTGGTTCGACCCCTGG	CARPQFVHSSSSNWFDPW	IGHV3-53	IGHJ5
TGTGCGAGACCCCCATATTGTACTAATGGTGTATGCTCGCCCTACTGG	CARPPYCTNGVCSPYW	IGHV4-38-2	IGHJ4
TGTACTAGAGACTATTGTAGTGGTGGTAGCTGCTATTGCGACTACTGG	CTRDYCSGGSCYCDYW	IGHV3-49	IGHJ4
TGTGCGAGACATCATAGCTGTTCAGTGAGTATAGCAGCAGCTGGCAACTGGTTCGACCCCTGG	CARHHSCSVSIAAAGNWFDPW	IGHV5-51	IGHJ5
TGTGCGAGAGTCTCATTCGGGGCCGCCCTACATTCCCGCCTTATAACATTTGACTACTGG	CARVSFGAALHSRLITFDYW	IGHV1-2	IGHJ4
TGTGCGAAAGAACCGCGTAGTGGTTATTACTATTGGCTAGTCCCGTTGGGCCCCTTCCAGCACTGG	CAKEPRSGYYYWLVPLGPFQHW	IGHV3-23	IGHJ1
TGTGCGAGAGACTACGGGAAGTGTATAGCAGCAGGACGAGCCTACTACTACATGGACGTCTGG	CARDYGKCIAAGRAYYYMDVW	IGHV1-2	IGHJ6
TGTGCGAGCACTGTACATTGTACTAATGGTGTATGCTATTCCGTTGACTACTGG	CASTVHCTNGVCYSVDYW	IGHV5-51	IGHJ4
TGTGCGAAAGATCTTCCCTCCACCCGTGAGGGGGGTTTTACTATGATAGTAGTGGCCACTATGCCCTTTGACTACTGG	CAKDLPSTREGGFTMIVVATMPFDYW	IGHV3-NL1	IGHJ4
TGTGCGAGAGTTTGCGCCGCCCTCGCGAATTGTACTAATGGTGTATGCTATACCCACTACTTTGACTACTGG	CARVCAALANCTNGVCYTHYFDYW	IGHV3-20	IGHJ4
TGTGCGAGAGGGGACGCAGCAGCTGGTACGTTCGACCCCTGG	CARGDAAAGTFDPW	IGHV1-2	IGHJ5
TGTACCACAGATGACCGCGGGGACTACTACTACTACTACTACATGGACGTCTGG	CTTDDRGDYYYYYYMDVW	IGHV3-15	IGHJ6
TGTGCGAGAGGTGGGGACTACGTTTGGGGGAGTTATCGTTGCCCACACTACTGG	CARGGDYVWGSYRCPHYW	IGHV3-21	IGHJ4
TGTACTAGACGTCAGCAGTGGCTATGGTTCGACCCCTGG	CTRRQQWLWFDPW	IGHV3-73	IGHJ5
TGTGCGAGTGCTCCTGACTTTGACTACTGG	CASAPDFDYW	IGHV3-21	IGHJ4
