TGTGCGAGAGATCCGCAGTGGCTGGCAAGAATTAATTACTACTTTGACTACTGG	CARDPQWLARINYYFDYW	IGHV1-3	IGHJ4
TGTGCACGGATACTGGGAGAAGTGGCTACGATACCCGGATATTACTACTACTACTACTACATGGACGTCTGG	CARILGEVATIPGYYYYYYYMDVW	IGHV2-70	IGHJ6
TGTGCGAAGCTTCCAAGACGTATTACTATGATAGTAGTGGTTATTACATACTTTGACTACTGG	CAKLPRRITMIVVVITYFDYW	IGHV3-NL1	IGHJ4
TGTCTTCCGAGGAGTTTTGGAGTGGTTATTATTTGTGACTTTGACTACTGG	CLPRSFGVVIICDFDYW	IGHV3-30-3	IGHJ4
TGTGCGAGAGAACCCCTCCTAGGGATCCGGACTAGCCATCACTGG	CAREPLLGIRTSHHW	IGHV3-66	IGHJ4
TGTGCGAGAGGACTACAGTATATGTACTACTTTGACTACTGG	CARGLQYMYYFDYW	IGHV4-38-2	IGHJ4
TGTGCGGCCCTACGATTACGGCTTGTAAGACAGTACTACTACTACTACATGGACGTCTGG	CAALRLRLVRQYYYYYMDVW	IGHV3-23	IGHJ6
TGTGCAAGAGAGACGCGCCCCGGATATGGTTCAGGGAGTTATTATAGGGTCTACTGG	CARETRPGYGSGSYYRVYW	IGHV6-1	IGHJ4
TGTGCGAGAGACCCCCGGGTCGAGCTTGCGAATAACTGGAACGACCTTCCTCGCTACTACTACTACATGGACGTCTGG	CARDPRVELANNWNDLPRYYYYMDVW	IGHV3-20	IGHJ6
TGTGCAAGTTCATGGTGCCTGGGATATTGTAGTAGTACCAGCTGCTATGACCGGTTTTACTTTGACTACTGG	CASSWCLGYCSSTSCYDRFYFDYW	IGHV3-13	IGHJ4
TGTGCGAGAGATGAGGGGGTGGATACAGCTATGGTTACGGCCAAGGACAACTGGTTCGACCCCTGG	CARDEGVDTAMVTAKDNWFDPW	IGHV3-7	IGHJ5
TGTGCGAGTGGGATTGTACTGGTGGTGTATGCTATAGGCTACTACTACTACATGGACGTCTGG	CASGIVLVVYAIGYYYYMDVW	IGHV1-46	IGHJ6
TGTCCCGACCGCGATTACGATTTTTGGAGTGGTTATTCTCGTAACAGTATTGACTACTGG	CPDRDYDFWSGYSRNSIDYW	IGHV3-30-3	IGHJ4
TGTGCGAGGCGGTACCCCCGATTAAGTAGTGGTGGTAGCTGCTACGAGGCCCAGAGGCTTATGGGGAAAACGCCTTATGACTACTGG	CARRYPRLSSGGSCYEAQRLMGKTPYDYW	IGHV4-34	IGHJ4
TGTGGGGGGGTATACTATGGTTCAGGGAGTATTGGAGGTTGTGATGACTACTGG	CGGVYYGSGSIGGCDDYW	IGHV3-21	IGHJ4
TGTGCGAGACCTCCCTCGATTATACAGCTATGGGGAAACTGGTTCGACCCCTGG	CARPPSIIQLWGNWFDPW	IGHV4-38-2	IGHJ5
TGTGCGAGGGTGCGTGATAGTAGTGGTTATTGG	CARVRDSSGYW	IGHV5-10-1	IGHJ5
TGTGCGAGAGCCCGTCGCGAGCTTGCTTGTAGTGGTGGTAGCTGCTACCCTGTAGGCAGCGGAACCAACTGGTTCGACCCCTGG	CARARRELACSGGSCYPVGSGTNWFDPW	IGHV3-30	IGHJ5
TGTGCACGGACGAGGGCTCGTATAGCAGTGGCTGGCCGGTTTGACTACTGG	CARTRARIAVAGRFDYW	IGHV2-70	IGHJ4
TGTGCGAGACAATTCATTGTAGTGGTGGTAGCTGCTACTCCGTTGGACAACTACTACTACTACTACATGGACGTCTGG	CARQFIVVVVAATPLDNYYYYYMDVW	IGHV5-51	IGHJ6
TGTGCGAGCAGACTGGTCAGGAGTATAGCAGCTCGTCCAGCTTTCCTGCCCACCGCCGGTATCTCCCCCTGTAGCCCCGGGGGGTACTACTACTACTACTACATGGACGTCTGG	CASRLVRSIAARPAFLPTAGISPCSPGGYYYYYYMDVW	IGHV3-11	IGHJ6
TGTGCGAGAGTAGCCAGTAAATTACGATATTTTGACTGGTTATTATTGATTAAACCCGTCCAGTCTGCCAAGTACTACTACTACATGGACGTCTGG	CARVASKLRYFDWLLLIKPVQSAKYYYYMDVW	IGHV1-18	IGHJ6
TGTGCGAGACCCCCCTATTGTAGTAGTACCAGCTGCTATAAACCATGGAGAGGATACTACTACTACTACTACATGGACGTCTGG	CARPPYCSSTSCYKPWRGYYYYYYMDVW	IGHV4-39	IGHJ6
TGTGCGAGAGATGGCCAAGGTGGATATTGTAGTAGTACCAGCTGCTATGAATACTACTTTGACTACTGG	CARDGQGGYCSSTSCYEYYFDYW	IGHV3-21	IGHJ4
TGTACCGGGGGCTCAGGTGGTTATTTAGGGTGCCCATGGGCAAGGGGCCACTACTACTACTACTACATGGACGTCTGG	CTGGSGGYLGCPWARGHYYYYYMDVW	IGHV3-15	IGHJ6
TGTGCGAGAGATTCCGAGGTTATTAGGCATGGTTCAGGGAGTTATTATAGGTTCTACATGGACGTCTGG	CARDSEVIRHGSGSYYRFYMDVW	IGHV1-2	IGHJ6
TGTCGGGACGCCCTGACTTCTCCCTACTACTACTACATGGACGTCTGG	CRDALTSPYYYYMDVW	IGHV3-74	IGHJ6
TGTGCGAAACTACCTATTGTGGTGGTGATTGCCATTTTAGTGGTGTCCTTTGACTACTGG	CAKLPIVVVIAILVVSFDYW	IGHV3-NL1	IGHJ4
TGTGCGAGAGATAGGATAAACGATATTTTGACTGGTTATTATATGAAAGACCGCGGCGACTACTGG	CARDRINDILTGYYMKDRGDYW	IGHV1-3	IGHJ4
TGTACACGGGTCCTGGGATATTGTACTGGTGGTGTATGCTATAAAAACCGCCGGACCCTATACTACTACTACTACTACATGGACGTCTGG	CTRVLGYCTGGVCYKNRRTLYYYYYYMDVW	IGHV3-9	IGHJ6
TGTGCGAGAACCCTACGTGGACGAGCTCGACCCTTTGACTACTGG	CARTLRGRARPFDYW	IGHV3-21	IGHJ4
TGTGCACACAACATCCCTCCAGGACTTATTAGTGGCTACGATTCAACTGAGTTCTTTGACTACTGG	CAHNIPPGLISGYDSTEFFDYW	IGHV2-5	IGHJ4
TGTGCGAGAGTAAACGGTATAACTGGAACTACGGGAAACTGGTTCGACCCCTGG	CARVNGITGTTGNWFDPW	IGHV4-61	IGHJ5
TGTGCACGGATAAACTCCGGTGATTGTAGTAGTACCAGCTGCTATGTGCATTGGTTCGACCCCTGG	CARINSGDCSSTSCYVHWFDPW	IGHV2-26	IGHJ5
TGTACCACAGGGGGCCCCAGAAAGTCGCCTTGGTTCACAGCAGTAGTACCAGCTGCTATCGGGAACTGGTTCGACCCCTGG	CTTGGPRKSPWFTAVVPAAIGNWFDPW	IGHV3-15	IGHJ5
TGTACTAGAGGCGAGGGACCTATGTCCGATGAATACTTCCAGCACTGG	CTRGEGPMSDEYFQHW	IGHV3-49	IGHJ1
TGTGCGAGAGATAGGAACGATTTTGGAGTGGTTAGGGTCCTTCGGTACTACTACATGGACGTCTGG	CARDRNDFGVVRVLRYYYMDVW	IGHV3-48	IGHJ6
TGTGCGAGAGCCCGTATTAGACTAGGATATTGTAGTGGTGGTAGCACCGGCTTAAATCCTAGGTACTACTTTGACTACTGG	CARARIRLGYCSGGSTGLNPRYYFDYW	IGHV3-48	IGHJ4
TGTGCGAGAGATATAGCAGCAGCTGGACCCTTTGACTACTGG	CARDIAAAGPFDYW	IGHV3-21	IGHJ4
TGTGCGAGAGATCGGGGGGGGGTGGCTACGCGTTACTACATGGACGTCTGG	CARDRGGVATRYYMDVW	IGHV3-21	IGHJ6
TGTGCGAGAGATCGAAGGGGGGCCGGGAGTTGGGACTTCCTACCTTACTACTACTACTACTACATGGACGTCTGG	CARDRRGAGSWDFLPYYYYYYMDVW	IGHV3-20	IGHJ6
TGTGCGAAAGATGTTACGGTTTTAGCAGTGGCTGGGTTGCAAACACCCCTTTATATTTTCTCGAAACTTAAGGACTACTGG	CAKDVTVLAVAGLQTPLYIFSKLKDYW	IGHV3-NL1	IGHJ4
TGTGCGAGAGTGTCCTTAGTAGTACCAGCTGCTCGATTTGACTACTGG	CARVSLVVPAARFDYW	IGHV1-46	IGHJ4
TGTGCGAGAAAGCGGGGATATTGTAGTAGTACCAGCTGCTATGCGGAGTCCATTGACTACTGG	CARKRGYCSSTSCYAESIDYW	IGHV4-28	IGHJ4
TGTGCGAGACAGAAATGCTATTGTAGTGGTGGTAGCTGCTCGGTTGACTACTGG	CARQKCYCSGGSCSVDYW	IGHV5-51	IGHJ4
TGTGCGAAAGTGGTATTGTACTGGTGGTGTATGCTATACCGGGACTACTACTACATGGACGTCTGG	CAKVVLYWWCMLYRDYYYMDVW	IGHV3-23	IGHJ6
TGTGCGAGAGGTGCATCCCGATCTACGGTGACTACGGGCTACTACTACTACATGGACGTCTGG	CARGASRSTVTTGYYYYMDVW	IGHV1-46	IGHJ6
TGTGCGAGGGCATATTACGATTTTTGGAGTGCCAATATACACTACTACTACTACTACATGGACGTCTGG	CARAYYDFWSANIHYYYYYMDVW	IGHV1-46	IGHJ6
TGTGCGAGAGATGATTGCTACAGTAACTACCCCGACCCGGAACCGTACTACTTTGACTACTGG	CARDDCYSNYPDPEPYYFDYW	IGHV1-46	IGHJ4
TGTGCGAAAGGCCCACGACCACAGTTTGAACGAGGCCCGACCGTGGGTCGCAACTTCCAGCAGCTGGTACGACCGGGCTACTGG	CAKGPRPQFERGPTVGRNFQQLVRPGYW	IGHV3-23	IGHJ4
TGTGCGAAAGCTCCCCCTACGGTGACTACGGTCAACTGGTTCGACCCCTGG	CAKAPPTVTTVNWFDPW	IGHV3-NL1	IGHJ5
TGTGCACGGATATCCTCTCCCACGTATTACGATTTTTGGAGTGGTTATTATATGAGACCACTTGACTACTGG	CARISSPTYYDFWSGYYMRPLDYW	IGHV2-26	IGHJ4
TGTGTCGTCCAGGCGTATAGCAGTGGCTGGCCCCCCTACTACTACTACTACATGGACGTCTGG	CVVQAYSSGWPPYYYYYMDVW	IGHV3-30-3	IGHJ6
TGTACCACAGATCGTTTCCTAGCATATTGTGGCCGAATATCTGACTACTGG	CTTDRFLAYCGRISDYW	IGHV3-15	IGHJ4
TGTGCACGGATACGAAGTAGCAGCTCGTCCACCCTTGACTACTGG	CARIRSSSSSTLDYW	IGHV2-26	IGHJ4
TGTGCGAGAGATATGGGCTCTTTTATGATAGTAGTGGTTATTACTTACAGTTATGACTACTGG	CARDMGSFMIVVVITYSYDYW	IGHV4-4	IGHJ4
TGTGCGAGAGTGTTATCTTTAGCAGTGGCTGGTATAGTTCAAACCTACTGG	CARVLSLAVAGIVQTYW	IGHV3-53	IGHJ4
TGTGCGAGAGGGCCCATAAGTTTTGACTACTGG	CARGPISFDYW	IGHV1-2	IGHJ4
TGTACCACAGCTCCCATTTTTGGAGTGGTTATTATTTGTGACGTAAATTACTTGAGCAATTACTACTACTACTACTACATGGACGTCTGG	CTTAPIFGVVIICDVNYLSNYYYYYYMDVW	IGHV3-15	IGHJ6
TGTGCGAGAGTGACGGGAAGCCTAATAGATGACTACTGG	CARVTGSLIDDYW	IGHV4-34	IGHJ4
TGTGCGAGACTCCTTATTGTAGTGGTGGTAGCTGCTACTCGCGGAAATGCTTTTGATATCTGG	CARLLIVVVVAATRGNAFDIW	IGHV1-46	IGHJ3
TGTGCGAGAGTGGTTAGGGTCGGGGCTCCTAGGTTGGGGAACTGGTTCGACCCCTGG	CARVVRVGAPRLGNWFDPW	IGHV1-46	IGHJ5
TGTGCAACAGATCGAGATAGCCATTACGATATTTTGACTGGTGGAAACTACATGGACGTCTGG	CATDRDSHYDILTGGNYMDVW	IGHV1-24	IGHJ6
TGTGCACGGATACGTATTGTACTGGTGGTGTATGCTATACATTGCCTTAACTGGTTCGACCCCTGG	CARIRIVLVVYAIHCLNWFDPW	IGHV2-70	IGHJ5
TGTGCGAGACATAGGTCAACGGTGTTCGTGCGCTACATGGACGTCTGG	CARHRSTVFVRYMDVW	IGHV5-51	IGHJ6
TGTGCACGGATACCCATCGGTTTTTTACCAGCTGCTATGTACCTAAGACGGTGGGTCCGCACGGGTAAGTCATATACCTACTACTTTGACTACTGG	CARIPIGFLPAAMYLRRWVRTGKSYTYYFDYW	IGHV2-70	IGHJ4
TGTGCGAGAGGGACCGCAGACGTATTACGATTTTTGGAGTGGCCATGG	CARGTADVLRFLEWPW	IGHV1-46	IGHJ5
TGTGCGAGAGGGTTTTCCGGGGGCCATTGGATTACTATGGTTCGGGGAGGGGATTTTGACTACTGG	CARGFSGGHWITMVRGGDFDYW	IGHV4-61	IGHJ4
TGTACTAGATCATTTTGTATTACTATGATAGTAGTGGTGCGATACTACTTTGACTACTGG	CTRSFCITMIVVVRYYFDYW	IGHV3-73	IGHJ4
TGTGCGAGGGGGGTTGTAGTGGTGGTAGGCCATGCTTTTGATATCTGG	CARGVVVVVGHAFDIW	IGHV3-11	IGHJ3
TGTGCGAGAGATTTTCCGCCTTACGGTGACTACGCGGAAGGCGCCAACTGGTTCGACCCCTGG	CARDFPPYGDYAEGANWFDPW	IGHV4-59	IGHJ5
TGTGCGACCGATGACTATTGTAGTAGTACCAGCTGCTATGCGAGGGACTACTGG	CATDDYCSSTSCYARDYW	IGHV3-20	IGHJ4
TGTGCGAGCCGGGAACATTATTGTAGTGGTGGTAGCTGCTACATATTGGATGACTACTGG	CASREHYCSGGSCYILDDYW	IGHV3-30	IGHJ4
TGTGCGAAAGGACGATTTTTGGAGTGGTTATTGACCGTCTTCACGAGAAGAAACTGGTTCGACCCCTGG	CAKGRFLEWLLTVFTRRNWFDPW	IGHV3-NL1	IGHJ5
TGTACTAGACATTGTAGTGGTGGTAGCTGCTACTCCTCCCCCTACTACTACTACTACATGGACGTCTGG	CTRHCSGGSCYSSPYYYYYMDVW	IGHV3-73	IGHJ6
TGTACTAGGGGGACATCCCGGCCCCCGTATGGTTCGGGGAGTTATTCCCAATATGTGTGG	CTRGTSRPPYGSGSYSQYVW	IGHV3-49	IGHJ5
TGTGCACGGAGCCGGTATAGATCCAGATTCTATTACTATGGTTCAGGGAGTTATACCTTTGACTACTGG	CARSRYRSRFYYYGSGSYTFDYW	IGHV2-70	IGHJ4
TGTGCACGGATACCACCTCATTACGATATTTTGACTGGTTATTATAAGGGCTGG	CARIPPHYDILTGYYKGW	IGHV2-26	IGHJ4
TGTGCGAGAAAGGGTGAGATTGTAGTAGTACCAGCTGCAACTTTTGGCTACTACTACTACTACATGGACGTCTGG	CARKGEIVVVPAATFGYYYYYMDVW	IGHV1-46	IGHJ6
TGTGTATCATGGGAGCTACTAGGATTGATACGTGATGCTTTTGATATCTGG	CVSWELLGLIRDAFDIW	IGHV3-30	IGHJ3
TGTGCGAGAGCGTGGGGAAGGTATTGTAGTGGTGGTAGCTGCTACATCCTCCCTTTGCCATACTTTGACTACTGG	CARAWGRYCSGGSCYILPLPYFDYW	IGHV4-59	IGHJ4
TGTGCGAGAATGTATTGTAGTAGTACCAGCTGCTATACCCAGTTCAATATGTCTACTTTTGAAGGGTGGGCCGAGCTAGGGGTATACTTTGACTACTGG	CARMYCSSTSCYTQFNMSTFEGWAELGVYFDYW	IGHV1-46	IGHJ4
TGTGCAAGAGGGGGGGCGGTATTACGATTTTTGGAGTGGTTATTATACCTGGGGTTCCCCCACTTACGGGGATTTGACTACTGG	CARGGAVLRFLEWLLYLGFPHLRGFDYW	IGHV3-13	IGHJ4
TGTGCGAGAGGCCTTTCCGATCTACAAGGTGACTACTCCTTATGGGACTACTACTACTACATGGACGTCTGG	CARGLSDLQGDYSLWDYYYYMDVW	IGHV4-34	IGHJ6
TGTGCGAGACAAGAGAATGTCGTGGGAGCTACTACGTACGGGACTAACTGGTTCGACCCCTGG	CARQENVVGATTYGTNWFDPW	IGHV7-4-1	IGHJ5
TGTGCGAGAGATGTGTCCGGGGATCCACCCGGGTTTGACTACTGG	CARDVSGDPPGFDYW	IGHV3-66	IGHJ4
TGTGCGAGACACGTTCCTCGATATTGTAGTGGTGGTAGCTGCTATCAGGGGTACACCTTTGACTACTGG	CARHVPRYCSGGSCYQGYTFDYW	IGHV5-51	IGHJ4
TGTGCGAGAGATCAGGGGGATAGTAAGATGAGGGCAGTGGCTACGATCAGGGGGGTTAAACTCGGGTACTTCGATCTCTGG	CARDQGDSKMRAVATIRGVKLGYFDLW	IGHV3-30	IGHJ2
TGTGCGAGAGGGCCCCATAGCAGTGGCTGGGCCCCGCACTGGTTCGACCCCTGG	CARGPHSSGWAPHWFDPW	IGHV4-61	IGHJ5
TGTGCGAAAGATGTGGTGATTCGGGAAGTAGGATATTGTAGTGGTGAGGGCTTTGACTACTGG	CAKDVVIREVGYCSGEGFDYW	IGHV3-NL1	IGHJ4
TGTGCGAGAAGGAGCGATAGCGATATTCTCCCGGGTAGAGAAAAGGTTGTAGTGGTGGTAGCTGCTACTCAGAACTACTTTGACTACTGG	CARRSDSDILPGREKVVVVVAATQNYFDYW	IGHV5-10-1	IGHJ4
TGTGCAAGCCCGTTGTATTGTAGTAGTACCAGCTGCTATGGTTACTGG	CASPLYCSSTSCYGYW	IGHV1-18	IGHJ4
TGTGCGAGAGATGTAGAGCAGTTCTTAAGTACCAGCTGCTATGGGGGCGACCCGACGGGTCCATATTGGGTCCCCCTTAACTACTGG	CARDVEQFLSTSCYGGDPTGPYWVPLNYW	IGHV3-7	IGHJ4
TGTGCGAAGAAAAACCCCGGTGGGATTTTTGACTACTGG	CAKKNPGGIFDYW	IGHV3-23	IGHJ4
TGTGCACGGATACCGGAGCTTCTGAGGTCGGAAGGGCCCCCTAGAGCCCTTAACTGGTTCGACCCCTGG	CARIPELLRSEGPPRALNWFDPW	IGHV2-70	IGHJ5
TGTGCGAGAGATATGGACCTAAAGGGTTTAACCCCGGTGGTGGTAGCTGCTACTCACTTCTGGTTCGACCCCTGG	CARDMDLKGLTPVVVAATHFWFDPW	IGHV3-48	IGHJ5
TGTGCGAAAGATTCCATTACTACGGTGACTATTGACTACTGG	CAKDSITTVTIDYW	IGHV3-NL1	IGHJ4
TGTGCGAGAGATCCAGCGGGATACAGCTATGGTTACGGAATTTGCTTTGACTACTGG	CARDPAGYSYGYGICFDYW	IGHV3-53	IGHJ4
TGTGCGAAACCTGGGCTAAACCGTATAGCAGCTCGTCGACGGTACTACTACATGGACGTCTGG	CAKPGLNRIAARRRYYYMDVW	IGHV3-23	IGHJ6
TGTGCGAGACGTCCTTTCGATAGCAGTGGCTGGTACTCGCATGCTTTTGATATCTGG	CARRPFDSSGWYSHAFDIW	IGHV5-51	IGHJ3
