TGTGCGAGAAACACTCCCTGCTATTGTAGTAGTACCAGCTGCTATGCGCCGAATCACAACTGGTTCGACCCCTGG	CARNTPCYCSSTSCYAPNHNWFDPW	IGHV1-18	IGHJ5
TGTACCACAGACTCCTTACGATTTTTGGAGTGGTCATGGTTCGACCCCTGG	CTTDSLRFLEWSWFDPW	IGHV3-15	IGHJ5
TGTGCGAGAGAAGCGGTGATTGTGTCGAAAAACTTTGACTACTGG	CAREAVIVSKNFDYW	IGHV4-61	IGHJ4
TGTGCGAGAGGTAGGCCGTACAGTAACTACGGAGGTACCGAAAATTACTACTACTACTACTACATGGACGTCTGG	CARGRPYSNYGGTENYYYYYYMDVW	IGHV4-38-2	IGHJ6
TGTGCGAGACAGGGTACTAAGGCTCTTCTCATGTTCGACCCCTGG	CARQGTKALLMFDPW	IGHV5-51	IGHJ5
TGTGCGAGACCGGCTGGCTATAGTGGCTACGATTACGACCTGAACTACTACTACATGGACGTCTGG	CARPAGYSGYDYDLNYYYMDVW	IGHV5-51	IGHJ6
TGTGCGAGAGATAGTAGTGGTTATTACGAACCCGGGCCCTTTGACTACTGG	CARDSSGYYEPGPFDYW	IGHV3-7	IGHJ4
TGTGCGGCAGATAGAATGGGGGAAGCAGCAGCTGGTGGACCGTCGAATTTGGCCGTTCACTGGTACTTCGATCTCTGG	CAADRMGEAAAGGPSNLAVHWYFDLW	IGHV1-58	IGHJ2
TGTGCGAGACCCTGGGGGATGCATAGCAGCTCGTCCGTGAAACTTGGATTAGGATTTGACTACTGG	CARPWGMHSSSSVKLGLGFDYW	IGHV4-38-2	IGHJ4
TGTGCGAGAGAAGGAATCCGGCCGATTTTTGGAGTGGGGGCTTGGGAAAACTACTTTGACTACTGG	CAREGIRPIFGVGAWENYFDYW	IGHV5-10-1	IGHJ4
TGTGCGAGAGAGGCCAATCCTCTGGAGCTAGGAAACGTGGCTATGGTTCGGGGAGTTATGAAATGGTTTGACTACTGG	CAREANPLELGNVAMVRGVMKWFDYW	IGHV3-11	IGHJ4
TGTGCGAGAGATCGGGCTTACGATTTTTGGAGTGGTTGCGCGGACTACTGG	CARDRAYDFWSGCADYW	IGHV3-53	IGHJ4
TGTGCGAGGTTATTACGATTTGCGGTAGATCACTACTACTACTACATGGACGTCTGG	CARLLRFAVDHYYYYMDVW	IGHV3-11	IGHJ6
TGTGCGAATTCCCAGCGCGGATACAGTACCAGCTGCTATGTAGATGCTTTTGATATCTGG	CANSQRGYSTSCYVDAFDIW	IGHV3-NL1	IGHJ3
TGTGCGAGAGGATTCCCAATAAGTGAAGTCATCTGG	CARGFPISEVIW	IGHV1-8	IGHJ3
TGTGCGAGAGGCCGTGGAATCCCCGGATCCCCCATTACTATGATAGTAGTGGTTGGGGCGACTCCCTTTGACTACTGG	CARGRGIPGSPITMIVVVGATPFDYW	IGHV4-34	IGHJ4
TGTGCGAAAGGGAGGGGGGAGTATAGCAGCAGCTGGTACGAGACGGACTACTTTGACTACTGG	CAKGRGEYSSSWYETDYFDYW	IGHV3-23	IGHJ4
TGTGCGAGAGATGGGTTAATTGGGTATAGCAGTGGCTGGTACGTGACCCACAACTGGTTCGACCCCTGG	CARDGLIGYSSGWYVTHNWFDPW	IGHV1-18	IGHJ5
TGTGCGATGCCGGCATTCCTTCGTTTAAATGGAACATACCTGTGGGAGCTACTGAAGGTGGGCCTCGGCTGGTACTTCGATCTCTGG	CAMPAFLRLNGTYLWELLKVGLGWYFDLW	IGHV3-20	IGHJ2
TGTGCGAGAGGCATTGGCGGGTATAGCAGGGACGGCCCGCACCACTACTACTACTACTACATGGACGTCTGG	CARGIGGYSRDGPHHYYYYYMDVW	IGHV4-34	IGHJ6
TGTGCGAAAGATGCCCGAGTAATGGGTACGATTTTTGGAGTAAACTGGTTCGACCCCTGG	CAKDARVMGTIFGVNWFDPW	IGHV3-23	IGHJ5
TGTGCGAAAGATGGGAGTCACGTCCCTCACGGGGGGCTGTGGTACTTTGACTACTGG	CAKDGSHVPHGGLWYFDYW	IGHV3-NL1	IGHJ4
TGTGCGAGAGATCAAGATATAGCAGCTCGGACCTGCCGGAACTGGTTCGACCCCTGG	CARDQDIAARTCRNWFDPW	IGHV1-2	IGHJ5
TGTGCGAGAGATTGCCCGGAATTCGTGGTGGCCCTGATTTTTGGAGTGGACCGTCACTACTACTACTACTACATGGACGTCTGG	CARDCPEFVVALIFGVDRHYYYYYMDVW	IGHV1-18	IGHJ6
TGTGCGAGAGAGGAAAGCGTTGACCCGCCCGATCCTAAACGGTGTAGTGGTGGTAGCTGCTACTCGCCGTACAACTGGTACTTCGATCTCTGG	CAREESVDPPDPKRCSGGSCYSPYNWYFDLW	IGHV3-53	IGHJ2
TGTACCACACTGCTCGAGTATAGCAGCAGCTGGTACCCATGTTACTTTGACTACTGG	CTTLLEYSSSWYPCYFDYW	IGHV3-15	IGHJ4
TGTGCAAAAGATATAGACCGAACGATTCCCCCCTCTGCTAACTGGTTCGACCCCTGG	CAKDIDRTIPPSANWFDPW	IGHV3-43	IGHJ5
TGTGCGAGACGGGTTTTAGATAGCAGTGGCTGGACACCACCGTTGTTCGACCCCTGG	CARRVLDSSGWTPPLFDPW	IGHV4-39	IGHJ5
TGTGCGAGAAGGCGGGATTACGATTTTTGGAGTGGTTATGTTTATTTATCGTACTTTGACTACTGG	CARRRDYDFWSGYVYLSYFDYW	IGHV4-38-2	IGHJ4
TGTGCGAAAGATGAGTTCGGATATTGTAGTGGTGGTAGCTGCTACTACCCTTACTTTGACTACTGG	CAKDEFGYCSGGSCYYPYFDYW	IGHV3-23	IGHJ4
TGTGCAAGAGTAGAGATGGCTACAATGGGGGGCGTCTGGTTCGACCCCTGG	CARVEMATMGGVWFDPW	IGHV1-45	IGHJ5
TGTGCGCCTCCCCGTACCTATTACTATGATAGTAGTGGTTATTATTACTACTACTACTACTACATGGACGTCTGG	CAPPRTYYYDSSGYYYYYYYYMDVW	IGHV1-18	IGHJ6
TGTGCGAGAGGTGTTATAGCAGTGGGGCTTTTCGGTCAAAACTGGTTCGACCCCTGG	CARGVIAVGLFGQNWFDPW	IGHV1-3	IGHJ5
TGTGCGAGAGATCGGCCGTTTAGGGGTATCATGGGATTTTTGGAGTGGTTATATAATCAACAGCGGGCCGGATACTACTACATGGACGTCTGG	CARDRPFRGIMGFLEWLYNQQRAGYYYMDVW	IGHV3-53	IGHJ6
TGTGCGAGACCCTATTGTAGTGGTGGTAGCTATATCCTTGACTACTGG	CARPYCSGGSYILDYW	IGHV4-59	IGHJ4
TGTGCGAAAACCGGATATTGTAGTAGTACCAGCTGCTATATCTCTCCCGAGACCATTGACTACTGG	CAKTGYCSSTSCYISPETIDYW	IGHV3-NL1	IGHJ4
TGTGCGAGGCGACTTGTAGTAGTACCAGCTGCTATATACTACTGG	CARRLVVVPAAIYYW	IGHV4-39	IGHJ4
TGTGCAAGAGCAAACATTACTATGGTTCAGGGAGTTGCGGGGTACTACTACTACTACATGGACGTCTGG	CARANITMVQGVAGYYYYYMDVW	IGHV3-74	IGHJ6
TGTTTGAAGGGATTTTTGGGAACTAGATATTACTACTACTACTACTACATGGACGTCTGG	CLKGFLGTRYYYYYYYMDVW	IGHV3-53	IGHJ6
TGTACTAGAGTAACTAATGTAGTAGTACCAGCTGCTTCTTGGTACTGGTACTTCGATCTCTGG	CTRVTNVVVPAASWYWYFDLW	IGHV3-49	IGHJ2
TGTGCGAGAGTCTGGTTGCCGATTGTAGTGGTGGTAGCTGTAGGGCCTACATCCCCCCAACTCTTTGACTACTGG	CARVWLPIVVVVAVGPTSPQLFDYW	IGHV7-4-1	IGHJ4
TGTGCGAGAGGGACCTGGCTTGACTACTGG	CARGTWLDYW	IGHV1-46	IGHJ4
TGTGCGAAAGATCCCCTTTGGAGTGGTTATAACCGTTTCTCCTACTGG	CAKDPLWSGYNRFSYW	IGHV3-23	IGHJ4
TGTGCAAAAGATCACAACGATTGGGTTATTGTAGTAGTACCAGCTGCTATCGTCTACTACTACTACTACATGGACGTCTGG	CAKDHNDWVIVVVPAAIVYYYYYMDVW	IGHV3-43	IGHJ6
TGTGCGAGAGCTCCGCGGGCGTCAAGCGTAGAGTATAGCAGCTCGTTAGTTCTTGACTACTGG	CARAPRASSVEYSSSLVLDYW	IGHV3-20	IGHJ4
TGTGCGAAAGGGTATTACTATGGTTCGGGGATCCTTTGCCCTAATCTGGTCTTCCCCGTGGTTGACTACTGG	CAKGYYYGSGILCPNLVFPVVDYW	IGHV3-NL1	IGHJ4
TGTGCAAGGGGGTTCCAGGGGGTATCGGATGATGCTTTTGATATCTGG	CARGFQGVSDDAFDIW	IGHV3-13	IGHJ3
TGTGCGACCGAGGAGGTAGCAGCAGCTGGTACCCGTTGGCCCTCGTTTGACTACTGG	CATEEVAAAGTRWPSFDYW	IGHV3-23	IGHJ4
TGTGCACGGATACTCCAGTTCTTAACCCCAGGGAGGATAGCAGCAGCTGGCGCCGACGCGGGGCACAACTGGTTCGACCCCTGG	CARILQFLTPGRIAAAGADAGHNWFDPW	IGHV2-26	IGHJ5
TGTGCGAAAGTCCTTGGACCGGCACCCCTATTACTATGGTTCAGGGACCACCAAACGTACTGG	CAKVLGPAPLLLWFRDHQTYW	IGHV3-NL1	IGHJ4
TGTGCGAAAGATCGCCCCCACGTATTACGATATTTTGACTGGTTATTGGCAATCCCTGAGGGCGGGTTCGACCCCTGG	CAKDRPHVLRYFDWLLAIPEGGFDPW	IGHV3-23	IGHJ5
TGTGCGAGAGTTCAGGATATTGTAGTAGTACCAGCTGTCTTAATTTTGCCCTGTCGCCCGCCGAGATATCGCTACTACTACTACTACATGGACGTCTGG	CARVQDIVVVPAVLILPCRPPRYRYYYYYMDVW	IGHV1-69	IGHJ6
TGTGCGAGCCCGCCATTTTTTGGAGTGGTTATTATAGATAATTACTACTACTACTACTACATGGACGTCTGG	CASPPFFGVVIIDNYYYYYYMDVW	IGHV3-21	IGHJ6
TGTGCGAGACCGTCCGAGGATCGTATTACGATTTTTGGAGTGGGCCCTGACTACTGG	CARPSEDRITIFGVGPDYW	IGHV5-51	IGHJ4
TGTGCAAAAGATGAGGATATTGTAGTAGTACCAGCTGCTAGGAACTGGTTCGACCCCTGG	CAKDEDIVVVPAARNWFDPW	IGHV3-43	IGHJ5
TGTGCGAGACGTGTTGTTATGATTACGTTTGGGGGAGTTATCGTTAGGCCCCATGCTTTTGATATCTGG	CARRVVMITFGGVIVRPHAFDIW	IGHV7-4-1	IGHJ3
TGTGCCGAGACTGTTGTAGTGGTGGTAGCTGCTACTCCATACTGG	CAETVVVVVAATPYW	IGHV3-53	IGHJ4
TGTGCGAGAGATATTGTACTGGTGGTGTATGCCTCTTGGACGTCTTACTACTACTACTACATGGACGTCTGG	CARDIVLVVYASWTSYYYYYMDVW	IGHV3-30	IGHJ6
TGTGCGAGACAAGGACCTTGCCTGGGTTTACGATTTTTGGAGTGGAAGAACTTTGACTACTGG	CARQGPCLGLRFLEWKNFDYW	IGHV5-51	IGHJ4
TGTGCAAAAGATATTTACGATTTTTGCCCGGCGGACTACTGG	CAKDIYDFCPADYW	IGHV3-43	IGHJ4
TGTGCACACAGACTTGACGGGGACTGTCGGAGAGGTTCAGGGAGTTATTATACCATCTTTTTAATGTGG	CAHRLDGDCRRGSGSYYTIFLMW	IGHV2-5	IGHJ4
TGTGCGAGAGATCGGGGAGAATCAACGGTATGCCCGGTGGTCCCAGAAGACATGATCAGATACGATATTTTGACTGGTATGCATGCTTTTGATATCTGG	CARDRGESTVCPVVPEDMIRYDILTGMHAFDIW	IGHV1-3	IGHJ3
TGTGCGAGAGTAGGGAATTGTAGTGGTGGTAGCTGCTACTGCACCGGCACTTCTGCCCGGTACTTCGATCTCTGG	CARVGNCSGGSCYCTGTSARYFDLW	IGHV3-7	IGHJ2
TGTGCGACATCAGCGGAGAAGACGGGAAGGCCGATAGCAGCTCGTCAGAACTGGTTCGACCCCTGG	CATSAEKTGRPIAARQNWFDPW	IGHV3-23	IGHJ5
TGTGCGAGCCCCACGTGGGAGCTACAATGTTGTGACTACTGG	CASPTWELQCCDYW	IGHV1-2	IGHJ4
TGTGCAAGAGCTCCGTTCGGGTCTAATTACTACTACTACTACTACATGGACGTCTGG	CARAPFGSNYYYYYYMDVW	IGHV3-13	IGHJ6
TGTGCACGGTGGTTCAGGGAGTTATTAGGTGTCCCCCCCTGG	CARWFRELLGVPPW	IGHV2-26	IGHJ5
TGTGCGAGTGCGCGTAACCGGGGAGGTATTAGGGTGGTAGCTGCTACTCTGGCATTATTTTCCCACTTTGACTACTGG	CASARNRGGIRVVAATLALFSHFDYW	IGHV3-21	IGHJ4
TGTGCGAGAGATGCGTGGAACGCTAACTACTACTACTACTACATGGACGTCTGG	CARDAWNANYYYYYMDVW	IGHV4-34	IGHJ6
TGTGCGTCTTATGGATCCCTCCAGGTTTGTAGTAGTACCAGCTGCCTCCCCAACTGGTTCGACCCCTGG	CASYGSLQVCSSTSCLPNWFDPW	IGHV4-59	IGHJ5
TGTGCGAGAGATCAGAGCCTAGGATATTGTAGTGGTGGTAGCTGCTACACACTCACAATTCGACGATTTAGGGTCCCTCTCTACTTTGACTACTGG	CARDQSLGYCSGGSCYTLTIRRFRVPLYFDYW	IGHV3-11	IGHJ4
TGTGCGAGAGAATGCCCCTTTTCACGGTATTGCTTGGACTTCGACTACTGG	CARECPFSRYCLDFDYW	IGHV1-69	IGHJ4
TGTGCGAGGTTAGTGACTACAGTAATGGACAACTGGTTCGACCCCTGG	CARLVTTVMDNWFDPW	IGHV5-10-1	IGHJ5
TGTGCGAGAGATCCACAATCCAATAGTGGATCACGTATGCGCCTAGGGGGGGGTATAGCAGTGGCTGGTGACCCAAGCCTTGACTACTGG	CARDPQSNSGSRMRLGGGIAVAGDPSLDYW	IGHV3-30	IGHJ4
TGTGCGGGAATGACTACAGTATCCCTCTACTACATGGACGTCTGG	CAGMTTVSLYYMDVW	IGHV3-30	IGHJ6
TGTGCGAAAGATCTACGGCTAGTACGCGGTATGATTACATCAGTTGAGGGCTACTGG	CAKDLRLVRGMITSVEGYW	IGHV3-NL1	IGHJ4
TGTGCGAGCGTCCTGAGTATTACGATTTTTGGAGTGGTTATTAGACGGAGGTTTGACTACTGG	CASVLSITIFGVVIRRRFDYW	IGHV3-11	IGHJ4
TGTGCGAGAGACGGGCGGGCAGTCCATAGCAGCAGCTGGTACCCGGCTACGTACTACTTTGACTACTGG	CARDGRAVHSSSWYPATYYFDYW	IGHV3-11	IGHJ4
TGTGCGAGGGGGCTGGTGGTAGCTGCTACGTTAGTCCTAGGAATCAAGGTTGACTACTGG	CARGLVVAATLVLGIKVDYW	IGHV3-30	IGHJ4
TGTGCGAGAGATGAAGTAGTACCAGCTGCTATGCTTCGCTTTGACTACTGG	CARDEVVPAAMLRFDYW	IGHV4-59	IGHJ4
TGTGCGAGGGATTGGCTACGATTCCAATTTGACTACTGG	CARDWLRFQFDYW	IGHV7-4-1	IGHJ4
TGTGCGAATTTACATTGTAGTGGTGGTAGCTGCTACTGGGAGTACTACTTTGACTACTGG	CANLHCSGGSCYWEYYFDYW	IGHV3-23	IGHJ4
TGTGCGAGAGGTGGACCGCCCTATGGTTCAGGGAGTTATTATAAACTCGACTGGTTCGACCCCTGG	CARGGPPYGSGSYYKLDWFDPW	IGHV1-3	IGHJ5
TGTGCGAGACATGAATCAGTAAGGGTGTCCGTGGGAGCTACTCCGTATGTTGACTACTGG	CARHESVRVSVGATPYVDYW	IGHV5-51	IGHJ4
TGTGCGAAAGCCCTTGGCGGGTGTCTTGAGAGAAATTGTAGTAGTACCAGCTGCTATCCCCTAATTGACTACTGG	CAKALGGCLERNCSSTSCYPLIDYW	IGHV3-23	IGHJ4
TGTGCGAGACTCACGTCATTTAAGATTACGATTTTTGGAGTGGTTATTGGACCCTACTTTGACTACTGG	CARLTSFKITIFGVVIGPYFDYW	IGHV4-38-2	IGHJ4
TGCGTCGAGACTACGGTGACTAGGGAGGGGAGCTTCCAGCACTGG	CVETTVTREGSFQHW	IGHV3-15	IGHJ1
TGTGCGAGAGAGTACCCTCCTTTTACTAGCCCTTTAGCAGCTGGTACGTTGATGGACAACTGGTTCGACCCCTGG	CAREYPPFTSPLAAGTLMDNWFDPW	IGHV3-66	IGHJ5
TGTGCGAAAGATCGGTATAGCAGCAGCTGGTACCGCTGGTACTTCGATCTCTGG	CAKDRYSSSWYRWYFDLW	IGHV3-NL1	IGHJ2
TGTGCGAGAGAGCCCTATTGTAGTGGTGGTAGCTGCTACACTTTTGATATCTGG	CAREPYCSGGSCYTFDIW	IGHV3-7	IGHJ3
TGTGCGAGAGATGCACCAAGAAAGTCCGATTGGGGTTTTGACTACTGG	CARDAPRKSDWGFDYW	IGHV1-2	IGHJ4
TGTGCGGACGGGTGTGGGAATGAGCTTAATGTGGGATATTGTAGTGGTGGTAGCTCCCGAAAGGTTGACTACTGG	CADGCGNELNVGYCSGGSSRKVDYW	IGHV1-2	IGHJ4
TGTGCGAGAGACCATTGTACTGGTGGTGTATGCTATACGGGCCACCAATACTACTACATGGACGTCTGG	CARDHCTGGVCYTGHQYYYMDVW	IGHV4-59	IGHJ6
TGTGCGAATAGTATAGCAGTGGCTGGTACGCGCGGACTATGGTACTACTTTGACTACTGG	CANSIAVAGTRGLWYYFDYW	IGHV3-23	IGHJ4
TGTGCGAGACACTACCGACAGTTGTATTACGATTTTTGGAGTGGTTATCCGTTGCGTCCCCGAACCTGGTTCGACCCCTGG	CARHYRQLYYDFWSGYPLRPRTWFDPW	IGHV4-34	IGHJ5
TGTGCGAAAGAAGGGGCTCGTATAGAGGGCTCTACGGTGGTAACTCCGAACTTGGACTACTGG	CAKEGARIEGSTVVTPNLDYW	IGHV3-NL1	IGHJ4
TGTGCGCCTCATCCAGATTGTAGTAGTACCAGCTTCCCCTTTGACTACTGG	CAPHPDCSSTSFPFDYW	IGHV3-21	IGHJ4
TGCCATTGTAGTAGTACCAGCTGCTATCGACTTTGGGCTTGTTTTGACTACTGG	CHCSSTSCYRLWACFDYW	IGHV1-18	IGHJ4
TGTGCGAGAGGCAAAGTTGGATATTGTAGTAGTACCAGCTGCTATCCAGATCCGGTCATTTGTTTCACTGTAGACTGGTTCGACCCCTGG	CARGKVGYCSSTSCYPDPVICFTVDWFDPW	IGHV4-34	IGHJ5
TGTGCGAGATCTTTAGAGGGATATTGTAGTGGTGGTAGACCAAATCTAGCCTTTGACTACTGG	CARSLEGYCSGGRPNLAFDYW	IGHV3-11	IGHJ4
