TGTGCGAGATATTGTAGTGGTGGTAGCTGCTACTCCGTGAAGGTTGTTGACTACTGG	CARYCSGGSCYSVKVVDYW	IGHV1-18	IGHJ4
TGTGCGAGAGCTTCAGTGGTGGTAGCTGCTACCCGTTACTACTTTGACTACTGG	CARASVVVAATRYYFDYW	IGHV3-7	IGHJ4
TGTGCGAAAGATATGTGGACGATTTTTGGAGTGGTTATCAACTGGTTCGACCCCTGG	CAKDMWTIFGVVINWFDPW	IGHV3-23	IGHJ5
TGTGCGACAGGTCTACTATGGTTCGGGGAGTTATTTCATTGTGACGGGCGTCCCCCGGCCCCAACTTACTTTGACTACTGG	CATGLLWFGELFHCDGRPPAPTYFDYW	IGHV3-23	IGHJ4
TGTGCGAGAGGTATTACGATTTTTGGAGTTCGTTTCTGCCCGCCTGACTGG	CARGITIFGVRFCPPDW	IGHV4-34	IGHJ4
TGTGCGAAATGGTGGGTGATACAGCAGCTCGTCCTTCACATTCGCTACTACTACTACTACATGGACGTCTGG	CAKWWVIQQLVLHIRYYYYYMDVW	IGHV3-23	IGHJ6
TGTGCGCCTAACCGGAGTGGGAGCTACTACTTTGACTACTGG	CAPNRSGSYYFDYW	IGHV4-39	IGHJ4
TGTGCACGGATACAGGTGGGTGCGGGGTACTTTGACTACTGG	CARIQVGAGYFDYW	IGHV2-70	IGHJ4
TGTGCGAAAGCCCAAGCAGTGGCTGGTACTGGAAACCACGGGTCGGCGTTCGACCCCTGG	CAKAQAVAGTGNHGSAFDPW	IGHV3-NL1	IGHJ5
TGTGCGAGACATGGTCGGAGTCCCCATATAGTGGCTACAGGGGTCGGTGACCGGTTGGGCTTTGACTACTGG	CARHGRSPHIVATGVGDRLGFDYW	IGHV5-51	IGHJ4
TGTGCGAGAGCAATAGTATTACGATTTTTGGAGTGGTTATTAGATTACTACTACTACTACTACATGGACGTCTGG	CARAIVLRFLEWLLDYYYYYYMDVW	IGHV1-69	IGHJ6
TGTGCGAGAGGGGTCTCCGGTGGTAGCTGCTACCCAGTACGCGCGGGACCCTACTACTTTGACTACTGG	CARGVSGGSCYPVRAGPYYFDYW	IGHV4-38-2	IGHJ4
TGTGCGAGAGATCGGCAGATACTTATTGTAGTAGTACCAGCTGCTATGCGAGCGGCTTACTGG	CARDRQILIVVVPAAMRAAYW	IGHV1-2	IGHJ4
TGTGAAACACCTCCGATAGCAGCAGCTGGTACGAAATTTGACTACTGG	CETPPIAAAGTKFDYW	IGHV1-3	IGHJ4
TGTGCTAAACTGAGGTGTTGTAGTAGTACCAGCTGCTATGCTTTTGTCGTCGGGTACTACTACTACTACATGGACGTCTGG	CAKLRCCSSTSCYAFVVGYYYYYMDVW	IGHV3-23	IGHJ6
TGTGCGAGGACAGGCTTGCGGCCCTATTACGATTTTTGGAGTGGTTATTACTCCCTCCCCCTATACTACTACATGGACGTCTGG	CARTGLRPYYDFWSGYYSLPLYYYMDVW	IGHV5-51	IGHJ6
TGTGCGAGAGTTCCATGTAGTAGTACCAGCTGCTATGAGCCCTTTGACTACTGG	CARVPCSSTSCYEPFDYW	IGHV1-46	IGHJ4
TGTGCAAGAGTTTCCGCGGATTTCCTAGCAGCAGCTGGTATCTACTTTGACTACTGG	CARVSADFLAAAGIYFDYW	IGHV3-13	IGHJ4
TGTGCTTTGGGGTATTACGATATTTTGACTGGTTATTATTGGCTATTTCAAAACTACTTTGACTACTGG	CALGYYDILTGYYWLFQNYFDYW	IGHV1-2	IGHJ4
TGTGCGAGACATCTCCTCTTAGTTAGTTATACCGGTGCTGGCTTTGACTACTGG	CARHLLLVSYTGAGFDYW	IGHV5-51	IGHJ4
TGTGCGAGAGATCTTGTGGAGCAGTGTAGTAGTACCAGCTGCTATACTCATCTTTGGTTCGACCCCTGG	CARDLVEQCSSTSCYTHLWFDPW	IGHV3-21	IGHJ5
TGTGCGAGATTGAAACACGTATTACGATTTTTGGAGTGGTTATTATACCTGATTTTCCGCTACTACTACTACTACATGGACGTCTGG	CARLKHVLRFLEWLLYLIFRYYYYYMDVW	IGHV1-46	IGHJ6
TGTGCGAGAATTGTAGTAGTACCAGCTGCTATGCGGCCGTTCATCTACTACTACTACATGGACGTCTGG	CARIVVVPAAMRPFIYYYYMDVW	IGHV3-30	IGHJ6
TGTACCACAGTACTCTCCGGGAACTATGATAGTAGTGGTTATTACTGGCCCGATGCTTTTGATATCTGG	CTTVLSGNYDSSGYYWPDAFDIW	IGHV3-15	IGHJ3
TGTCCCATATTACGATATTTTGACTGGTTATTATTACCGGAATTTGACTACTGG	CPILRYFDWLLLPEFDYW	IGHV4-38-2	IGHJ4
TGTGCGAGCCTTCCTGTATTGTACTGGTGGTGTATGCTATGCTGGGTGGGGCTTATGGGCCCCTGG	CASLPVLYWWCMLCWVGLMGPW	IGHV3-30	IGHJ4
TGTGCGAGACATAACTTTACCCGAAGATATTGTACTGGTGGTGTATGCCGTTACTGGTACTTCGATCTCTGG	CARHNFTRRYCTGGVCRYWYFDLW	IGHV5-51	IGHJ2
TGTGCGAGAGATGTACGTGGCCGGTATTGTACTGGTGGTGTATGCTATGTGAGTAGGTTCGACCCCTGG	CARDVRGRYCTGGVCYVSRFDPW	IGHV3-20	IGHJ5
TGTGCGAGACCCTTTCGGGATATTGTAGTGGTGGTAGCTGCAGGATTTGACTACTGG	CARPFRDIVVVVAAGFDYW	IGHV3-53	IGHJ4
TGTGCGAGAACCCCAAGGCTAGGATATTGTACTAATGGTGTATGCACTCCCTTTGACTACTGG	CARTPRLGYCTNGVCTPFDYW	IGHV5-10-1	IGHJ4
TGTGCGAGAGATAGGGCGGGGCAGCAGCTCGTCCCCGATTGTTTCTACTTCCAGCACTGG	CARDRAGQQLVPDCFYFQHW	IGHV3-21	IGHJ1
TGTGCGAGACATTGCTACGGTGACTACGAGGACTGGTTCGACCCCTGG	CARHCYGDYEDWFDPW	IGHV5-51	IGHJ5
TGTACCACAGGGCCCGTGATTTCTAGGGGATCCAATTTTTGGAGTGGTTATTATGGAGTGGTTGACTTTGACTACTGG	CTTGPVISRGSNFWSGYYGVVDFDYW	IGHV3-15	IGHJ4
TGTGCGAGGCACACTCCCCGAGGACGAGGATATTGTAGTGGTGGTAGCTGCTACTCCAGGGGGCCCGGGCAGCACTGG	CARHTPRGRGYCSGGSCYSRGPGQHW	IGHV1-46	IGHJ1
TGTGCGAGAGTGGTGGTGGTAGCTGCTACGGAATTTACTATCCTGGAGGGCTGG	CARVVVVAATEFTILEGW	IGHV1-46	IGHJ4
TGTACTAGACCCCAGTGTACAGTAACTACGCACTACTACTACATGGACGTCTGG	CTRPQCTVTTHYYYMDVW	IGHV3-49	IGHJ6
TGTGCACACAGACACGAAAATTTTGGAGTGGTTACAAAGGGTTACTACTACTACTACATGGACGTCTGG	CAHRHENFGVVTKGYYYYYMDVW	IGHV2-5	IGHJ6
TGTGCGAGATCACTGCTCGGGGCGCAGTGGCTGGTATGGTTCGACCCCTGG	CARSLLGAQWLVWFDPW	IGHV1-8	IGHJ5
TGTGCAAGAGATGGGACGATAGTAGTGGTTATTACAGTCTGG	CARDGTIVVVITVW	IGHV3-13	IGHJ4
TGTGCGAGGCCAGCAGTGGCTGGTACCCACTTTGACTACTGG	CARPAVAGTHFDYW	IGHV7-4-1	IGHJ4
TGTGCGAGACGGTCTCAGGGCGGATTACGATATTTTGACTGGTTATTTCTTGACTACTGG	CARRSQGGLRYFDWLFLDYW	IGHV4-61	IGHJ4
TGTGCGAGAGATTCGCTGTTTGTATTACTATGGTTCAGGCCCCGCCCTGACTACTGG	CARDSLFVLLWFRPRPDYW	IGHV3-20	IGHJ4
TGTACTAGAGATGGAGAAGCCGGATACCGGTACTACTACTACTACATGGACGTCTGG	CTRDGEAGYRYYYYYMDVW	IGHV3-49	IGHJ6
TGTGCGAGACAGGGGTCGTTTACCGGGTATAGCAGTGGCTGGGTTTCCAGTTCTGACTACTGG	CARQGSFTGYSSGWVSSSDYW	IGHV5-51	IGHJ4
TGTACTAGACGGATGACTACGGTGACTACGCCAGATTACTACTACTACTACATGGACGTCTGG	CTRRMTTVTTPDYYYYYMDVW	IGHV3-73	IGHJ6
TGTGCGAGACGAGTCACGAGCCCTCACGGGGGGTCCCAAAACTTTGACTACTGG	CARRVTSPHGGSQNFDYW	IGHV5-51	IGHJ4
TGTGCGAGACGTAAAGAGCAGTGGCTGATTGATTACTACTTTGACTACTGG	CARRKEQWLIDYYFDYW	IGHV5-51	IGHJ4
TGTGCGATTACAGTGGCTGGTTTAGTGCGATTTGACTACTGG	CAITVAGLVRFDYW	IGHV3-20	IGHJ4
TGTGCGAGAGGAGACTACAGTAACTCGTCCCAGAGTGACTACTGG	CARGDYSNSSQSDYW	IGHV3-53	IGHJ4
TGTGCGAGAGTCCTACCCAAAGGGTTGCAAATCCGTCGCAGCCTGGAACTACGGTGTACAGCGGTTGACTACTGG	CARVLPKGLQIRRSLELRCTAVDYW	IGHV7-4-1	IGHJ4
TGTGCAAGAAAGTACCAGCTGCTATACTTATACTACTACTACTACATGGACGTCTGG	CARKYQLLYLYYYYYMDVW	IGHV3-13	IGHJ6
TGTGCGAGAGGCGCGGAGGGGAATACGATTTTTGGAGTGGGTGGGAACCTGTACTACTACTACATGGACGTCTGG	CARGAEGNTIFGVGGNLYYYYMDVW	IGHV1-3	IGHJ6
TGTGCAAGCCCCCCTGGTTATAGCAGTGGCTGGTACGTGGTTCCAACCTTGCTTGACTACTGG	CASPPGYSSGWYVVPTLLDYW	IGHV3-13	IGHJ4
TGTGCGAAAGATCGTATTACTATGATAGTAGTGGTTATTAGTGGTTTTAACTGGTTCGACCCCTGG	CAKDRITMIVVVISGFNWFDPW	IGHV3-23	IGHJ5
TGTGCACCCCCTAACCGTTCTATAGCAGTGGCTGGTACCTACTGG	CAPPNRSIAVAGTYW	IGHV2-5	IGHJ4
TGTGCACACAGACAGGGGGGTATGATAGTAGTGGTTATTACTACCGGACCGGAAGAAACAGGGCAAGACTGGTTCGACCCCTGG	CAHRQGGMIVVVITTGPEETGQDWFDPW	IGHV2-5	IGHJ5
TGTGCGAGAGATACGTCCAGCTGCTATATAGAGTACTGG	CARDTSSCYIEYW	IGHV3-21	IGHJ4
TGTGCGAGAGATCGTACGGTAAGTAGCAGTGGCTGCCTTGGTGACGCATACTACTGG	CARDRTVSSSGCLGDAYYW	IGHV4-59	IGHJ4
TGTGCGAGAGTTGGCAGCATAGCAGTGGCTGGTACCCTTGCTTTTGATATCTGG	CARVGSIAVAGTLAFDIW	IGHV4-59	IGHJ3
TGTTACGGGTCGGCCTCCCAGAGATGGCTACTAATCCCGGCCCCCTCAATTGACTACTGG	CYGSASQRWLLIPAPSIDYW	IGHV3-30-3	IGHJ4
TGTGCGAAAGAAACCCTCATTGTAGTGGTGGTAGCTGCTACTCATATTATCCCGAACTGG	CAKETLIVVVVAATHIIPNW	IGHV3-23	IGHJ4
TGTGCGAAATTGAAATATTGTAGTAGTACCAGCTGCGAAGAGTCCCCGATACCTGACTACTGG	CAKLKYCSSTSCEESPIPDYW	IGHV3-23	IGHJ4
TGTGCACGGATACAAATGGAGAGGTCAGACCGCCCGCGTATTACGATTTTTGGAGTGGTTATTAAGGGAATTGAGCCATTCTACTACTACTACTACATGGACGTCTGG	CARIQMERSDRPRITIFGVVIKGIEPFYYYYYMDVW	IGHV2-26	IGHJ6
TGTGCGAGAGAACTCAGGGCTATAGTAGACGGAGCTCAGGGTGGCCATGCATACTTTGACTACTGG	CARELRAIVDGAQGGHAYFDYW	IGHV1-18	IGHJ4
TGTGCAAGAGATTTACGACGGGCCCCACTGTACACCCCCTACTGG	CARDLRRAPLYTPYW	IGHV3-13	IGHJ4
TGTGCGAGTTTTATTGTAGTGGTGGTAGCCCAGCAAATGCCGGGGAAGTTCTTTGACTACTGG	CASFIVVVVAQQMPGKFFDYW	IGHV5-51	IGHJ4
TGTGCGAGAGATCTCGATCTAAATATTACGATTTTTGGAGTGGTTATTAGTGTCCTCGTGTCGACCACGGACCCGTACTACTACATGGACGTCTGG	CARDLDLNITIFGVVISVLVSTTDPYYYMDVW	IGHV1-18	IGHJ6
TGTGCAAAAGATATCTATGATAGTAGTGGTTATGCCCCGGTCTGGTTCGACCCCTGG	CAKDIYDSSGYAPVWFDPW	IGHV3-43	IGHJ5
TGTGCGAGGGCAAATTGTAGTAGTACCAGCTGCGCCTACTACTACTACATGGACGTCTGG	CARANCSSTSCAYYYYMDVW	IGHV3-21	IGHJ6
TGTGCGAGAGTACCCTTTGAATATTGTAGTGGTGGTAGCTGCTACGAGGGGTTTGACTACTGG	CARVPFEYCSGGSCYEGFDYW	IGHV4-4	IGHJ4
TGTGCGAGAGATTTAGTTACCTGTATTACGATTTTTGGAGTGGTTATATTGGGGCAACGGTGGTTCGACCCCTGG	CARDLVTCITIFGVVILGQRWFDPW	IGHV3-20	IGHJ5
TGTGCGAGACGGGATATCCTTTATACAGTTGATGCTTTTGATATCTGG	CARRDILYTVDAFDIW	IGHV1-2	IGHJ3
TGTGCGAGATGTGATATTGTAGTAGTACCAGCTGCTATAGATGGCTACTACATGGACGTCTGG	CARCDIVVVPAAIDGYYMDVW	IGHV7-4-1	IGHJ6
TGTGCGAGTGGGTATTGTAGTGGTGGTAGCTGCTACTCGTTTGACTACTGG	CASGYCSGGSCYSFDYW	IGHV3-20	IGHJ4
TGTGCACACAGACGGGGAAGTATGTGGTGTATGGCTTGCCCCTACTGG	CAHRRGSMWCMACPYW	IGHV2-5	IGHJ4
TGTACCCGAGCCATGACTACGGTGGTCTGCCCCGGATGG	CTRAMTTVVCPGW	IGHV3-9	IGHJ4
TGTGCGAGAGGACGATTTGGAGTGGTTATTATAGGAAACTGGTTCGACCCCTGG	CARGRFGVVIIGNWFDPW	IGHV3-21	IGHJ5
TGTGCACGGATAACGTTTGTAGTGGTGGTAGCTGCTCATCTAGATGAGGGTAGGCACTACTACTACTACATGGACGTCTGG	CARITFVVVVAAHLDEGRHYYYYMDVW	IGHV2-26	IGHJ6
TGTGCGAGAGATGAATTAGATGACTACTGG	CARDELDDYW	IGHV1-2	IGHJ4
TGTGCGAGAGCAGCCTGTAGTGGTGGTAGCTGCTACTCGCGTTCCTACTGG	CARAACSGGSCYSRSYW	IGHV3-53	IGHJ4
TGTGCACGGAACGAAGGTTCACTAGGATATTGTAGTGGTGGTAGCTGCTACTGTTACTACTTTGACTACTGG	CARNEGSLGYCSGGSCYCYYFDYW	IGHV2-26	IGHJ4
TGTGCGAGAGATCTGGATATTACGATTTTTGGAGTGGTTATTCGAAACTGG	CARDLDITIFGVVIRNW	IGHV4-59	IGHJ5
TGTGCAAGAGATCTCGTATGTGCCTTATCGTATAGCAGCAGCTGGTATCACTACTACTTTGACTACTGG	CARDLVCALSYSSSWYHYYFDYW	IGHV3-13	IGHJ4
TGTGCGAGAGATCTCCGTATTGTAGTAGTACCAGACCAGTGCTTCTGGCATCTGCAGAGCCAAGGGGAGAGCTACTACTACTACATGGACGTCTGG	CARDLRIVVVPDQCFWHLQSQGESYYYYMDVW	IGHV3-66	IGHJ6
TGTACTCCGAGGGTGCTACGTATTACTATGGTTCAGGGACGTCGTGACTACTGG	CTPRVLRITMVQGRRDYW	IGHV3-49	IGHJ4
TGTGCGAAAGAAAATCTTTGGAGTGGTTATTTTCACCGCGCGGGAGACCTTCGAGTATTTGACTACTGG	CAKENLWSGYFHRAGDLRVFDYW	IGHV3-NL1	IGHJ4
TGTGCGAGCAACCGGGATATTGTAGTGGTGGTAGCTGCTACCTTGCGTGACTACTGG	CASNRDIVVVVAATLRDYW	IGHV1-46	IGHJ4
TGTGCGAGAATGCGTGGGGTGGTAGCTGATAGGTACTACTTTGACTACTGG	CARMRGVVADRYYFDYW	IGHV1-46	IGHJ4
TGTGCGAGAACACGAACGGGCCTATGGGGGGAGGCCTACTATGGTTCGGGGAGTTACGAGTGTATCTTTGACTACTGG	CARTRTGLWGEAYYGSGSYECIFDYW	IGHV4-38-2	IGHJ4
TGTGCGAGAGCCGCCCGCAGTGGCTGGAGGAAGCAACAAAACTGG	CARAARSGWRKQQNW	IGHV3-20	IGHJ5
TGTGCGATCCAGCAGCAGCTGACGGACTTTGACTACTGG	CAIQQQLTDFDYW	IGHV3-7	IGHJ4
TGTGCAAAAGAGGATTACGGAAACTACTACTACTACTACATGGACGTCTGG	CAKEDYGNYYYYYMDVW	IGHV3-43	IGHJ6
TGTGCGACGTCGAGCGCCTTGGGGGAGTTATCGTCCAACTACTGG	CATSSALGELSSNYW	IGHV3-23	IGHJ4
TGTACCACAGCTAATCACGAGCCGGTCCCTTATGATTACATTTGGGGGAGGTACTACTACTACTACTACATGGACGTCTGG	CTTANHEPVPYDYIWGRYYYYYYMDVW	IGHV3-15	IGHJ6
TGTGCGAGACAGATTAGTATGGTTCAGGGAGTTATTATACCGAGGGTTGTCACCCCGGAAATTGACTACTGG	CARQISMVQGVIIPRVVTPEIDYW	IGHV5-51	IGHJ4
TGTGCGAGAGATCTACCGGGGAGGTGGATACAGCTATGGCCCTTGTGGTTCGACCCCTGG	CARDLPGRWIQLWPLWFDPW	IGHV1-69	IGHJ5
TGTGCGAGACTTGACTACGGTGACTACCCTTTCCCACGCTTTGACTACTGG	CARLDYGDYPFPRFDYW	IGHV5-51	IGHJ4
TGTGCGAGACAGGGAGTGGGGTTTCGTATTACTATGATAGTAGTGGTTATTACTATCTGCTTTGACTACTGG	CARQGVGFRITMIVVVITICFDYW	IGHV5-51	IGHJ4
TGTGCGAGACACAGTTCCGCTGCTACTCGGGGGCCTCCTTGGATGGACGTCTGG	CARHSSAATRGPPWMDVW	IGHV1-3	IGHJ6
TGTGCGAACCTCTTACGTGGATATAGTGGCTACGTTCTTTGG	CANLLRGYSGYVLW	IGHV3-NL1	IGHJ4
