TGTGCGAGAAAAACCAATATTGTACTGGTGGTGTATGCTGGATCATCTATACTGCAAGGGGGGTACTACTACTACTACTACATGGACGTCTGG	CARKTNIVLVVYAGSSILQGGYYYYYYMDVW	IGHV5-10-1	IGHJ6
TGTGCGAAAGCGGAGTATTGTAGTAGTACCAGCTGCTACCGTAACTGG	CAKAEYCSSTSCYRNW	IGHV3-NL1	IGHJ4
TGTGCGAGAGGCATAGGGCATATTGTGGTGGTGACTGCTACAGTGGCGGATGCTTTTGATATCTGG	CARGIGHIVVVTATVADAFDIW	IGHV3-20	IGHJ3
TGTGCGAAAGGAGGACTGCAGCTCGCGAGGTGTTTGGCTCCTAACTGGTTCGACCCCTGG	CAKGGLQLARCLAPNWFDPW	IGHV3-23	IGHJ5
TGTGCAAGAACCTCGGGGCCTGCAGGGCGGGGCGGGCGTACCCTTGGGGGTCTCATCATGGACGTCTGG	CARTSGPAGRGGRTLGGLIMDVW	IGHV1-45	IGHJ6
TGTGCGAAAGAGCTGGCTTATGATTACATTTGGGGGAGTTATCGTTCTGGGTACTACTACTACTACATGGACGTCTGG	CAKELAYDYIWGSYRSGYYYYYMDVW	IGHV3-23	IGHJ6
TGTGCGAAAAGAGCGAACTTTGACTACTGG	CAKRANFDYW	IGHV3-NL1	IGHJ4
TGTGCGAGAGAAGGATTGTACTGGTGGTGTATGCTATCACTACCCAACTGGTTCGACCCCTGG	CAREGLYWWCMLSLPNWFDPW	IGHV1-3	IGHJ5
TGTACTAGCCTGGTAGCAGTGGCTGCCCGGTTCGACCCCTGG	CTSLVAVAARFDPW	IGHV3-49	IGHJ5
TGTGCGAGCCTATATTGTAGTGGTGGTAGCTGCTACTCTTCCAGTAAGGTGACCGACTGGTTCGACCCCTGG	CASLYCSGGSCYSSSKVTDWFDPW	IGHV3-20	IGHJ5
TGTGCGAGAGATCACGTCCTGTGGAAACAATATTGTACTGGTGGTGTATGCTATGTGAGGCACGCGAGTCCTAGTGACGTGTGTTACTACTACTACATGGACGTCTGG	CARDHVLWKQYCTGGVCYVRHASPSDVCYYYYMDVW	IGHV3-53	IGHJ6
TGTGCACACAGTTGGGGTTGTACTGGTGGTGTATGCTATCCCCTATTTGACTACTACTACTACATGGACGTCTGG	CAHSWGCTGGVCYPLFDYYYYMDVW	IGHV2-5	IGHJ6
TGTGCGAGATTTGAGAGTTACGGTGACTACGGGGAAGTTTGCCCTCACTACTACTACTACTACATGGACGTCTGG	CARFESYGDYGEVCPHYYYYYMDVW	IGHV4-38-2	IGHJ6
TGTGCGAGAGATAGGAGGCCTACGATTGTAGTAGTACCAGCTGCTATGCGGAAACGGTACTACTACTACATGGACGTCTGG	CARDRRPTIVVVPAAMRKRYYYYMDVW	IGHV4-61	IGHJ6
TGTGCGAAAGATAAAAGGAGGACGGGAACAACCGGATATTGTAGTGGTGGTAGCTGCCCGTCCTTTGACTACTGG	CAKDKRRTGTTGYCSGGSCPSFDYW	IGHV3-NL1	IGHJ4
TGTGCGAGTAGTTGTAGTAGTACCAGCTGCTATACCACACTGATCTGGTTCGACCCCTGG	CASSCSSTSCYTTLIWFDPW	IGHV4-61	IGHJ5
TGTGCGAGACGTGGTGGTAGCTGCTTAAAATGGCGACACGCCTCTTCGGATTACTTTGACTACTGG	CARRGGSCLKWRHASSDYFDYW	IGHV5-10-1	IGHJ4
TGTGCGAGAGTTTCCTCCCCCGGTATTGTAGTGGTGGTAGCTGCTACTCTCTCCTACTTTGACTACTGG	CARVSSPGIVVVVAATLSYFDYW	IGHV3-53	IGHJ4
TGTGACTCCCTCGATATAGTGGCTACGATGGGCTTTGACTACTGG	CDSLDIVATMGFDYW	IGHV3-23	IGHJ4
TGTGCGAGACACGCTCCCCCAGCTATGGAAATTATAGTTTGGTTATCCCCTTACTACTACTACTACTACATGGACGTCTGG	CARHAPPAMEIIVWLSPYYYYYYMDVW	IGHV5-51	IGHJ6
TGTGCGAAAGATGGAAGTCTAGTCGATATTGTAGTGGTGGTAGCTGCTAGTATGAACGTTGACTACTGG	CAKDGSLVDIVVVVAASMNVDYW	IGHV3-23	IGHJ4
TGTGCGAAATTTCCTTCCGCCTATAGGGAACCTACTGGTGGTGTATGCTGGGGGATTTTTGACTACTGG	CAKFPSAYREPTGGVCWGIFDYW	IGHV3-23	IGHJ4
TGTGCGAGAGATTTGGTCTCGGTTGTATTACGATTTTTGGAGTGGTTACAGGTTCATTACTACTACTACTACTACATGGACGTCTGG	CARDLVSVVLRFLEWLQVHYYYYYYMDVW	IGHV3-20	IGHJ6
TGTGCGACACCTGAATTGTCGGAAGACTTTTGGTTCGACGTACAGCTATGGTTCGGCATTTACAACTGGTTCGACCCCTGG	CATPELSEDFWFDVQLWFGIYNWFDPW	IGHV4-38-2	IGHJ5
TGTGCGAGACGATTCGGTATTGTCCTAACGTATTACTATGGTTCGGGGAGTTATATGGGTAGATCCGCCTTTGACTACTGG	CARRFGIVLTYYYGSGSYMGRSAFDYW	IGHV5-51	IGHJ4
TGTGCAAAAAGTACCTCGTGGTTATTGCTCCTAAAGTACAACTGGTTCGACCCCTGG	CAKSTSWLLLLKYNWFDPW	IGHV3-43	IGHJ5
TGTGCGAAAGAAGCCTGTCCGAGTATAGCAGCAGCTTACTACTTTGACTACTGG	CAKEACPSIAAAYYFDYW	IGHV3-23	IGHJ4
TGTGCGAATGTAAGGTTTGACTATAGCAGCAGCTGGTACGGGTGTGTCGCTTTGTACAACTGGTTCGACCCCTGG	CANVRFDYSSSWYGCVALYNWFDPW	IGHV3-23	IGHJ5
TGTGCGAAAGATGGAATACTCATCGTATTACGATTTTTGGAGTGGTTATTGGGTTCTGACTACTGG	CAKDGILIVLRFLEWLLGSDYW	IGHV3-23	IGHJ4
TGTGCGAAAGGGGAAATTTTAGCAGTGGCTGGTAAAGTTTTTGACTACTGG	CAKGEILAVAGKVFDYW	IGHV3-NL1	IGHJ4
TGTGCGAGCCCGGGCATCGCAGCTCGTCCTGGGGGTGACTACTGG	CASPGIAARPGGDYW	IGHV1-18	IGHJ4
TGTACTAGACCGCCGGTGGTAACGGAGCTACTATACTTTGACTACTGG	CTRPPVVTELLYFDYW	IGHV3-73	IGHJ4
TGTGCGAGAGGTGCAATCCTAGGATATTGTAGTAGTACCAGCTGCTGTGGCTTCTACTACTACTACATGGACGTCTGG	CARGAILGYCSSTSCCGFYYYYMDVW	IGHV3-7	IGHJ6
TGTGCGAGAGCAAGCGGATCTCGGGATAGTAGTGGTTATCACAACTGGTTCGACCCCTGG	CARASGSRDSSGYHNWFDPW	IGHV3-64	IGHJ5
TGTGCGAGAGAACGATATTGTAGTGGTGGTACGTCCCGGGACTACTGG	CARERYCSGGTSRDYW	IGHV3-53	IGHJ4
TGTGCAAAAGGCGGATTTAGGGATACTATGATAGTAGTGGTTATTAAATTTGACTACTGG	CAKGGFRDTMIVVVIKFDYW	IGHV3-43	IGHJ4
TGTGCAAGAGTAATATTACGATTTTTGGAGTGGTTATTAGGGCACTACTACTACTACATGGACGTCTGG	CARVILRFLEWLLGHYYYYMDVW	IGHV3-74	IGHJ6
TGTGTGGTAGTTGGCGGAGGATATTGTAGTGGTGGTAGCTGCTACGGAGTTACGTCCGCCTGGGATCGAGTTTTTACCGGAAAATGGGCGTACTGG	CVVVGGGYCSGGSCYGVTSAWDRVFTGKWAYW	IGHV3-30-3	IGHJ4
TGTGCGAGAGATCTCAGGGAGATGGCTACAATTGGTCCTTATTGCGACTTTGACTACTGG	CARDLREMATIGPYCDFDYW	IGHV3-64	IGHJ4
TGTGCACACGTTGGCGCCCTGCGCGCAAACCGGGCCCGTATTGTGGTGGTGATTGCTACGTACTGG	CAHVGALRANRARIVVVIATYW	IGHV2-5	IGHJ4
TGTGCGAGAGAGGGTGGGTCGTTTGATCAGCATAGCAGTGGCTGGTACCATCGCAGTTTCCAGCACTGG	CAREGGSFDQHSSGWYHRSFQHW	IGHV1-2	IGHJ1
TGTGCACACAGCCTCTGGATTACGTTTGGGGGAGTTATCGGCTTGATGGACGTCTGG	CAHSLWITFGGVIGLMDVW	IGHV2-5	IGHJ6
TGTGCGAACCGAGGAACTTACATTTGGGGGAGTTATCGTAATGCCGACTCCCTTGACTACTGG	CANRGTYIWGSYRNADSLDYW	IGHV3-23	IGHJ4
TGTGCGAGAGATGCAGTTCCCCAGTATAGCAGCAGCTGGCCATCGGCGTACTACTTTGACTACTGG	CARDAVPQYSSSWPSAYYFDYW	IGHV3-21	IGHJ4
TGTGCGAATAGCAGCAGCTGGTACTTCTTTGACTACTGG	CANSSSWYFFDYW	IGHV3-23	IGHJ4
TGTGCGAGAGGGGTGTGGCGAGGGGTGCCGGGATTATATTGTAGTGGTGGTAGCTGCTACCCCCACTACTACTACTACATGGACGTCTGG	CARGVWRGVPGLYCSGGSCYPHYYYYMDVW	IGHV3-66	IGHJ6
TGTGCGGGCGCCTCCTGTAGTGGTGGTAGCTGCTACTGGAATGATGCTTTTGATATCTGG	CAGASCSGGSCYWNDAFDIW	IGHV3-53	IGHJ3
TGTGCGAGAGATCGTGGGCGAGGTGTCCATACGGTGACTACGTTTTCACCTATTTCCGGTATGCTCTGG	CARDRGRGVHTVTTFSPISGMLW	IGHV3-11	IGHJ3
TGTGCGAGAGTTCAAATTAAGGGGTGTATGCTACGCCGTGCTTTTGATATCTGG	CARVQIKGCMLRRAFDIW	IGHV4-38-2	IGHJ3
TGTACCACAGACTTTCGAGCGTGGACTACGGGCTGGCGTAGCAGCTCGTCAAAAGCCAAGGGAAGACACCCACGGGACTACTGG	CTTDFRAWTTGWRSSSSKAKGRHPRDYW	IGHV3-15	IGHJ4
TGTGCGAGAGAGGCTCTGGAACCCCACGGATACAGCTATGGACAAAGCTACTACTACTACATGGACGTCTGG	CAREALEPHGYSYGQSYYYYMDVW	IGHV3-20	IGHJ6
TGTGCGAGAGATCGCTTATCCATCGGATTGCCGGACCAAGATATAGCAGTGGCGATTAATGACTACTGG	CARDRLSIGLPDQDIAVAINDYW	IGHV3-66	IGHJ4
TGTACCACCATGGAGGGATACTACTACTACTACATGGACGTCTGG	CTTMEGYYYYYMDVW	IGHV3-15	IGHJ6
TGTGCGAGAGGCCTCATTGTAGTAGTACCAGCTGCTATAGTGGAGGGGGGACGCTACTACTACATGGACGTCTGG	CARGLIVVVPAAIVEGGRYYYMDVW	IGHV3-64	IGHJ6
TGTGCGAGAAGTCCAAGTAGGAGGTTGCCGGGTATAGCAGTGGCTGGTATCAGGTGGTTCGACCCCTGG	CARSPSRRLPGIAVAGIRWFDPW	IGHV3-21	IGHJ5
TGTGCGAGAGATTTGGCAGTGGCTGGGTACTTCGATCTCTGG	CARDLAVAGYFDLW	IGHV3-53	IGHJ2
TGTGCGAAAAGACCTAATCCAGTCAACTACGCGGCGGGATGGCTTGACTACTGG	CAKRPNPVNYAAGWLDYW	IGHV3-23	IGHJ4
TGTGCGAAAGATTCCGCTTGTAGTAGTACCAGCTGCTTACGTATGGGGGATGCTTTTGATATCTGG	CAKDSACSSTSCLRMGDAFDIW	IGHV3-23	IGHJ3
TGTGCGAGAACCCTCCCACAACCCACTACGATTTTTGGAGTGGTTATTAAACCTGGATACTACATGGACGTCTGG	CARTLPQPTTIFGVVIKPGYYMDVW	IGHV3-7	IGHJ6
TGTGCGAGATTTAGTCCCAAGGGCTTCTACTGG	CARFSPKGFYW	IGHV5-10-1	IGHJ4
TGTACCACAGAGGCGTATTACTATGGTTCGGGGAGTTATCCGGGGGACTGGTTCGACCCCTGG	CTTEAYYYGSGSYPGDWFDPW	IGHV3-15	IGHJ5
TGTGCGAGAGCCGAGATCCTGTTACGATATTTTGACTGGTTATTATGCGACGACTACTGG	CARAEILLRYFDWLLCDDYW	IGHV1-18	IGHJ4
TGTGCGAGATATTGTACCCGGAGGGATGACTACGGTGACTACGGCCTTGACTACTGG	CARYCTRRDDYGDYGLDYW	IGHV3-53	IGHJ4
TGTGCGAGAGAATGCAGTGGCTGGCGAGGTAACTGG	CARECSGWRGNW	IGHV1-2	IGHJ4
TGTGCGAAAGATCCCCAGAATATTGTAGTAGTACCAGCTGCTAACTACTACTACTACATGGACGTCTGG	CAKDPQNIVVVPAANYYYYMDVW	IGHV3-23	IGHJ6
TGTGCGAGAGCTGAGGGGAGAATAGTAGTGGTTATTTATCTCCAGGGGAAGACGCCCAGACACCTCGTTGACTACTGG	CARAEGRIVVVIYLQGKTPRHLVDYW	IGHV3-7	IGHJ4
TGTGCACAAATACAGCTATGGTTACCGGGGGAATTTGACTACTGG	CAQIQLWLPGEFDYW	IGHV3-7	IGHJ4
TGTGCGAGAGGCGGGAATGGGGTAATTGTAGTGGTGGTAGCTGCTACGAAGGCCCCAACCTTTGACTACTGG	CARGGNGVIVVVVAATKAPTFDYW	IGHV4-34	IGHJ4
TGTGCGAGAGAGACCTCTAAACCAAGAAGTTCCACGATAGAAGTCCGTACCAGCTGCTATTCGTCTGACTACTGG	CARETSKPRSSTIEVRTSCYSSDYW	IGHV1-69	IGHJ4
TGTGCAAGAGATGTTATGGTTCGGGGAGTTATTAACCACTTTGACTACTGG	CARDVMVRGVINHFDYW	IGHV3-74	IGHJ4
TGTGCGAAAGGCCTTAATTGCGATATTGTAGTGGTGGTAGCTGCTACTCCCATTTGG	CAKGLNCDIVVVVAATPIW	IGHV3-23	IGHJ4
TGTGCGAGGTTGCCCCTTTACGATATTTTGACTGGTTATGAATCCTACTGG	CARLPLYDILTGYESYW	IGHV4-28	IGHJ4
TGTGCGAGAGGAAATCGGCGTTCTTCGATAGTAGTACCAGCTGCTATGGACCGCTGTGACTACTGG	CARGNRRSSIVVPAAMDRCDYW	IGHV1-3	IGHJ4
TGTGCAAGATTGTCACCTATGGTTCAGGGAGTTATTGCTTACTACTACTACTACTACATGGACGTCTGG	CARLSPMVQGVIAYYYYYYMDVW	IGHV1-45	IGHJ6
TGTGCAAGAGATCATACGTTATGTAACCTCCTAGGATATTGTAGTGGTGGTAGCTGCTACCCGGGGGGGTACTACTTTGACTACTGG	CARDHTLCNLLGYCSGGSCYPGGYYFDYW	IGHV3-13	IGHJ4
TGTGCGAGGACTTATTACGATATTTTGACTGGTTATTATCCGAACTTTGACTACTGG	CARTYYDILTGYYPNFDYW	IGHV4-61	IGHJ4
TGTGCGAGAGATCGCGTGGCTACGACCTACTACTTTGACTACTGG	CARDRVATTYYFDYW	IGHV1-3	IGHJ4
TGTACTAGAGAGGAGGTGAATGACAGCTATGGTTTGTACTACTACTACTACTACATGGACGTCTGG	CTREEVNDSYGLYYYYYYMDVW	IGHV3-49	IGHJ6
TGTGCGAGCCTACTGGGCGAGGATATTGTAGTAGTACCAGCTGCTACGAATCCCAGGAACCTCATTTGG	CASLLGEDIVVVPAATNPRNLIW	IGHV1-69	IGHJ4
TGTGCGAGACATGGTCCAAATGACGATGACTACGGTGACTACATTGGTACTGACTACTGG	CARHGPNDDDYGDYIGTDYW	IGHV4-39	IGHJ4
TGTGCGAAAGATCTTTTAACGGGGAGGTATAGCAGCAGCTGGTACGGCCCATTCGCTGACTACTGG	CAKDLLTGRYSSSWYGPFADYW	IGHV3-23	IGHJ4
TGTGCGAAAGTTCGTATAGCAGCAGCGGGGAGTCGATCATCGAACTACTTTGACTACTGG	CAKVRIAAAGSRSSNYFDYW	IGHV3-NL1	IGHJ4
TGTCGCATGTTGAGGTATTGTGGTGGTGACTGCTATTACCTTGACTACTGG	CRMLRYCGGDCYYLDYW	IGHV3-7	IGHJ4
TGTGCGAAAAAGTGTCCGTTAGCTGCTCCCACGGGCGGCTACTACTACTACTACATGGACGTCTGG	CAKKCPLAAPTGGYYYYYMDVW	IGHV1-69	IGHJ6
TGTGCGAGAGTAAGTAGTAGTACCAGCTGCTATAAACTGGGTAAAACTGACTACTGG	CARVSSSTSCYKLGKTDYW	IGHV3-7	IGHJ4
TGTACCACAATCGTGTGGGAGTCCCGGCTGTATTGTAGTGGTGGTAGCTGCTACTCTACTTTACCAATCTGG	CTTIVWESRLYCSGGSCYSTLPIW	IGHV3-15	IGHJ3
TGTGCGAGAGATCGATCCCGGTCGGGTATAGCAGCAGCTTTGCCTCGGTGCTCAAGTGCGTTCGACCCCTGG	CARDRSRSGIAAALPRCSSAFDPW	IGHV1-18	IGHJ5
TGTGCGAAAGCGACCAGCTGCTATGGGAAGGAATTTGACTACTGG	CAKATSCYGKEFDYW	IGHV3-23	IGHJ4
TGTTCGTATTACGATTTTTGGAGTGGTTATTATCCCCAGCGTGACTACTGG	CSYYDFWSGYYPQRDYW	IGHV3-7	IGHJ4
TGTGCGAAACCTATTACTATGATAGTAGTGGTTATTACTCGATTTGACTACTGG	CAKPITMIVVVITRFDYW	IGHV3-NL1	IGHJ4
TGTGCGAGACTGTGGCTACTGCATCTTATGTGGTTCGACCCCTGG	CARLWLLHLMWFDPW	IGHV5-51	IGHJ5
TGTGCGAGAGGCAAAAGGGGTATTACGATTTTTGGAGTGGTTATTAAGCTGGACACTCTACCCCACTGGTTCGACCCCTGG	CARGKRGITIFGVVIKLDTLPHWFDPW	IGHV3-53	IGHJ5
TGTGCGAAAGGGTTCTACGGTGACTACGAGTACTGG	CAKGFYGDYEYW	IGHV3-23	IGHJ4
TGTGCGAGAGAGGTGCGTTCACCTATGGTTCAGGGAGTTATTAATGACTACTACTACTACTACATGGACGTCTGG	CAREVRSPMVQGVINDYYYYYMDVW	IGHV1-3	IGHJ6
TGTGCACGGTCCCACACAATGATAGTAGCGGAACCTAAGCTGGGTTTAGGCGACTACTGG	CARSHTMIVAEPKLGLGDYW	IGHV2-5	IGHJ4
TGTGCGAGAGATCATCCTTACTATGGTTCAGGGAGGATCGACTACTGG	CARDHPYYGSGRIDYW	IGHV3-11	IGHJ4
TGTGCGAGCCAAAGCGATCACCTAAGAAGGGTTGCAGCAGCTGGCGTATGGGAAGACTACTACTACTACATGGACGTCTGG	CASQSDHLRRVAAAGVWEDYYYYMDVW	IGHV1-18	IGHJ6
TGTCATTGGCGCATTGTAGTGGTGGTAGCTGCTTCCAAAGATGCTTTTGATATCTGG	CHWRIVVVVAASKDAFDIW	IGHV3-30-3	IGHJ3
TGTGCGAGAGTCAATGGTGCCAGGAGATCATATTACTACTACTACTACTACATGGACGTCTGG	CARVNGARRSYYYYYYYMDVW	IGHV7-4-1	IGHJ6
TGTGCAAAAGGGAAGCTTAAATTACGATTTTTGGAGTGGTTATTATACCTGGTGAGCGGCTGG	CAKGKLKLRFLEWLLYLVSGW	IGHV3-43	IGHJ4
