TGTGCAAGAGATCTTGAATCTGGCTATTGTAGTGGTGGTAGCTGCTTTGCTGTAGGGCCCCCACGCTACGGGGCGCCCTTCCTTGACTACTGG	CARDLESGYCSGGSCFAVGPPRYGAPFLDYW	IGHV3-13	IGHJ4
TGTGCTGTTTCGGGGAGAGAACTGGAAGTTGTAGTAGTACCAGCTCGAACCACGTCCGGATACTACTGG	CAVSGRELEVVVVPARTTSGYYW	IGHV3-30-3	IGHJ4
TGTGCGAGCATTTTCCCATGTGCCATTGTAGTAGTACCAGCTGCTATATACCGAAGCGTTCTGGGGTCAACGGGACAGCCCAACTACTACTACTACTACATGGACGTCTGG	CASIFPCAIVVVPAAIYRSVLGSTGQPNYYYYYMDVW	IGHV3-53	IGHJ6
TGTACTAGACTTTTCCGGTGGGAGCTACGGTGGAACGACTACTGG	CTRLFRWELRWNDYW	IGHV3-49	IGHJ4
TGTGCGAGAGATATAGTATTACGATTTTTGGAGTGGTTATCCGCCGGGGTGGATTTTGACTACTGG	CARDIVLRFLEWLSAGVDFDYW	IGHV3-11	IGHJ4
TGTGCAAGACTGAACTGGGATTACTATGATAGTAGTGGTTATTACTACGAGAGCTACTGG	CARLNWDYYDSSGYYYESYW	IGHV3-74	IGHJ4
TGTGCGAAAGATGGCGAGACTATCCTAGCAGTGGCTGCAGCCTCCTGG	CAKDGETILAVAAASW	IGHV3-23	IGHJ4
TGTGCGAGAGCCTCATCGATAGCAGCTCGTCCCCCAGATGACTACTGG	CARASSIAARPPDDYW	IGHV1-2	IGHJ4
TGTGCACGGATGGAGCCGTTGTATAGCAGCAGCTGGTACGAAATTTGTACCAGGGATGCTTTTGATATCTGG	CARMEPLYSSSWYEICTRDAFDIW	IGHV2-70	IGHJ3
TGTGCGATATGGTTCGGGGAGTTATCCGGGAAAGCTCTAGTTGATATCTGG	CAIWFGELSGKALVDIW	IGHV4-34	IGHJ3
TGTGCGAGAGATTGTTTGGGCCCATACGGGACTACGGTGACTACCTTGTACTGGTACTTCGATCTCTGG	CARDCLGPYGTTVTTLYWYFDLW	IGHV3-7	IGHJ2
TGTGCGAGAGAGGCCGTCCCATATTGTAGTGGTGGTAGCTCTCAACGGACCTACTACTACTACATGGACGTCTGG	CAREAVPYCSGGSSQRTYYYYMDVW	IGHV1-46	IGHJ6
TGTGCAAGAGTAGAGCAGCAGCTGCGAAACTTTGACTACTGG	CARVEQQLRNFDYW	IGHV3-13	IGHJ4
TGTGCGAAAGGGGAACGCCTTCGTGGGGACACTCCACTCTACTTTGACTACTGG	CAKGERLRGDTPLYFDYW	IGHV3-NL1	IGHJ4
TGTGCGAGTGCAGCAGCAGTGGCTGGTACGTACTACTTTGACTACTGG	CASAAAVAGTYYFDYW	IGHV5-10-1	IGHJ4
TGTGCGAGAGGTGTATGGTATTGTAGTGGTGCGGGGGACTGGAAAAACTACTGG	CARGVWYCSGAGDWKNYW	IGHV4-59	IGHJ4
TGTGCGAAACAGAAGTATAACCCCAGTGGCTGGTATATGTGGTCCTGGGGTACGGGGTGG	CAKQKYNPSGWYMWSWGTGW	IGHV3-23	IGHJ4
TGTGCGAACAAGCCCGATGATTACATTTGGGGGAGTTATCGGCTTACAGGGTACTGG	CANKPDDYIWGSYRLTGYW	IGHV3-NL1	IGHJ4
TGTGCACAATCCCCGGATTGTACTGGTGGTGTATGCAGGCTGGGTAGCTACTGGTACTTCGATCTCTGG	CAQSPDCTGGVCRLGSYWYFDLW	IGHV3-74	IGHJ2
TGTGCACGGAATTGCCCGGTATTACGATATTTTGACTGGTTATTATGGGTTGATGACTACTGG	CARNCPVLRYFDWLLWVDDYW	IGHV2-70	IGHJ4
TGTGCGAGACTTGGATCCGGTATAGCAGCTCGTCACTCGGGGAAACATTATGACTACTGG	CARLGSGIAARHSGKHYDYW	IGHV5-51	IGHJ4
TGTGCGAAAACCGGGGACTACAGGACCTACTACATGGACGTCTGG	CAKTGDYRTYYMDVW	IGHV3-23	IGHJ6
TGTGCGAGTTCTCGGAGTGGTTATCTTTTTGTTTTCTACTTTGACTACTGG	CASSRSGYLFVFYFDYW	IGHV1-69	IGHJ4
TGTACCTCCCATAGCAGCTCGCTTAAACCCTACTACTACTACTACTACATGGACGTCTGG	CTSHSSSLKPYYYYYYMDVW	IGHV3-49	IGHJ6
TGTGCACGGATGAATGGCCGGAGTTGGAATATTTTGGGTATGATTACATTTGGGGGAGTTATCGTTATCGAGGACTACTGG	CARMNGRSWNILGMITFGGVIVIEDYW	IGHV2-26	IGHJ4
TGTGCGAAAGATCCCGAGACCGTGGAAAACCGTCACTACTTTGACTACTGG	CAKDPETVENRHYFDYW	IGHV3-23	IGHJ4
TGTGCGAGACACTCGACTACGTATTACGATTTTTGGAGTGGTTACTTGAATCAATTAGAACTTTACTACTACTACTACATGGACGTCTGG	CARHSTTYYDFWSGYLNQLELYYYYYMDVW	IGHV5-10-1	IGHJ6
TGTGCGAGAGACCCCTCCGCGGTATTACGATATTTTGACTGGTTATTATACAGCTGG	CARDPSAVLRYFDWLLYSW	IGHV1-3	IGHJ5
TGTACCACAGACCTGGTTAAAGAGATTACTATGGTTCAGGGAGTTATTATAACCCTCGAATACTTCCAGCACTGG	CTTDLVKEITMVQGVIITLEYFQHW	IGHV3-15	IGHJ1
TGTGCGAGAGATCCACATGCGATTGTAGTGGTGGCCTCCTTTGACTACTGG	CARDPHAIVVVASFDYW	IGHV1-3	IGHJ4
TGTGCGAGACATGCTTCGGCTCGGGGGGGTAACTGG	CARHASARGGNW	IGHV4-39	IGHJ4
TGTGCGAGAGATAAACCCGTGTGCTACTACTACTACTACATGGACGTCTGG	CARDKPVCYYYYYMDVW	IGHV3-66	IGHJ6
TGTGCAAGCTGTCATATTGTGGTGGTGACTAACTTGGATGACTACTGG	CASCHIVVVTNLDDYW	IGHV3-13	IGHJ4
TGTACCACAGATTTAGACGTGGATACAGCTATGGTTTACTTTGACTACTGG	CTTDLDVDTAMVYFDYW	IGHV3-15	IGHJ4
TGTGCGAGAGATTTATTAGCTATTCGTGGCCGACCAGGATACGATTTTTGGAGTGGTTATTTATCTCAAGTGAGGGGCGTACACACCTTGAATGATGCTTTTGATATCTGG	CARDLLAIRGRPGYDFWSGYLSQVRGVHTLNDAFDIW	IGHV4-59	IGHJ3
TGTGCGCGTTATAGCAGCTCGGGGAGCGAATTTGACTACTGG	CARYSSSGSEFDYW	IGHV4-34	IGHJ4
TGTGCGAGACGTGTATTACGATTTTTGGAGTGGTTATTAAACTACTGGTACTTCGATCTCTGG	CARRVLRFLEWLLNYWYFDLW	IGHV3-20	IGHJ2
TGTGCGAAAGATCGGGACCTTCGAAAGGCCGATTGTAGTGGTGGTAGCTGCTCCGGCCGGCTAGGTAATTGTGAATACTTCCAGCACTGG	CAKDRDLRKADCSGGSCSGRLGNCEYFQHW	IGHV3-NL1	IGHJ1
TGTGCAAGATCTGGGCAGGTTAGCAGTGGCGGGGCAGCCGTTGACTACTGG	CARSGQVSSGGAAVDYW	IGHV1-45	IGHJ4
TGTGCGAGAGTCCAACATCCGCCGACTACGGTGGTAACTCCGGGATTTGACTACTGG	CARVQHPPTTVVTPGFDYW	IGHV1-46	IGHJ4
TGTGCGAGACGATTTTTGGAGTGGTTTACGGTTTTTGACTACTGG	CARRFLEWFTVFDYW	IGHV1-2	IGHJ4
TGTGCGATTCAAAGTACCAGCTGGTTCGACCCCTGG	CAIQSTSWFDPW	IGHV3-11	IGHJ5
TGTGCAAGAACCGGGGGATATTGTAGTAGTACCAGCTGCTATAGGAATTTAACAAATGACTACTGG	CARTGGYCSSTSCYRNLTNDYW	IGHV3-74	IGHJ4
TGTGCGAGAGGGGGGGACTTCGTGGGTGACTGCTATCCTGTACCAGACTACTGG	CARGGDFVGDCYPVPDYW	IGHV3-20	IGHJ4
TGTGCGAGGCGGGGGAGTGACCCCTACTGG	CARRGSDPYW	IGHV5-10-1	IGHJ4
TGTGCGAGCCCCGTGACTACGGTGGTAACCTTTGACTACTGG	CASPVTTVVTFDYW	IGHV4-34	IGHJ4
TGTGCAAGAGTATATCATGCAATTGTACTAATGGTGTATGCTACGCCTAACTGGTTCGACCCCTGG	CARVYHAIVLMVYATPNWFDPW	IGHV3-13	IGHJ5
TGTGCGAGACGATCCGTATTACGATATTTTGACTGGTTATTATCGTACCTGCACTACTACTACTACTACATGGACGTCTGG	CARRSVLRYFDWLLSYLHYYYYYMDVW	IGHV5-51	IGHJ6
TGTGCGAAAGTATATTACTATGGTTCAGGGAGTGCATTCTTTGACTACTGG	CAKVYYYGSGSAFFDYW	IGHV3-NL1	IGHJ4
TGTGCAAGAGGGGGGGATAGCAGCAGGAGCTTTGACTACTGG	CARGGDSSRSFDYW	IGHV3-74	IGHJ4
TGTGCGAGAGCCAGAACCGGGCGGGCCGATATTGTAGTAGTACCAGCTGCTATTCCGGCTTTTGATATCTGG	CARARTGRADIVVVPAAIPAFDIW	IGHV4-34	IGHJ3
TGTGCGAGAGCCTGGAAAGGGTATTACGATATTTTGACTAATTGGATGGTTCCCTTTGACTACTGG	CARAWKGYYDILTNWMVPFDYW	IGHV4-59	IGHJ4
TGTGCGAGGACTAACACCCTCCAAATAACTGGAACTGACTACTGG	CARTNTLQITGTDYW	IGHV4-4	IGHJ4
TGTGCGAGAGATGTTTGGTTGTACTGGTGGTGTATGACGGTGCTTCCGGCCCTGGAACGGGCCCCAACCTTTGACTCCTACATGGACGTCTGG	CARDVWLYWWCMTVLPALERAPTFDSYMDVW	IGHV4-34	IGHJ6
TGTGCGAGAGGCGGACCCCGCTTTGGAGTGGTTATTATGTGCTACTACTACTACTACATGGACGTCTGG	CARGGPRFGVVIMCYYYYYMDVW	IGHV4-34	IGHJ6
TGTGCGAAAAACCGAGAATATGCAGAGGGGGGTTTTGACTACTGG	CAKNREYAEGGFDYW	IGHV3-23	IGHJ4
TGTGACCGGTATAGCAGCAGCTCGATATTGCTTGCTTGTTACTGG	CDRYSSSSILLACYW	IGHV3-NL1	IGHJ4
TGTGCGAGCTATATAGCAGCAGCTGGTACCTTTTACCTATTTTACTACTACTACTACATGGACGTCTGG	CASYIAAAGTFYLFYYYYYMDVW	IGHV3-48	IGHJ6
TGTGCGAGACAACGAGGATATTGTAGTAGTACCAGCTGCTACTGGACGCCCCACTACTACTACTACTACATGGACGTCTGG	CARQRGYCSSTSCYWTPHYYYYYMDVW	IGHV5-51	IGHJ6
TGTGCGAGACATCGTATTACTATGGTTCAGGGATCTTGGAGGGTGATCTTTGACTACTGG	CARHRITMVQGSWRVIFDYW	IGHV4-39	IGHJ4
TGTGAGATGTGGTATTGTAGTGGTGGTAGCTGCTACCAGGCCGAGAACCCATACTACTACTACTACATGGACGTCTGG	CEMWYCSGGSCYQAENPYYYYYMDVW	IGHV3-66	IGHJ6
TGTGCGAAAGCGGGCCGCCGGTATTGTAGTGTTTCCTACTGG	CAKAGRRYCSVSYW	IGHV3-NL1	IGHJ4
TGTACTAGACATCACAATAGCAGCTCGTTGGAACTTGATGCTTTTGATATCTGG	CTRHHNSSSLELDAFDIW	IGHV3-73	IGHJ3
TGTGCGAGACGCCTTACTTACTATGATAGTAGTGGTTATGATTGGATTGACTACTGG	CARRLTYYDSSGYDWIDYW	IGHV5-10-1	IGHJ4
TGTGCGAGGACTCTAAGCGGCCCTTCTCCCCCAGATTACTATGATAGTAGTGGTTATTATCCATACTTCCAGCACTGG	CARTLSGPSPPDYYDSSGYYPYFQHW	IGHV3-20	IGHJ1
TGTGCGAAAGGGCCCCAGAATATTGTACTGGTGGTGTATGCTATCGAGGGGATATACGTGGACTACTGG	CAKGPQNIVLVVYAIEGIYVDYW	IGHV3-NL1	IGHJ4
TGTGCGAAATCAGGGAGTTGGTTCGCCACGGACTACTACTACTACTACATGGACGTCTGG	CAKSGSWFATDYYYYYMDVW	IGHV5-51	IGHJ6
TGTACTAGAGTAGGGACGAACTGGAATCCCTCCGCCCTAAGCTGGTTCGACCCCTGG	CTRVGTNWNPSALSWFDPW	IGHV3-49	IGHJ5
TGTGCGAGAAGGCCGTATAGCAGTGGCTGGGGCTGG	CARRPYSSGWGW	IGHV4-39	IGHJ5
TGTGCGAGATCGGGGTTCCGTACTATGATAGTAGTTTACTTTGACTACTGG	CARSGFRTMIVVYFDYW	IGHV5-10-1	IGHJ4
TGTGCGAGATATTGTAGTAGTACCAGCTGCATCTGGTTCGACCCCTGG	CARYCSSTSCIWFDPW	IGHV7-4-1	IGHJ5
TGTGCGAATCGGAGGGGGCCGAAACTATGTGCTTTTGATATCTGG	CANRRGPKLCAFDIW	IGHV3-NL1	IGHJ3
TGTGCGAAAGATTGGAACGGGTCTCACTACTACTACTACATGGACGTCTGG	CAKDWNGSHYYYYMDVW	IGHV3-23	IGHJ6
TGTGCGAAAGATCGTGGTGGTAGCTGCTACTCCCCGGAACGGTTAGCCTGGAATGCACCGGACTACTGG	CAKDRGGSCYSPERLAWNAPDYW	IGHV3-NL1	IGHJ4
TGTGCGAGAGTGGAGAAACCCGTGGTGGTAGCTGCTACTCGGGCCAGAACTCCATACTTTGACTACTGG	CARVEKPVVVAATRARTPYFDYW	IGHV1-3	IGHJ4
TGTGCGAGCGTTATACAGCTATGGTTTTGGCAAACCGGTGACTACTGG	CASVIQLWFWQTGDYW	IGHV1-2	IGHJ4
TGTGCGAGAGCAAACCCAGGAGATTTTTGGAGTGGTTATTATACTACACCTCGGGCGTACATGGACGTCTGG	CARANPGDFWSGYYTTPRAYMDVW	IGHV3-53	IGHJ6
TGTGCGAGGTATTACTATGACATTCCGTCCTCCCCCAAGGCCATAGGATCCCCTGGCTTTGACTACTGG	CARYYYDIPSSPKAIGSPGFDYW	IGHV3-53	IGHJ4
TGTGCGAGAGCGATTTATAGCAGCAGCTGGTACGTGGAACAGGTTGACTACTGG	CARAIYSSSWYVEQVDYW	IGHV1-2	IGHJ4
TGTGCGAGAGGACTTGACCACATAAGACCATGCCAGGCCGGGTATAGCAGTGGCTGGTACCTGGGGCCCATGGGGAGGGTACGTATTGCTCCCATATTTGACTACTGG	CARGLDHIRPCQAGYSSGWYLGPMGRVRIAPIFDYW	IGHV3-11	IGHJ4
TGTGCGAGAGGCGGTCCTGGTTGCTACTTTTGTAGTAGTACCAGCTCCCAGTGGTTCGACCCCTGG	CARGGPGCYFCSSTSSQWFDPW	IGHV4-34	IGHJ5
TGTGCGAGACATAGGTCTCAGTTATTACGATATTTTGACTGGTTATTAGTAACCTCTGTCTATTACTACTACTACTACTACATGGACGTCTGG	CARHRSQLLRYFDWLLVTSVYYYYYYYMDVW	IGHV4-39	IGHJ6
TGTGCGAGAGATGACAGTACGATCCAGATGGCTACAGGGGAGTCCCACTACTTTGACTACTGG	CARDDSTIQMATGESHYFDYW	IGHV3-66	IGHJ4
TGTGCGAGAGATGACGATTACGATATTTTGCCTATCTACAACTGGTTCGACCCCTGG	CARDDDYDILPIYNWFDPW	IGHV1-69	IGHJ5
TGTGCGAAAGATCGGCTCGGGGGTAGCAGCAGCTGGTACCCCGACTACTTTGACTACTGG	CAKDRLGGSSSWYPDYFDYW	IGHV3-23	IGHJ4
TGTGCGAAAGACCCTATTGTAGTAGTACCAGCTGCTATCGGGAGAGGATTTGACTACTGG	CAKDPIVVVPAAIGRGFDYW	IGHV3-23	IGHJ4
TGTGCACACAGAGGTTCTTATGATTACGTTTGGGGGAGTTATCGTTCGGCGATATTTTACTACTTTGACTACTGG	CAHRGSYDYVWGSYRSAIFYYFDYW	IGHV2-5	IGHJ4
TGTGCGAGAGAAGGAACGATGCAGTGGCTGGTACGTCCATACAACTGGTTCGACCCCTGG	CAREGTMQWLVRPYNWFDPW	IGHV3-48	IGHJ5
TGTGCGAGATTCCAGGATATTGTAGTGGTGGTAGCTGCTAGACTCGTGATCTTTGACTACTGG	CARFQDIVVVVAARLVIFDYW	IGHV7-4-1	IGHJ4
TGTGCGAGAGATTTCATTGCACCCATTCGTAACCCCCCCGGAAGGTGCCCAGTGGGAGCTACTTCTGACATTGACTACTGG	CARDFIAPIRNPPGRCPVGATSDIDYW	IGHV1-2	IGHJ4
TGTGCGAGAGCCTCGCACCGGAACTTTGACTACTGG	CARASHRNFDYW	IGHV1-18	IGHJ4
TGTACCACAGATGAAGGAGCATATAGTGGCTGGTGGACGTTTTTTAGATTCTACTGG	CTTDEGAYSGWWTFFRFYW	IGHV3-15	IGHJ4
TGTGCGAGAGGACATGCGGAAATTGTACTAATGGTGTATGCTATACGTCTCTTTGACTACTGG	CARGHAEIVLMVYAIRLFDYW	IGHV7-4-1	IGHJ4
TGTGCGAGCGTTGGTGATATTGTAGTAGTACCAGCTGCTAATCAACGGGCGGTGTACTACTACTACATGGACGTCTGG	CASVGDIVVVPAANQRAVYYYYMDVW	IGHV3-7	IGHJ6
TGTGCGACCTTTATGGTAGCAGCAGCTGGTAAGAACTACTACTACTACTACATGGACGTCTGG	CATFMVAAAGKNYYYYYMDVW	IGHV3-NL1	IGHJ6
TGTACTAGTCCGGGGACGTTAGTAAAATACACCTACTACTACTACTACATGGACGTCTGG	CTSPGTLVKYTYYYYYMDVW	IGHV3-73	IGHJ6
TGTGCGAGAGCCAAATGTCGTCTATGGTTCAGGGAGTTATTATTAAACGTGGTTGGGAGCATCTACTACTACTACTACATGGACGTCTGG	CARAKCRLWFRELLLNVVGSIYYYYYMDVW	IGHV3-53	IGHJ6
TGTGCGAGAGATCGGGACGGGGACCCTGGTAGGGCCCTCCACCCAAATTTTAGAGTATTCTCTCTGTACAACTGGTTCGACCCCTGG	CARDRDGDPGRALHPNFRVFSLYNWFDPW	IGHV3-7	IGHJ5
TGTGCACGGATACGTCCCCCGGCAGTGGCTGGTACGTACCCAACGGTCTGGTTCGACCCCTGG	CARIRPPAVAGTYPTVWFDPW	IGHV2-70	IGHJ5
TGTGCGAGAGGCGCGAAAATTGTAGTGGTGGTAGTGTTCGCGTACTTTGACTACTGG	CARGAKIVVVVVFAYFDYW	IGHV4-34	IGHJ4
