TGTGCGAAAGATCAATCTATTGTACTGGTGGTGTATGCTATACCGGGGCCTTACTACTACTACTACTACATGGACGTCTGG	CAKDQSIVLVVYAIPGPYYYYYYMDVW	IGHV3-NL1	IGHJ6
TGTGCGAAAGATAAAGCAGGGTATAACTGGAACGACAACTGGTTCGACCCCTGG	CAKDKAGYNWNDNWFDPW	IGHV3-NL1	IGHJ5
TGTGCGAGAGATCCTATTGTGGTGGTGACTGCCCCCCCTCCGACCTACTGG	CARDPIVVVTAPPPTYW	IGHV4-59	IGHJ4
TGTGCAAGAGATCTAAGTCACCATAGCAGCTCGCGGACCCGTGACTACTGG	CARDLSHHSSSRTRDYW	IGHV3-13	IGHJ4
TGTACCACAGCCATTTACACTTACGATTACGAATTCTTTGACTACTGG	CTTAIYTYDYEFFDYW	IGHV3-15	IGHJ4
TGTGCGCCGTCAGCCCGTGGCGATTTTTGGAGTGGTTATTATCAACACTACTACTACTACATGGACGTCTGG	CAPSARGDFWSGYYQHYYYYMDVW	IGHV4-61	IGHJ6
TGTGCACACAGACATACGGATTGTTTACGATTTTTGGAGTGGTTATTGCCAGTACTCTGG	CAHRHTDCLRFLEWLLPVLW	IGHV2-5	IGHJ3
TGTGCGAGAGAGGCCGTCTATGGTTCAGGGAGTTATTTTTGGTTTGACTACTGG	CAREAVYGSGSYFWFDYW	IGHV1-2	IGHJ4
TGTGCGAGGGTTTTCAGGGAGTTATTATCCCCTTTAGACTACTGG	CARVFRELLSPLDYW	IGHV3-23	IGHJ4
TGTGCAAGAGATGGTGTCCTAGGGGGGTATACTTCTGGGAGTCTTGACTACTGG	CARDGVLGGYTSGSLDYW	IGHV3-13	IGHJ4
TGTGCGAAAGGAGGTCATGTGGTAGCTGCTACTCCAGGGGACTACTGG	CAKGGHVVAATPGDYW	IGHV3-NL1	IGHJ4
TGTGCACGGATTACACTAAGCCGCCTTATGATTACACGAGCTAACTGGTTCGACCCCTGG	CARITLSRLMITRANWFDPW	IGHV2-26	IGHJ5
TGTGCGAGAGGGCCCGGGATCTGTAGTGGTGGTAGCTGCTACTGCCAATGGTTCGACCCCTGG	CARGPGICSGGSCYCQWFDPW	IGHV1-18	IGHJ5
TGTGCGAGAGAGGGGCGCCTCGTAATTGTAGTAGTACCAGCTGCTATACTGGATGCTTTTGATATCTGG	CAREGRLVIVVVPAAILDAFDIW	IGHV1-46	IGHJ3
TGTGCAGGGGGGCGAGTAGACATTGTGGTGGTTGACTACTGG	CAGGRVDIVVVDYW	IGHV4-39	IGHJ4
TGTGCGAGAGATCTCTCAACCCGGCTGGTACACCTCGGGATCTGG	CARDLSTRLVHLGIW	IGHV1-3	IGHJ5
TGTGCACACAACGAACCGTGTAATTACCCGGCTATAGCAGCTCGTCCAGTGGAAAACTGGTTCGACCCCTGG	CAHNEPCNYPAIAARPVENWFDPW	IGHV2-5	IGHJ5
TGTGCGAGAGATCGGGATATTGTAGTAGTACCAGCTGCTATGTACTACTACTACATGGACGTCTGG	CARDRDIVVVPAAMYYYYMDVW	IGHV3-7	IGHJ6
TGTGCAAAAGATGGGTATAACTGGTACGACTACTGG	CAKDGYNWYDYW	IGHV3-43D	IGHJ4
TGTGCGATCCCATTAGTGGGAGCTACTCAGACAGCCGTCTTACTTGGTGACTACTGG	CAIPLVGATQTAVLLGDYW	IGHV4-59	IGHJ4
TGTGCACGGAAGCCCCTGGCCGTTGGTCTGGTGGTAGCTGCTACGGACAGTTACTACTACTACTACTACATGGACGTCTGG	CARKPLAVGLVVAATDSYYYYYYMDVW	IGHV2-70	IGHJ6
TGTGCGAGAGATAGGGTTCGCCGTACCATTGTAGTAGTACCAGCTGAAAAATACTCTGTATACTACTTTGACTACTGG	CARDRVRRTIVVVPAEKYSVYYFDYW	IGHV1-3	IGHJ4
TGTGCGAAAGATGGTCCCGGGTATAGCAGCAGTAAATACTACTACTACTACATGGACGTCTGG	CAKDGPGYSSSKYYYYYMDVW	IGHV3-23	IGHJ6
TGTGCGAAAGGATCTATTACTATGGTTCAGGGAGTTATCCCCTTTGACTACTGG	CAKGSITMVQGVIPFDYW	IGHV3-23	IGHJ4
TGTGCGAGACCCCAGCCATTACGATTTTTGGAGTGGTTATTGGGGGTTTACTTTGACTACTGG	CARPQPLRFLEWLLGVYFDYW	IGHV4-61	IGHJ4
TGTGTCCTCCTCCTCGATATTGTAGTAGTACCAGCTGCCGACTTTGATGTCTACTACTACTACTACATGGACGTCTGG	CVLLLDIVVVPAADFDVYYYYYMDVW	IGHV3-30-3	IGHJ6
TGTGCGAGCGACCCATTGACAGCTATGGGGAGGAACTGGTTCGACCCCTGG	CASDPLTAMGRNWFDPW	IGHV4-34	IGHJ5
TGTGCGAGAGAGGAGTATTGTAGTAGTACCAGCTGCTGGTCTTACTACTACTACTACATGGACGTCTGG	CAREEYCSSTSCWSYYYYYMDVW	IGHV1-69	IGHJ6
TGTGCGAAACAGAGTCGGGGACTGGTGGTGTATGCTATATCGGATTCAGCGTTTCATGACTACTGG	CAKQSRGLVVYAISDSAFHDYW	IGHV3-23	IGHJ4
TGTGCGAAAGGATTATACTTTGACTACTGG	CAKGLYFDYW	IGHV3-23	IGHJ4
TGTGCGAAAGTTACTCATGGTGGTAGTGGGACCCTGGGGGACTTTGACTACTGG	CAKVTHGGSGTLGDFDYW	IGHV3-23	IGHJ4
TGTGCGAAGATAGTTATGTATAGCAGCAGCCAGGGATCCGGGGCTGTTGTTGTTGACTACTGG	CAKIVMYSSSQGSGAVVVDYW	IGHV1-69	IGHJ4
TGTGCGAGACGCCACTCCTACAGCTATGGTTGGCATCTCGCCACGTCTCCCCTCTACTTTGACTACTGG	CARRHSYSYGWHLATSPLYFDYW	IGHV5-51	IGHJ4
TGTGCGTCGGCTATAGCAGCTCGTCTTGCGGTCCACATGACGCACATGGACGTCTGG	CASAIAARLAVHMTHMDVW	IGHV1-69	IGHJ6
TGTGCGAGAGATCTAGCAGCTCGTACCTACATGTGTACAAGCCGCGGGTACTTCGATCTCTGG	CARDLAARTYMCTSRGYFDLW	IGHV3-11	IGHJ2
TGTGCGAGACCCCCCTCCGGTGCAGCAGCGTCCTACTTTGACTACTGG	CARPPSGAAASYFDYW	IGHV1-69	IGHJ4
TGTGCGAAAGATTGGTACGGTATTGTAGTGGTGGTAGCTGCTACTGACTACTGG	CAKDWYGIVVVVAATDYW	IGHV3-NL1	IGHJ4
TGTGCGAGGTATAGCAGCAGCTGGTACACCTACTGG	CARYSSSWYTYW	IGHV1-3	IGHJ4
TGTGCATTTCCTTTACCCGGGTATAGCAGTGGCTGGCCCGACACATTTGACTACTGG	CAFPLPGYSSGWPDTFDYW	IGHV4-59	IGHJ4
TGTGCGAGAGGGCGTACAGTAGTGGTTATTACGCGAACCCCAACAGACTACTGG	CARGRTVVVITRTPTDYW	IGHV1-2	IGHJ4
TGTGTATCGGAGATCCGTAGTGGTGGTAGCTGCTACGTTACCTACTTTGACTACTGG	CVSEIRSGGSCYVTYFDYW	IGHV3-30	IGHJ4
TGTACCACAGATCCTTCGGGCGAGAAGGCCCGATATATTTGGGGGTTCGACCCCTGG	CTTDPSGEKARYIWGFDPW	IGHV3-15	IGHJ5
TGTGCGAGAGATCTGCCCAGGGGTGACTACATTCCCTACTGGTACTTCGATCTCTGG	CARDLPRGDYIPYWYFDLW	IGHV4-61	IGHJ2
TGTGCGAGAGACAAACCCTTCCCAAACGTGGGATACTACTACTACATGGACGTCTGG	CARDKPFPNVGYYYYMDVW	IGHV3-53	IGHJ6
TGTGCGAGACTCCGCTATTGTAGTGGTGGTAGCTGCTACTCGATCACTACGGTTGACTACTGG	CARLRYCSGGSCYSITTVDYW	IGHV5-51	IGHJ4
TGTGCGAGAATTAACGGAAGGCACGTATTACGATTTTTGGAGTGGTTAGCGCGAGGGGGATACTACATGGACGTCTGG	CARINGRHVLRFLEWLARGGYYMDVW	IGHV3-30	IGHJ6
TGTGCGAACATAGATGGGCCTTTTGGGCTCTACTTTGACTACTGG	CANIDGPFGLYFDYW	IGHV4-59	IGHJ4
TGTGCGAGATCTCCCCGCCCCGTACTATGTTTCCTACATATTGACTACTGG	CARSPRPVLCFLHIDYW	IGHV5-10-1	IGHJ4
TGTGCGAGCTCAAGCCCTATTGTAGTGGTGGTAGCTGCTACGGCTTTTGACTACTGG	CASSSPIVVVVAATAFDYW	IGHV5-51	IGHJ4
TGTGCGAGAATTGACCTCTACTATGAATGGCGTGCCTACCAGGTCTTAGACCTACTGTGGTACAACTGGTTCGACCCCTGG	CARIDLYYEWRAYQVLDLLWYNWFDPW	IGHV5-10-1	IGHJ5
TGTGCACGGATACCTAATAGCAGTGGCTGGTATCGCCCATTCCGTGCTTTTGATATCTGG	CARIPNSSGWYRPFRAFDIW	IGHV2-26	IGHJ3
TGTGCAAGAGATTATAATATTACTATGATAGTAGTGGTTATAAGCTGCCGATTTGACTACTGG	CARDYNITMIVVVISCRFDYW	IGHV3-13	IGHJ4
TGTGCGAAAGATCGGGCCTGTATAGCAGTGGCTGGTACTGACTACTGG	CAKDRACIAVAGTDYW	IGHV3-23	IGHJ4
TGTGCGACCCCGGGTGGTGGTAGCTGCTACCGTTTTGACTACTGG	CATPGGGSCYRFDYW	IGHV3-11	IGHJ4
TGTGCGAGAGAAAGTTCCTCGCTGGATGGGGGGATACAGCTATGGTTACTGTGGTTCGACCCCTGG	CARESSSLDGGIQLWLLWFDPW	IGHV3-48	IGHJ5
TGTGCGAGAGTCATCGGATTACAGTGGCTGGAATGCTACTACTACATGGACGTCTGG	CARVIGLQWLECYYYMDVW	IGHV4-59	IGHJ6
TGTGCGAGTAGTCAGAAGCAGTGGCTAAAGCCGCCATACTTTGACTACTGG	CASSQKQWLKPPYFDYW	IGHV4-59	IGHJ4
TGTGCGATGGCCTATGCAGTGGCTGGTACATCCCAGTCGGAATGGATTGACTACTGG	CAMAYAVAGTSQSEWIDYW	IGHV1-2	IGHJ4
TGTGCAAGAGATCTCGAGGGGCTAGTCACGTATTACGATTTTTGGAGTGGTTATATGGCTCGTCATTACTACTACTACTACTACATGGACGTCTGG	CARDLEGLVTYYDFWSGYMARHYYYYYYMDVW	IGHV3-74	IGHJ6
TGTGCAAAAGATACGTTTGGGGGAGTTATCGAAGACTTTGACTACTGG	CAKDTFGGVIEDFDYW	IGHV3-43D	IGHJ4
TGTGCGGGCCTTGGACTCCAGCAGTGGCTGGGATGCGGGTATTCCTATGATGCTTTTGATATCTGG	CAGLGLQQWLGCGYSYDAFDIW	IGHV4-39	IGHJ3
TGTGCAAGAGATCGAGTGGGAAACACGATTTTTGGAGTGGTTATTATACCGGGGGGCGGAAGGGATGACTACTGG	CARDRVGNTIFGVVIIPGGGRDDYW	IGHV3-13	IGHJ4
TGTGCTAGAGTATCCCACCGGAGCCATTTCTCGGGGAGTTGTCCGGAAAGAAAAAGGCCTCCCATCTTGGTCTACTGG	CARVSHRSHFSGSCPERKRPPILVYW	IGHV3-72	IGHJ4
TGTGCGAGAGTGGGATGGGTCTACGGTGACTACGGGAATAAGAACATGGTGGCCGAGTACTACTACTACTACATGGACGTCTGG	CARVGWVYGDYGNKNMVAEYYYYYMDVW	IGHV3-48	IGHJ6
TGTGCGAGGTCCCCCGATCATTGTAGTGGTGGTAGCTGCTACTCTTGGGAGGATAACTGGTTCGACCCCTGG	CARSPDHCSGGSCYSWEDNWFDPW	IGHV4-59	IGHJ5
TGTGCGAGAGATCCGAGATGGCCCCACTGG	CARDPRWPHW	IGHV3-66	IGHJ4
TGTGCAAGACTAGGGTTGGGAGCTACGATTTTTGGCTACTGG	CARLGLGATIFGYW	IGHV3-13	IGHJ4
TGTGCGAGACAACGGGCAGTGGGAGCTACAAATATTTTTTTTGACTACTGG	CARQRAVGATNIFFDYW	IGHV5-51	IGHJ4
TGTGCGAGAGTACCGGGTTGGAGGATTGACTACTGG	CARVPGWRIDYW	IGHV1-69	IGHJ4
TGTGCGAGAGATCCAAATTGTAGTAGTACCAGCTGCTACAATGATGCTTTTGATATCTGG	CARDPNCSSTSCYNDAFDIW	IGHV4-4	IGHJ3
TGTACTAGAGCCCGTCTATATTGTAGTAGTACCAGCTGCTATGAACGATGGTACTACTACTACTACATGGACGTCTGG	CTRARLYCSSTSCYERWYYYYYMDVW	IGHV3-49	IGHJ6
TGTGCGAGAGATGGGGCCTCGATTTTTGGAGTTCTGTGGGGTCCTTGTTGG	CARDGASIFGVLWGPCW	IGHV3-7	IGHJ5
TGTGCGAACTTTCGGGGAGTTATTGCGGACTTTAACTGGTTCGACCCCTGG	CANFRGVIADFNWFDPW	IGHV3-11	IGHJ5
TGTGCGCGGTCTATAGCAGCCCACGACTACTACTACTACTACATGGACGTCTGG	CARSIAAHDYYYYYMDVW	IGHV3-30-3	IGHJ6
TGTGCGAAAGATGAGGGGTGTATAGCAGCAGCTGGTAGGAAGAAATTATACTTTGACTACTGG	CAKDEGCIAAAGRKKLYFDYW	IGHV3-NL1	IGHJ4
TGTGCGAGAGGTGTTGGCTACGATAACCTAGGGGGAGGCCGGCATTACTACTACTACTACTACATGGACGTCTGG	CARGVGYDNLGGGRHYYYYYYMDVW	IGHV4-61	IGHJ6
TGTGCGAGAGAGGGGAACGATTTTTGGAGTGGTTATTATCAATCATACTACTACTACTACTACATGGACGTCTGG	CAREGNDFWSGYYQSYYYYYYMDVW	IGHV4-4	IGHJ6
TGTGCGAGCATTTGTCGTCCGAATGACGGTGGTAACTCCGGAGTTTTGGCAGCCACGGTAAACTGGTTCGACCCCTGG	CASICRPNDGGNSGVLAATVNWFDPW	IGHV4-61	IGHJ5
TGTACCACAGAATATTACGGTGACTACACCCCGGACTACTGG	CTTEYYGDYTPDYW	IGHV3-15	IGHJ4
TGTGCGAGAGATGGGATTGAAGAGGGGGCCTGCTCGTCGCCGATTACTATGGTTCAGGGAGTTATTATCAGGCTCGGCTACTGG	CARDGIEEGACSSPITMVQGVIIRLGYW	IGHV1-2	IGHJ4
TGTGCGAAATTAGCCGATTACGATATTTTGACTGGTTCAGTTTTTGACTACTGG	CAKLADYDILTGSVFDYW	IGHV3-23	IGHJ4
TGTGCGAGAGATCTTAGCTATAGTGGGAGCTACGGCCCCTCCGATGACTACTGG	CARDLSYSGSYGPSDDYW	IGHV3-53	IGHJ4
TGTACCACAGATTGGAAGGTCGGCGGGCGTAGCCGCTCAGGGAATTGTAGTAGTACCAGCTGCAAAGTCAACTGGTTCGACCCCTGG	CTTDWKVGGRSRSGNCSSTSCKVNWFDPW	IGHV3-15	IGHJ5
TGTGCGAGCGCGGGGGATTGGGATTGGTACTTTGACTACTGG	CASAGDWDWYFDYW	IGHV4-4	IGHJ4
TGTGCGAGAGGCGGTATAGCAGTGGCTGTCCGTATCCAGCACTGG	CARGGIAVAVRIQHW	IGHV7-4-1	IGHJ1
TGTGCGAGGTCTGGGGATATTGTAGTAGTACCAGCTGCTATCATAGATTTGGTCTACTACTACTACTACATGGACGTCTGG	CARSGDIVVVPAAIIDLVYYYYYMDVW	IGHV5-51	IGHJ6
TGTGCACGGATACCCCGATGGATATTACGATTTTTGGAGTGGTTATTATCTCAAACGGTTGACTACTGG	CARIPRWILRFLEWLLSQTVDYW	IGHV2-26	IGHJ4
TGTGCGAGAGATATCGTGGCTACGATTGCGGGCCTTAACTACTACTACTACATGGACGTCTGG	CARDIVATIAGLNYYYYMDVW	IGHV3-30	IGHJ6
TGTGCGAGAGGGGTTTACGATTTTTGGAGTGGTTATTATTACCCTCGAGAAGGGTACTACTACTACTACATGGACGTCTGG	CARGVYDFWSGYYYPREGYYYYYMDVW	IGHV5-51	IGHJ6
TGTCAGCTATGGTTCAGGGAGTTATTAAATTCCTTAGCCGATGACTACTACTACTACATGGACGTCTGG	CQLWFRELLNSLADDYYYYMDVW	IGHV7-4-1	IGHJ6
TGTGCGAAAGATCCCCCTGGGCCCCACCCGATCCCAGTCAACGGTGTGCTAGCCCCGTTTGAGGATGATATCTGG	CAKDPPGPHPIPVNGVLAPFEDDIW	IGHV3-23	IGHJ3
TGTGCGAGTGGAGGACTACGTGACTACTGG	CASGGLRDYW	IGHV4-59	IGHJ4
TGTACTAGAGTACCCCTTAAAAGGTGTAGTAGTACCAGCTGCTATGCCAAGCCCTTTGACTACTGG	CTRVPLKRCSSTSCYAKPFDYW	IGHV3-49	IGHJ4
TGTGCGAGTCGGTTTCTAGCAGTGGCTGGTACTATCTACTGG	CASRFLAVAGTIYW	IGHV3-21	IGHJ4
TGTGCGAGAGATGAACGGCCATACTATGGTTCAGGACGTAGAGCAGTGTACAACTGGTTCGACCCCTGG	CARDERPYYGSGRRAVYNWFDPW	IGHV4-59	IGHJ5
TGTGCGAGAGACCGGGTGACGGATGGAAATAATTCCGGGGATATAGCAGCTCGTCCGCCAACGCTAGAATACTACTACTACTACATGGACGTCTGG	CARDRVTDGNNSGDIAARPPTLEYYYYYMDVW	IGHV1-18	IGHJ6
TGTGCGAGAGAAACGCAGCAGCTGGTACCCAACTTTGACTACTGG	CARETQQLVPNFDYW	IGHV3-30	IGHJ4
TGTGCGAGATACTGGGCCCCAAGGTACGATTTTTGGAGTGGTTATTACTTCTACTGG	CARYWAPRYDFWSGYYFYW	IGHV1-46	IGHJ4
TGTGCGAGAGCCCCCAGATGTAGTGGTGGTAGCTGCTACTCCGTACTTTTCTGG	CARAPRCSGGSCYSVLFW	IGHV3-30	IGHJ5
TGTACCACAATCTCCCCGGGTACGATTTTTGGAGTGGTTATTATAAAGTATCTAGCTTTTGATATCTGG	CTTISPGTIFGVVIIKYLAFDIW	IGHV3-15	IGHJ3
