TGCTTAGACAAACAAATCGTATTACGATTTTTGGAGTGGGTAGTTGACTACTGG	CLDKQIVLRFLEWVVDYW	IGHV5-10-1	IGHJ4
TGTGCGAGAGGCTCCGGGGGCAGTGATACCAGCTGCTATGATCATCCAAGCCGGGACTACTGG	CARGSGGSDTSCYDHPSRDYW	IGHV4-34	IGHJ4
TGTGCGACCACCACCTTTAGCAGTGGCCTTTGTGGCCACAATCTTAAAAGAGGCTGGGCATTCCAGCACTGG	CATTTFSSGLCGHNLKRGWAFQHW	IGHV3-23	IGHJ1
TGTACGTTCCCGTATTGTAGTGGTGGTAGCTGCTACTCCGAAGGAGGCGGCTGGTTCGACCCCTGG	CTFPYCSGGSCYSEGGGWFDPW	IGHV3-49	IGHJ5
TGTGCGAACGACGATTTTTGGAGTGGTTATTCGCACTGGTTCGACCCCTGG	CANDDFWSGYSHWFDPW	IGHV3-23	IGHJ5
TGTACTAGACGGGCCAGTCGTATAGCAGCAGCTGGTACACTTTTTTATAGGACGCCTACCTCCCCTAGGAACTGGTTCGACCCCTGG	CTRRASRIAAAGTLFYRTPTSPRNWFDPW	IGHV3-73	IGHJ5
TGTGCGAGAGAATTCCATAGCAGTGGCTGGTACATCTATGGTGCTTTTGATATCTGG	CAREFHSSGWYIYGAFDIW	IGHV3-66	IGHJ3
TGTGCGAAACCCACGTATTACGATTTTTGGAGTGGTTATGCTGGTCTTCGCCTGGGAGGCTACTACTACTACTACATGGACGTCTGG	CAKPTYYDFWSGYAGLRLGGYYYYYMDVW	IGHV3-NL1	IGHJ6
TGTGCGAGATGGGTGACTGCTAGGGGCCGTACGAATAACTGGTTCGACCCCTGG	CARWVTARGRTNNWFDPW	IGHV3-21	IGHJ5
TGTGCAAGAGGAACTAGAGCAGCTCGTCTGTGGCGAGACTACTGG	CARGTRAARLWRDYW	IGHV3-13	IGHJ4
TGTGCCGTTTTCGATATTGTAGTGGTGGTAGCTGCTACGGGGACTGGGTCTTCCTTTGACTACTGG	CAVFDIVVVVAATGTGSSFDYW	IGHV4-34	IGHJ4
TGTGCGAGACCGGCTGGTACACTCTTAGGGTGCAGGTACTACTTTGACTACTGG	CARPAGTLLGCRYYFDYW	IGHV1-3	IGHJ4
TGTGCGAGAGACGGGTACCTAACAGTAGGATATTGTAGTAGTACCAGCTGCTACGTTGTACCATACTACTACTACTACTACATGGACGTCTGG	CARDGYLTVGYCSSTSCYVVPYYYYYYMDVW	IGHV4-4	IGHJ6
TGTGCACGGAGGATGTGTAGTGGTGGTAGCTGCCAACGCTACTACTACTACTACATGGACGTCTGG	CARRMCSGGSCQRYYYYYMDVW	IGHV2-26	IGHJ6
TGTGCGAGAAGCTTCTCCCCGATGGGTTATTGTACTGGTGGTGTATGCTCCTACTACTACTACTACATGGACGTCTGG	CARSFSPMGYCTGGVCSYYYYYMDVW	IGHV4-38-2	IGHJ6
TGTGCGAGGCTCGTAACCTTCTTTACGATTACATTTGGGGGAGTTATCGTCCACATGTACTACTACTACATGGACGTCTGG	CARLVTFFTITFGGVIVHMYYYYMDVW	IGHV3-21	IGHJ6
TGTGCGGGCGATTATGATTACATTTGGGGGAGTTATCGTTCGGCCTACTGG	CAGDYDYIWGSYRSAYW	IGHV3-30	IGHJ4
TGTGCGAGACATCGTTTACGATTTTTGGAGAACTACTACTACTACATGGACGTCTGG	CARHRLRFLENYYYYMDVW	IGHV5-51	IGHJ6
TGTGCGAAAGATCCGGCGCCTTGTGCAGGGAGTTATTATATGAAAAGTTCCCTGGCCCCGGTAGTTTACTACTACTACTACTACATGGACGTCTGG	CAKDPAPCAGSYYMKSSLAPVVYYYYYYMDVW	IGHV3-NL1	IGHJ6
TGTGCAAAAGATGGAAGTACTGGTGGTGTATCCCGAGCTTTTGATATCTGG	CAKDGSTGGVSRAFDIW	IGHV3-43	IGHJ3
TGTGCGAAAGTAGGGTGGCCGGGGAGGTTAAGGGACTGGTTCGACCCCTGG	CAKVGWPGRLRDWFDPW	IGHV3-NL1	IGHJ5
TGTGCAAAACCCGCTGTAGTGGTGGTAGCTGCTACCTCCATCCTTAACTTTGACTACTGG	CAKPAVVVVAATSILNFDYW	IGHV3-43	IGHJ4
TGTGCGAGACGAACGGGTGGGAATGATAGTAGTGGTTATTACGGCGTCGGGGCCAGCTACTGGTACTTCGATCTCTGG	CARRTGGNDSSGYYGVGASYWYFDLW	IGHV4-39	IGHJ2
TGTGCGAGCGGAGGGTATAGCAGCAGCTGGCCCAGTAGAGTTGACTACTGG	CASGGYSSSWPSRVDYW	IGHV3-11	IGHJ4
TGTGCGAGAAAAGAACGGAAGAACGCCCCTATTACTATGATAGTAGTGGTTATCCTTCTGCTTGAGGAGTTTGACTACTGG	CARKERKNAPITMIVVVILLLEEFDYW	IGHV5-10-1	IGHJ4
TGTACTAGAGACGGTCGGGAGTATAGCAGCTCGTCGCGTAAGGTTGAAGAGCCATCGTTTGACTACTGG	CTRDGREYSSSSRKVEEPSFDYW	IGHV3-49	IGHJ4
TGTGCGAGAGTAATCCCTATTGTAGTGGTGGTAGCTGCTACTCCGCCCCCGCTCGCCTTTGACTACTGG	CARVIPIVVVVAATPPPLAFDYW	IGHV1-3	IGHJ4
TGTGCGAGAGACCTACTTGGAGTGGTTATTCAGGATTATTACTACTACTACTACTACATGGACGTCTGG	CARDLLGVVIQDYYYYYYYMDVW	IGHV4-61	IGHJ6
TGTACCAATCAAGTAGCCGGTAAACCGGGGGGGTACAACTGGTTCGACCCCTGG	CTNQVAGKPGGYNWFDPW	IGHV3-15	IGHJ5
TGTGCGAGAGATTCCATGGTTCATAGACTTGACTACTACTACTACTACATGGACGTCTGG	CARDSMVHRLDYYYYYMDVW	IGHV1-3	IGHJ6
TGTGCAAGGGGCGGGCCCGGGTATAGCAGTGGCTGGACTTATTTTGACTACTGG	CARGGPGYSSGWTYFDYW	IGHV3-74	IGHJ4
TGTACCACAGATTCTCTAAGGATTATGATTACATTTGGGGGAGTTATCGACTACTACTACTACATGGACGTCTGG	CTTDSLRIMITFGGVIDYYYYMDVW	IGHV3-15	IGHJ6
TGTGTACCCGGTGCGGATCCGGTAGGATATTGTAGTAGTACCAGCTGCTATGCGGCCGGAGGACACTACTACTACTACATGGACGTCTGG	CVPGADPVGYCSSTSCYAAGGHYYYYMDVW	IGHV1-69	IGHJ6
TGTGCGAGTTTCCTCGGAACGTATTACGATTTTTGGAGTGGATACTACTACTACTACTACATGGACGTCTGG	CASFLGTYYDFWSGYYYYYYMDVW	IGHV3-21	IGHJ6
TGTGCGAGATGTATAACTACGGTGACTGTTCTCCCATACTACTACTACTACATGGACGTCTGG	CARCITTVTVLPYYYYYMDVW	IGHV4-61	IGHJ6
TGTGCAAAAGGAAGACCCGGGATTGTAGTGGTGGTAGCTGCAGGTTTTGCTTGGTACAACTGGTTCGACCCCTGG	CAKGRPGIVVVVAAGFAWYNWFDPW	IGHV3-43	IGHJ5
TGTGCGAGAGACAAGGGGGATATTGTAGTAGTACCAGCTGCGCCGTACAACTGGTTCGACCCCTGG	CARDKGDIVVVPAAPYNWFDPW	IGHV4-59	IGHJ5
TGTGCGAGAGAGAGACTATGTAGTGGTGGTAGCTGTGTTAACGTATTAAAGCGGAAGCGAGTGCTTTTTAATGCCTACTACTACTACTACATGGACGTCTGG	CARERLCSGGSCVNVLKRKRVLFNAYYYYYMDVW	IGHV4-59	IGHJ6
TGTGCAAAAGACCCGCAGATAGTGGGAGCTGACTACTGG	CAKDPQIVGADYW	IGHV3-43	IGHJ4
TGTGCGAAAGATTACCGACCGTGGCTACGATATACTGAGGGGAGGTGCACGAACTGGACTTGTCTTTGTGGTCACTTTGATGCTTTTGATATCTGG	CAKDYRPWLRYTEGRCTNWTCLCGHFDAFDIW	IGHV3-23	IGHJ3
TGTGCAAAAGGGGCTCCCCCTTATGATTACGTTTGGGGGAGTTATCGTTACTACTTTGACTACTGG	CAKGAPPYDYVWGSYRYYFDYW	IGHV3-43	IGHJ4
TGTGCGAAAGGGGTGCCGCATATAGTGGCTACGATTTCGACGTGGTACAACTGGTTCGACCCCTGG	CAKGVPHIVATISTWYNWFDPW	IGHV3-23	IGHJ5
TGTGCAAGAGTCCGCAGTGGCTGGTCGAGTCGGGTTAGCTTTGACTACTGG	CARVRSGWSSRVSFDYW	IGHV3-13	IGHJ4
TGTGCGAAAGATCGCAAGGACTACGGTGACTACTTGCCGGGGGGGGACTACTACTACATGGACGTCTGG	CAKDRKDYGDYLPGGDYYYMDVW	IGHV3-NL1	IGHJ6
TGTGCGAAAGATAAAATCCCATGGGGGAGTTATCGAGTTTGGGGGCATCAGTGCCACTACTTTGACTACTGG	CAKDKIPWGSYRVWGHQCHYFDYW	IGHV3-23	IGHJ4
TGTACGCTTGTAACAGGGGATATTGTAGTAGTACCAGCTGCTATGTATCTACGACCCTACTGG	CTLVTGDIVVVPAAMYLRPYW	IGHV3-49	IGHJ4
TGTACTAGAGCTGTTATTAGTACCAGCTGCTATCCGTCGCTACCTAACTACTTTGACTACTGG	CTRAVISTSCYPSLPNYFDYW	IGHV3-49	IGHJ4
TGTACTAGCCTGGAGGGGCTGCCAGGCCCTTCAGCTACGTGCCCCGACCGTTGGCAGAATCGGCGCTTGTGTGACGGGTGGAGACACTTTGACTACTGG	CTSLEGLPGPSATCPDRWQNRRLCDGWRHFDYW	IGHV3-49	IGHJ4
TGTGCGAGAGATTGGGTCCACGAACGATTACGATTTTTGGAGTGGTTACAGATCTGTAGTCGGGAAACCCGGAACATATCGGGCGCTTTTGATATCTGG	CARDWVHERLRFLEWLQICSRETRNISGAFDIW	IGHV3-7	IGHJ3
TGTGCGAGAGTAACCGGTCCGGTTGGGGTAGTAGTACCAGCTGCTATGCCGGCCGACTACTACTACTACATGGACGTCTGG	CARVTGPVGVVVPAAMPADYYYYMDVW	IGHV4-34	IGHJ6
TGTGCGAAAGCGACGATTTTTGGAGTGGTTATTATTAAGGAACTTGGTCTCGACATGGACGTCTGG	CAKATIFGVVIIKELGLDMDVW	IGHV3-NL1	IGHJ6
TGTGCGAGAACAGACTACGGTGTCACATACAACTGGTTCGACCCCTGG	CARTDYGVTYNWFDPW	IGHV5-10-1	IGHJ5
TGTACCACGCCGGGACAGCAGCTGGTTGTCGAGTGG	CTTPGQQLVVEW	IGHV3-15	IGHJ4
TGTGCGAGTCGACATTACTATGATAGTAGTGGTTATTACACGTTCTATGACTACTGG	CASRHYYDSSGYYTFYDYW	IGHV4-39	IGHJ4
TGTGCACGGATGAAGGGGTATGGTTCAGGGAGTTATTATCGGGACTGGCTTCGCTGG	CARMKGYGSGSYYRDWLRW	IGHV2-26	IGHJ5
TGTGCGAGACCCCCTACGGTGACACCCGATGCTTTTGATATCTGG	CARPPTVTPDAFDIW	IGHV4-39	IGHJ3
TGTACCACATTAGCGTACCAGCTGCTATTCGTCGGACACTACTACTACTACTACATGGACGTCTGG	CTTLAYQLLFVGHYYYYYMDVW	IGHV3-15	IGHJ6
TGTGCGAAATGGGTTTACGATTTTTGGAGTGGTTATTATCGAAATGTGGCCTACTACTACATGGACGTCTGG	CAKWVYDFWSGYYRNVAYYYMDVW	IGHV3-NL1	IGHJ6
TGTGCGAAACGGAGGACGATTTTTGGAGTGGTTATTATTATGGCAGGTCACTGGTACTTCGATCTCTGG	CAKRRTIFGVVIIMAGHWYFDLW	IGHV3-23	IGHJ2
TGTGCGAGAGATGGCCCTCCGTATTACGATTTTTGGAGTGGTTATTATCGAGTTATTTTCTACTACTACTACTACATGGACGTCTGG	CARDGPPYYDFWSGYYRVIFYYYYYMDVW	IGHV3-53	IGHJ6
TGTGCACACACACTGGGAACGCAGTCCACGTATTACTATGGTTCAGGGAGCCGCCATCACTCGTCTTGGTACTACTTTGACTACTGG	CAHTLGTQSTYYYGSGSRHHSSWYYFDYW	IGHV2-5	IGHJ4
TGTGCGAGAGAGGGGTCCTACAGTAACTACGTCGGTGACTACTTTGACTACTGG	CAREGSYSNYVGDYFDYW	IGHV3-7	IGHJ4
TGTGCGAGAGCGGGGTCACGTATTACTATGATAGTAGTGGTTATTACTATCTCCTTTGACTACTGG	CARAGSRITMIVVVITISFDYW	IGHV1-69	IGHJ4
TGTGCGAGAGATCTTCGGGGCCGGGGGTGGGAGCTACGCGAAGATGCTTTTGATATCTGG	CARDLRGRGWELREDAFDIW	IGHV3-20	IGHJ3
TGTGCGAAAGATCGGTTCCCGTATTACTATGGTTCAGGGCGCTCCCTCTGTGATGCTTTTGATATCTGG	CAKDRFPYYYGSGRSLCDAFDIW	IGHV3-NL1	IGHJ3
TGTGCGAGAAGCGGTAGTAGTTACTATGATAGTAGTGGTGCCTCCGACTACTTTGACTACTGG	CARSGSSYYDSSGASDYFDYW	IGHV4-34	IGHJ4
TGTGCGAGAGGGAGCCCTATAGCAGTGGCTGCGCGCACGTCTGACTACTGG	CARGSPIAVAARTSDYW	IGHV1-18	IGHJ4
TGTACTAGACTTGATATTGTACTGGTGGTGTATGCTGGAGCTAGTCAGGGGCATTACTACTACTACTACTACATGGACGTCTGG	CTRLDIVLVVYAGASQGHYYYYYYMDVW	IGHV3-73	IGHJ6
TGTGCGAGAAGGGAGTTGGTAACTCCGGATCCTTTGGGGTGCGACCCCTGG	CARRELVTPDPLGCDPW	IGHV1-69	IGHJ5
TGTGCGAAATCCATCGTATTACGATTTTTGGAGTGGTTATTCCCCCAGCGCGTACCTCACTTTGACTACTGG	CAKSIVLRFLEWLFPQRVPHFDYW	IGHV3-23	IGHJ4
TGTACCACAGATGTTTACTATGGTTCAGGGACTATTCTAGGCTACTACTACATGGACGTCTGG	CTTDVYYGSGTILGYYYMDVW	IGHV3-15	IGHJ6
TGTGCGAGACGAGTACATATTGTAGTAGTACCAGCTGCTCACTACTACTACTACTACATGGACGTCTGG	CARRVHIVVVPAAHYYYYYMDVW	IGHV5-51	IGHJ6
TGTGCAAAAGATACCGATTACGATTTTTGGAGTGGTTCCATCCGCGGCTGG	CAKDTDYDFWSGSIRGW	IGHV3-43	IGHJ4
TGTGCGAGACCTCTGGGGTTACTATGGTTCAGGGAGTTAGTGCATCTCCCGCGTTTGTTCGACCCCTGG	CARPLGLLWFRELVHLPRLFDPW	IGHV5-10-1	IGHJ5
TGTGCGAGAGATGGGCCCCCCGCGCAGTGGCTGGTACAGTCCCATACTTCATCGTACTACTTTGACTACTGG	CARDGPPAQWLVQSHTSSYYFDYW	IGHV1-3	IGHJ4
TGTGCGAGAGATGGCCTGGCGTCTAGTACCAGCTGCTATGGGGTGCGGGGGCGGTTAAAAAACTACTACTACTACATGGACGTCTGG	CARDGLASSTSCYGVRGRLKNYYYYMDVW	IGHV3-30	IGHJ6
TGTGCGGGATATTGTAGTAGTACCAGCTGCTTTCGTGCGGCGAGGGACTACTTTGACTACTGG	CAGYCSSTSCFRAARDYFDYW	IGHV3-20	IGHJ4
TGTGCGAGCGTGCACGGTAGTGGTGGTAGCTGCTACTTGTACTACTACTACTACATGGACGTCTGG	CASVHGSGGSCYLYYYYYMDVW	IGHV3-21	IGHJ6
TGTGCGAGTGAGATGGCTACAGAAAACTTTGACTACTGG	CASEMATENFDYW	IGHV3-53	IGHJ4
TGTGCAAAAGATCTATTAATTGTAGTAGTACCAGCACACTATCTTCCCCGCCTCGGCTACGGGGTACGCTACTACTACTACTACATGGACGTCTGG	CAKDLLIVVVPAHYLPRLGYGVRYYYYYMDVW	IGHV3-43D	IGHJ6
TGTGCAAGAAGTTCCCTTACGATTTTTGGAGTGGTTATTACGCCCCGACCTCCCTGGATTGACTACTGG	CARSSLTIFGVVITPRPPWIDYW	IGHV6-1	IGHJ4
TGTGCGAAAGAGGCTGAATATTGTAGTGGTGGTAGCTGCTACTGGGAATCGTCGGGGGATGCTTTTGATATCTGG	CAKEAEYCSGGSCYWESSGDAFDIW	IGHV3-NL1	IGHJ3
TGTGCGAGACAGTTGAGTATTGTAGTGGTGGTAGCTGCTACTCGGGCCGGAACAAACAGGGATGATGCTTTTGATATCTGG	CARQLSIVVVVAATRAGTNRDDAFDIW	IGHV1-46	IGHJ3
TGTGCAAGAGATGGCAAGGGAGATTGTAGTGGTGGTAGCTGCTACTTTCTGTCTGACTACTGG	CARDGKGDCSGGSCYFLSDYW	IGHV3-74	IGHJ4
TGTGCGAACAGCCATCGGACAGTCGGGGCCGTCAAGATTTTTGGAGTGGTTATATCTGACTTTGACTACTGG	CANSHRTVGAVKIFGVVISDFDYW	IGHV3-23	IGHJ4
TGTGCGAAACGGTATATTACGATTTTTGGAGTGGTTATTGAACACCCGAGACGAGGGAATTACTACTACTACTACTACATGGACGTCTGG	CAKRYITIFGVVIEHPRRGNYYYYYYMDVW	IGHV3-23	IGHJ6
TGTGCGAAGCCTTCTGTCTCATTCAGACGACCTGACTACTGG	CAKPSVSFRRPDYW	IGHV3-23	IGHJ4
TGTAAAAGGAGGCTCGATTTTTGGAGTGGTTATTATACCCGAGGGGACTACTACTACTACATGGACGTCTGG	CKRRLDFWSGYYTRGDYYYYMDVW	IGHV3-15	IGHJ6
TGTGCTAGAGCTTGCCGGAGTATTACGATTTTTGGAGTAGCATTACAGTCCCGTGACTACTGG	CARACRSITIFGVALQSRDYW	IGHV3-72	IGHJ4
TGTGCAAGAGATGGGGATAGGAGTAATATTGTAGTAGTACCAGCTGCTCTGGGGCATATGTCCTACTGG	CARDGDRSNIVVVPAALGHMSYW	IGHV3-74	IGHJ4
TGTGCGAAATCTGAGCAGCTCGGCCCATTTGACTACTGG	CAKSEQLGPFDYW	IGHV3-23	IGHJ4
TGTGCGAGTTTTGGATATTGTAGTAGTACCAGCTGCTATGAAGTCAGTACCCACCATTACTACTACTACTACATGGACGTCTGG	CASFGYCSSTSCYEVSTHHYYYYYMDVW	IGHV5-51	IGHJ6
TGTGCGAGAGGACCGTCTGCTGGTAATTGTAGTAGTACCAGCTGCTATGTGAAACTATATACACCCCCAGGTACCCTCTACTACTACTACTACATGGACGTCTGG	CARGPSAGNCSSTSCYVKLYTPPGTLYYYYYMDVW	IGHV1-69	IGHJ6
TGTGCGAGAGCGTACCGAATAGCAGTAAAGGGAGCCGACTACTGG	CARAYRIAVKGADYW	IGHV4-38-2	IGHJ4
TGTGCGAGATTTCACGGCCCGGTTCAGGGATCGTACTACTACTACTACTACATGGACGTCTGG	CARFHGPVQGSYYYYYYMDVW	IGHV1-3	IGHJ6
TGTGCGAGACTATTTCTCGGGCCTAATGGGTATTGTAGTAGTACCAGCTGCTATGCCAGGTACTACTACTACATGGACGTCTGG	CARLFLGPNGYCSSTSCYARYYYYMDVW	IGHV4-38-2	IGHJ6
TGTGCGAGCGCTTATAGGAGGTCCTCCTGCGAGTATAGCAGCTCGGTCGACTACTGG	CASAYRRSSCEYSSSVDYW	IGHV4-34	IGHJ4
TGTGCGAAAGCCCGGTGTTGGTATAGCAGTGGCTGGTACGTGGACCTCGGGGAGAGCAGAAGGTTTGACTACTGG	CAKARCWYSSGWYVDLGESRRFDYW	IGHV3-NL1	IGHJ4
TGTGCAAGAGATCTAAATACTGTTGTAGTGGTGGTAGCTGCTACTCACGGACTAACCGACTACTGG	CARDLNTVVVVVAATHGLTDYW	IGHV3-74	IGHJ4
TGTGCGAAAGCCGGGTATAGCAGTGGCTGGATACTAAACTACTGG	CAKAGYSSGWILNYW	IGHV3-23	IGHJ4
