TGTGCACACGCGGGGACCCAGTTAAGGTTATGG	CAHAGTQLRLW	IGHV2-5	IGHJ4
TGTGCCCCTACCGTTATACTTAGAGCCCGGGCTCTGGATATTGTACTGGTGGTGTATGCCTCTATTACTGTGTGGTTCGACCCCTGG	CAPTVILRARALDIVLVVYASITVWFDPW	IGHV3-30	IGHJ5
TGTGCGACGTCACGTATTACTATGATAGTAGTGGTTATAGGACATAAGTCGGTTGACTACTGG	CATSRITMIVVVIGHKSVDYW	IGHV3-NL1	IGHJ4
TGTGCGAGAGGGGAGGTGGTAGCTGCTCCCCCCCTATACTTTGACTACTGG	CARGEVVAAPPLYFDYW	IGHV3-48	IGHJ4
TGTGCGAAAGATAAACCTACGGTGACTACTTTGAGCGGAAACTACTTTGACTACTGG	CAKDKPTVTTLSGNYFDYW	IGHV3-NL1	IGHJ4
TGTGCGAGAGAGAACGGGGGAATAGCAGCGAAGACTTCCCCCAACTGGTTCGACCCCTGG	CARENGGIAAKTSPNWFDPW	IGHV3-7	IGHJ5
TGTGCGAGAGATGGGTATTGTAGTGGTGGTAGCCCTTGGTTCGACCCCTGG	CARDGYCSGGSPWFDPW	IGHV3-7	IGHJ5
TGTGCGAGAGTATTGGGAATTACTATGATAGTAGTGGTTATTACGGACTGGTTCGACCCCTGG	CARVLGITMIVVVITDWFDPW	IGHV7-4-1	IGHJ5
TGTACCACAGGTGACGAGGGGGGGCAGCAGCTGGTATCAGGGCGCGAGAACTGG	CTTGDEGGQQLVSGRENW	IGHV3-15	IGHJ4
TGTGCGAGAGATTCTCATCTAAACAGGATCCTTCCAATTGACTACTGG	CARDSHLNRILPIDYW	IGHV1-2	IGHJ4
TGTGCGAGACGCTATGGTTCAGGGAGTTATTGGGTGACCGACTACTGG	CARRYGSGSYWVTDYW	IGHV4-39	IGHJ4
TGTGCCTACGATATTGTAGTGGTGGTAGCTGCTAGCGATGCTTTTGATATCTGG	CAYDIVVVVAASDAFDIW	IGHV1-46	IGHJ3
TGTGCGGGTTACATTCCTGACTACTGG	CAGYIPDYW	IGHV3-66	IGHJ4
TGTGCGAGAGTTACCCAGGAGGCAGCAGCTGGTACAAAGTACTACTTTGACTACTGG	CARVTQEAAAGTKYYFDYW	IGHV3-53	IGHJ4
TGTGCGAGGCTCAAGAACTCTCGCTTCGCAAAGAAACTTGACTACTGG	CARLKNSRFAKKLDYW	IGHV1-18	IGHJ4
TGTGCGAGAGATCGGGGCTGTATTACTATGGTTCAGGGAGTTATTAGGGGGTCCTTTGACTACTGG	CARDRGCITMVQGVIRGSFDYW	IGHV3-48	IGHJ4
TGTGCGAGAGAGCCAGCAGTGGCTGGTAAGCCGCTTCGGTTTGACTACTGG	CAREPAVAGKPLRFDYW	IGHV3-21	IGHJ4
TGTGCCACCTCCTTTTCTGGATGGCTACAATTGATCCGGGAGAGCAAGTTAGGCAGAAACTACTTTGACTACTGG	CATSFSGWLQLIRESKLGRNYFDYW	IGHV3-74	IGHJ4
TGTGCGAGAGGGATAAAACTAGACTATTTGTTGACTACGGTGACTACCCATGGACGAAAAAACTTTGACTACTGG	CARGIKLDYLLTTVTTHGRKNFDYW	IGHV4-38-2	IGHJ4
TGTGCGAGGCTTATTACTATGATAGTAGTGGTTATTACTTTCTTTGACTACTGG	CARLITMIVVVITFFDYW	IGHV1-69	IGHJ4
TGTGCGAGAGCCTGGGTGTGGGCGTACCAGCTGCCCGCCTACTACTACTACATGGACGTCTGG	CARAWVWAYQLPAYYYYMDVW	IGHV1-18	IGHJ6
TGTGCGAGAGTAGGATATTGTAGTGGTGGTAGCTGCTACGGCTCCGCATTTAGCTGGTTCGACCCCTGG	CARVGYCSGGSCYGSAFSWFDPW	IGHV3-20	IGHJ5
TGTGCGAAAACGGCTAGGATATTGTACTGGTGGTGTATGCTATCCCACTACTACTACTACATGGACGTCTGG	CAKTARILYWWCMLSHYYYYMDVW	IGHV3-NL1	IGHJ6
TGTGCGAGATTAGCCTTGGTAGTGGTGGTAGCTGCTACTCCGTACTACTACTACTACTACATGGACGTCTGG	CARLALVVVVAATPYYYYYYMDVW	IGHV3-7	IGHJ6
TGTGCGAGAGATGGGGTTGACTACGGTGACTACGTAATTCCGGCGTACTACTTTGACTACTGG	CARDGVDYGDYVIPAYYFDYW	IGHV3-7	IGHJ4
TGTGCGAGAGATCAGCGGTCAGGTATTGTAGTGGTGGTAGCTGAAAGCCCGGACGATTTCAAAAAAGCCTTTGACTACTGG	CARDQRSGIVVVVAESPDDFKKAFDYW	IGHV3-11	IGHJ4
TGTGCGAGGCGTTCCCCCCGAATTATTGTAGTGGTGGTAGCTGCTACTCGGGGGTACTACTTTGACTACTGG	CARRSPRIIVVVVAATRGYYFDYW	IGHV1-46	IGHJ4
TGCCTGAGACAGGATATTGTAGTAGTACCAGCTGAAAACTGGTTCGACCCCTGG	CLRQDIVVVPAENWFDPW	IGHV1-18	IGHJ5
TGTACCACGGAGGTGCCTATGGTTCAGGGACTTCCTGATGCTTTTGATATCTGG	CTTEVPMVQGLPDAFDIW	IGHV3-15	IGHJ3
TGTGCGAGAGAGCAGCTGGCCACACCACGGGCGTGCTACTGG	CAREQLATPRACYW	IGHV3-53	IGHJ4
TGTGCACACAGACGGGTTACCTATGACGGGGCAACCTTTGACTACTGG	CAHRRVTYDGATFDYW	IGHV2-5	IGHJ4
TGTGCGAGACATCGGTTTATGATAGTAGTGGTTATTACGAACTACTGG	CARHRFMIVVVITNYW	IGHV4-39	IGHJ4
TGTGCACGGATACGTCCTTATCGGCCCTATAGGGAGGACGGCTACTACTACTACTACTACATGGACGTCTGG	CARIRPYRPYREDGYYYYYYMDVW	IGHV2-70	IGHJ6
TGTGCGAAATGGGGTCTTCGACTTACGATTTTTGGAGTGGTTATTCATTACTACTACTACTACTACATGGACGTCTGG	CAKWGLRLTIFGVVIHYYYYYYMDVW	IGHV3-NL1	IGHJ6
TGTGCGAAAGGATGGAAGGAGGTTACGATTTTTGGAGTGGTTATTATGGGTATAACGAATCACAGATTAAACCCGAAATTTGACTACTGG	CAKGWKEVTIFGVVIMGITNHRLNPKFDYW	IGHV3-NL1	IGHJ4
TGTACTAGTTTAATCCCGACTGGAACTACGCGCGTAGGGGAGTACTGG	CTSLIPTGTTRVGEYW	IGHV3-73	IGHJ4
TGTGCGCCCACAGGCGGCTGGTACATTGGGGACTACTGG	CAPTGGWYIGDYW	IGHV3-66	IGHJ4
TGTGCGAGAGGGGTTACTCAGGGTTACTATGATAGTACGCGCCCGGGGGACGGCTACTTTGACTACTGG	CARGVTQGYYDSTRPGDGYFDYW	IGHV1-2	IGHJ4
TGTGCGAGAGGGGGGCCGGATATAGTGGCTACGATTGGATCCGAACTCGGATACTGG	CARGGPDIVATIGSELGYW	IGHV1-2	IGHJ4
TGTGCGAGACTGCGTATTACGATTTTTGGAGTGGTTATAGATGCTCAATACTACTACTACTACATGGACGTCTGG	CARLRITIFGVVIDAQYYYYYMDVW	IGHV3-48	IGHJ6
TGTGCGAAAGATGTAAGAATGATTACATTTGGGGGAGTTATCGTTCACTTGGACCACCAGTACTACTTTGACTACTGG	CAKDVRMITFGGVIVHLDHQYYFDYW	IGHV3-NL1	IGHJ4
TGTGCGAGAATGCAACGTAGTAGTACCAGCTGCTATCCCAGATGGTTCGACCCCTGG	CARMQRSSTSCYPRWFDPW	IGHV5-51	IGHJ5
TGTGCGAGAGATGGGCCCCCCCAGATAAAGCTCTTTGACTACTGG	CARDGPPQIKLFDYW	IGHV1-69	IGHJ4
TGTGCGAGAGGAAGTGGAACGGGTATGATTACGTTTGGGGGAGTTATCGTTGTGTTATACGACTACTGG	CARGSGTGMITFGGVIVVLYDYW	IGHV7-4-1	IGHJ4
TGTGCGAGAGATGGTGGACTATGGTTCAGGGAGTTATTTTACAACCCTGACTACTGG	CARDGGLWFRELFYNPDYW	IGHV3-21	IGHJ4
TGTGCGAAAGACCCCAGTGGGATAGTAGTGGTTATGAAGCGACAGGGGGGTCGGATGTCCTCTTTTGATATCTGG	CAKDPSGIVVVMKRQGGRMSSFDIW	IGHV3-23	IGHJ3
TGTGCGAGAACCGATAAGGGAAATTTTATGACACCTTTGAGAAGACGTGGCTGGTACGAATGCGACTACTGG	CARTDKGNFMTPLRRRGWYECDYW	IGHV4-38-2	IGHJ4
TGTGCGAGAGAGTCGCGAATAAATAGCAGTGGCTCTGATGCTTTTGATATCTGG	CARESRINSSGSDAFDIW	IGHV1-2	IGHJ3
TGTGCGGATAAGTCCACGTCGTACCAGCTGCCGTGGGATCCGACCTGG	CADKSTSYQLPWDPTW	IGHV1-46	IGHJ5
TGTGCGAGGAAAGTTGATCTCTATATAGCAGCAGCTGGTACAGCGTTTCCCTATGATCTATTTAACTTTGACTACTGG	CARKVDLYIAAAGTAFPYDLFNFDYW	IGHV4-34	IGHJ4
TGTGCAAGAGATCTGACTCGGGGCGGGCGATTTTTGGAGTGGTTATTACTCGTAGGTCAGAATACCACGCCCCGGGATGCTTTTGATATCTGG	CARDLTRGGRFLEWLLLVGQNTTPRDAFDIW	IGHV3-13	IGHJ3
TGTGCGAGAGATAACGGAAGGGGGGAGTTATCGTTCTACTACTACTACTACTACATGGACGTCTGG	CARDNGRGELSFYYYYYYMDVW	IGHV3-11	IGHJ6
TGTGCGAGACGCACGTATTATGATTACATTTGGGGGAGTTATCGTTCAAGATGG	CARRTYYDYIWGSYRSRW	IGHV7-4-1	IGHJ4
TGTGCGAACTCTATGGGGACGGGCATACTATGGTTCAGGGAGGGTCTTACCCCCTACTACTACTACATGGACGTCTGG	CANSMGTGILWFREGLTPYYYYMDVW	IGHV3-23	IGHJ6
TGTGCGAGAGATAATAAATACCTACAGCAGCAGCTGGTAAGGAACTTTGACTACTGG	CARDNKYLQQQLVRNFDYW	IGHV1-69	IGHJ4
TGTGCGAGAGCTTGTAGTGGTGGTAGCTGCTACTCTTTCTGGCCCCCCTACGAACCGGCCTACTACTACTACTACATGGACGTCTGG	CARACSGGSCYSFWPPYEPAYYYYYMDVW	IGHV3-11	IGHJ6
TGTGCGAGACATTGGACCCGTAGTAGTACCAGCTGCTATGCCGGGCGTAACTACTACTACTACTACATGGACGTCTGG	CARHWTRSSTSCYAGRNYYYYYMDVW	IGHV4-39	IGHJ6
TGTGCGAGACATATTGTAGTGGTGGTAGCTGCTACTTCGGATTACTTTGACTACTGG	CARHIVVVVAATSDYFDYW	IGHV1-69	IGHJ4
TGTGCGAAAGATTGCCGTGGGGTGGATATTGTAGTGGTGGTAGCTGCTACTCTAGCGGTCTGG	CAKDCRGVDIVVVVAATLAVW	IGHV3-23	IGHJ4
TGTGCGGGGTGTGCGTGTAGAACTTGTAGTGGTGGTAGCTGCTACAAATACTACTACTACTACTACTACATGGACGTCTGG	CAGCACRTCSGGSCYKYYYYYYYMDVW	IGHV1-46	IGHJ6
TGTGCAAGAAGGCACCCGTACTACTTTGACTACTGG	CARRHPYYFDYW	IGHV3-13	IGHJ4
TGTGCGAGACATGAGGGCGAGGTACGTATTACGATTTTTGGAGTGGTTATTATTGAAGAATCGATGCGCCACCTACTCCTAAGCTGGTTCGACCCCTGG	CARHEGEVRITIFGVVIIEESMRHLLLSWFDPW	IGHV5-51	IGHJ5
TGTGCGAAAGAGTTACCGTATTGTAGTAGTACCAGCTGCTATGACTCCGAAAAATACTACTACTACTACATGGACGTCTGG	CAKELPYCSSTSCYDSEKYYYYYMDVW	IGHV3-NL1	IGHJ6
TGTGCGAACTATGCCCGAATTTGTAGTGGTGGTAGCTGCTACTCCATCCACTACTACTACTACATGGACGTCTGG	CANYARICSGGSCYSIHYYYYMDVW	IGHV3-NL1	IGHJ6
TGTGCGAGATACTTTTTTTGGAGTGGTTATTGCCCTAGCTACTACTTTGACTACTGG	CARYFFWSGYCPSYYFDYW	IGHV7-4-1	IGHJ4
TGTGCGAGTGGGCGGTGCATATTAGGGGTTCGGGGAGGCGGATATGATGCTTTTGATATCTGG	CASGRCILGVRGGGYDAFDIW	IGHV3-21	IGHJ3
TGTGCGAGAGATGGTTCGGCGATTTTTGGAGTGGTTATCGGTGTTCCCCTGGGGGCCAACTGGTTCGACCCCTGG	CARDGSAIFGVVIGVPLGANWFDPW	IGHV3-11	IGHJ5
TGTGCGAAACCGAATCGGGATTACTATGATAGTAGTGGTTATTATTCTGCGGGATTGAGCCAGACAACCCGTAGAATCGCTTTTGATATCTGG	CAKPNRDYYDSSGYYSAGLSQTTRRIAFDIW	IGHV3-23	IGHJ3
TGTGCGAAAGACGAAGTGCGGGTGTACTGGTGGTGTATGAAGAGCTTTGACTACTGG	CAKDEVRVYWWCMKSFDYW	IGHV3-NL1	IGHJ4
TGTGCACGGAGCGAAGGATATAGTGGCTACGATTGGGCAATCTGGGATGACTACTGG	CARSEGYSGYDWAIWDDYW	IGHV2-26	IGHJ4
TGTGCGAAAGATCAGATAACGGAGTATAACTGGAACCTGGGGTACTACTTTGACTACTGG	CAKDQITEYNWNLGYYFDYW	IGHV3-NL1	IGHJ4
TGTGCGAGAGGGGGGTATTACTATGGTTCGGGGACCTGGTTCGACCCCTGG	CARGGYYYGSGTWFDPW	IGHV4-59	IGHJ5
TGTGCGAGACGCAGGAACACTAAGCAGTGGCTGGGCGGCATGGACGTCTGG	CARRRNTKQWLGGMDVW	IGHV7-4-1	IGHJ6
TGTGCACGGATAATAGCTCCCACCGAGGGATTTTATACGATTTTTGGTATCATTCTCTACTGG	CARIIAPTEGFYTIFGIILYW	IGHV2-26	IGHJ4
TGTGCGAGAGGTTTCCTTAACGGTGACTACGTTGGCTACTTTGACTACTGG	CARGFLNGDYVGYFDYW	IGHV1-18	IGHJ4
TGTGCGAGAGGCAGCGGCTGGGGCGAGTGGGAGCTACGAGGCTTTGACTACTGG	CARGSGWGEWELRGFDYW	IGHV4-34	IGHJ4
TGTGCGAGTGATGAGAATGACTACGGTGACCCGGTGGGAGTTGACTACTGG	CASDENDYGDPVGVDYW	IGHV1-3	IGHJ4
TGTGCGAAAAGTTTCCCCAGCCTGGTCATTGTAGTGGTGGTAGCTGCTACTCTTCCACCCTTTGACTACTGG	CAKSFPSLVIVVVVAATLPPFDYW	IGHV3-23	IGHJ4
TGTGCAAAAGATATGCCGATTAAGGGGAATCATTTAATAGCAGCTCGGGGCTACTACTACTACTACATGGACGTCTGG	CAKDMPIKGNHLIAARGYYYYYMDVW	IGHV3-43	IGHJ6
TGTGCAAAAGATAAGGGATTTTTGGAGTGGTTATTATCCCTGATTGACTACTGG	CAKDKGFLEWLLSLIDYW	IGHV3-43	IGHJ4
TGTGCGAGAGTGACTACGGTGACTCCCTACTGG	CARVTTVTPYW	IGHV1-3	IGHJ4
TGTACCACAGATTCCCGCGGGTTTGGTGGTGATAGATTCCAAGATATTACACGGTACTGGTTCGACCCCTGG	CTTDSRGFGGDRFQDITRYWFDPW	IGHV3-15	IGHJ5
TGTGCGAAAGTAAAGAGTCTCTACTACTACATGGACGTCTGG	CAKVKSLYYYMDVW	IGHV3-23	IGHJ6
TGTGCGAGGCATGAAATAGTAGTGGTTATTACTACGCACGATGATGCTTTTGATATCTGG	CARHEIVVVITTHDDAFDIW	IGHV1-3	IGHJ3
TGTGCGAGTTATATACTATGG	CASYILW	IGHV1-2	IGHJ5
TGTGCGAGAGATCCTACGGTGACTACGAGTCGGAGGTCCACCAGCTACTACTTTGACTACTGG	CARDPTVTTSRRSTSYYFDYW	IGHV3-53	IGHJ4
TGTGCGAGAGGCCGGGATATTGTAGTGGTGGTAGCTGCTACCCCATCCGAGCCCGACTACTGG	CARGRDIVVVVAATPSEPDYW	IGHV1-18	IGHJ4
TGTGCGAGAGCTTACCATACCGGTTCAGGGAGTGAGTTTGACTACTGG	CARAYHTGSGSEFDYW	IGHV3-7	IGHJ4
TGTGCGAAGGGGTGTTTACGATTTTTGGAGTGGTTATTAGTGAGATTAGACTACTGG	CAKGCLRFLEWLLVRLDYW	IGHV3-23	IGHJ4
TGTGCGAGACGGGTCGATAGTGGCTACGATGCCCACTACTTTGACTACTGG	CARRVDSGYDAHYFDYW	IGHV5-51	IGHJ4
TGTGCGAGCCCCGGGTATAGCAGTGGCTGGTACGGGCCTGCTTTTGACTACTGG	CASPGYSSGWYGPAFDYW	IGHV4-61	IGHJ4
TGTGCGAGAATAAGAACAGTGGCTGGAGAAACTGAACGCTACTACTACTACTACATGGACGTCTGG	CARIRTVAGETERYYYYYMDVW	IGHV5-10-1	IGHJ6
TGTGCGAGTGGGTGGGGCATTACCGCCCTGACTACGGTGACTACGGGGGTAACTTACTACTACTACTACTACATGGACGTCTGG	CASGWGITALTTVTTGVTYYYYYYMDVW	IGHV1-46	IGHJ6
TGTGCGAGACATGGTTCCTATTACGAAGTTGTAGTGGTGGTAGCTGCTCCCTCCTTTGACTACTGG	CARHGSYYEVVVVVAAPSFDYW	IGHV5-51	IGHJ4
TGTGCTTGGCCTTTACTGGCAAACGGGTTTTACTACTTTGACTACTGG	CAWPLLANGFYYFDYW	IGHV7-4-1	IGHJ4
TGTGCGAGACATCGAGGCGGTAGTAGTACCAGCTGCTCTTTTCCCCTGACCTTTGACTGGTTCGACCCCTGG	CARHRGGSSTSCSFPLTFDWFDPW	IGHV4-39	IGHJ5
TGTGCGAGAGATCGTCTAACCGTTGAGTGGTACCAGCTGCTAAAAACCGGGGGGCACTACTACTACTACTACATGGACGTCTGG	CARDRLTVEWYQLLKTGGHYYYYYMDVW	IGHV3-21	IGHJ6
TGTACCACAGGGACATTTGGGGGAGTTATCGCTCGAACAGCTTACTACTACTACTACTACATGGACGTCTGG	CTTGTFGGVIARTAYYYYYYMDVW	IGHV3-15	IGHJ6
TGTGCAAGAGAGACCCTCGAATACATTTGGGGGAGTTATCGGCGGTCCTCGAGCCTTGACTACTGG	CARETLEYIWGSYRRSSSLDYW	IGHV3-74	IGHJ4
TGTGCAAGAGATAGTATTACTATGATAGTAGTGGTTATGCCATTCTACCCCACGGCACGGCCCTTTGACTACTGG	CARDSITMIVVVMPFYPTARPFDYW	IGHV3-13	IGHJ4
