TGTGCGAGACAGAATATTGTGAACAGTATAGCAGCAGCTGTCGACCCCTGG	CARQNIVNSIAAAVDPW	IGHV3-7	IGHJ5
TGTACCACAGATCGGCCGTATTATGATTACATTTGGGGGAGTTATCGCCCGCCTCGCTTTGACTACTGG	CTTDRPYYDYIWGSYRPPRFDYW	IGHV3-15	IGHJ4
TGTGCGGGATCCATCGGGAACTGGAACGACGCCGACGACTTTGACTACTGG	CAGSIGNWNDADDFDYW	IGHV3-53	IGHJ4
TGTGCGAGAGTTGGGTATTACTATGATAGTAGTGGTTACACGGATTCGGTCTTTGACTACTGG	CARVGYYYDSSGYTDSVFDYW	IGHV1-18	IGHJ4
TGTGCGAGAACCCCGTTAAAAGGTGGGAGCTACTACAAACATCCATTTCCTGTCTTTGACTACTGG	CARTPLKGGSYYKHPFPVFDYW	IGHV7-4-1	IGHJ4
TGTGCGAGAGAGGGACTTCCCGACGGGCCCCGCTTCAAAGCCCACTATTATGATTACATTTGGGGGAGTTATCGTAAGGGTGATGCTTTTGATATCTGG	CAREGLPDGPRFKAHYYDYIWGSYRKGDAFDIW	IGHV4-59	IGHJ3
TGTGCGAAAGCCTATGGCCCAGGGAGGACTGCCATAGCAGTGGCTGGGGTACGCTTCAATTCCCCTAACCTATTTGACTACTGG	CAKAYGPGRTAIAVAGVRFNSPNLFDYW	IGHV3-23	IGHJ4
TGTGCGAGACTTGATATAGTGGCTACGATAACACTAAAGTTTCCTCGTTCATGTTCCATTACACCCTACTACTACTACTACATGGACGTCTGG	CARLDIVATITLKFPRSCSITPYYYYYMDVW	IGHV4-34	IGHJ6
TGTGCGAGAGCCGTTTTGGACGGGCCTCACCCCTATAGGCTTGACTACTGG	CARAVLDGPHPYRLDYW	IGHV3-66	IGHJ4
TGTGAGTCTGTAGTGGTGGTAGCTGCTACGAGAACCTACTACTACTACATGGACGTCTGG	CESVVVVAATRTYYYYMDVW	IGHV3-30	IGHJ6
TGTGCACGGATGTCTAGAATCGTGGTAGCTGCTACGCTCACGGACTGG	CARMSRIVVAATLTDW	IGHV2-26	IGHJ5
TGTGCAAGAGAAAAGGTCATTACCATCTTGTACTGGTGGTGTATGCTATACCGCGTGGGGTTCGTACTCGCCTGCTGGTTCGACCCCTGG	CAREKVITILYWWCMLYRVGFVLACWFDPW	IGHV6-1	IGHJ5
TGTGCGAGACCGCAACTGGGGACCGCAGGGTACTTCGATCTCTGG	CARPQLGTAGYFDLW	IGHV5-51	IGHJ2
TGTGCGAGTGGGGGGTACCACGATTTTTGGAGTGGTCTGGGGAACTGGTTCGACCCCTGG	CASGGYHDFWSGLGNWFDPW	IGHV3-20	IGHJ5
TGTGCGAGAGATCTATCCCGGCAGAATTGTAGTAGTACCAGCTGCTTAGCCTGGTTCGACCCCTGG	CARDLSRQNCSSTSCLAWFDPW	IGHV3-30	IGHJ5
TGTGCGAGACATATTGTAGCGACAACTATGATAGTAGTGGTTATTAGAGTCCCCTTTGACTACTGG	CARHIVATTMIVVVIRVPFDYW	IGHV5-51	IGHJ4
TGTGCGAGAGATAAACGCCAGTATTACGATTTTTGGAGTGGTTACCGCGCCCAGGGAAATATCTACTACTACTACATGGACGTCTGG	CARDKRQYYDFWSGYRAQGNIYYYYMDVW	IGHV4-61	IGHJ6
TGTGCGGTCCAAGACCGCGCCGCCAGTAGTAGTACCAGCTGCTACGAAGCCGCCTACTACTACTACTACATGGACGTCTGG	CAVQDRAASSSTSCYEAAYYYYYMDVW	IGHV3-NL1	IGHJ6
TGTGCGAGGGTCTTATTATCGCACTACTACTTTGACTACTGG	CARVLLSHYYFDYW	IGHV1-69	IGHJ4
TGTGCGAGAGGATTCTGCAAATTACGGGCCTTGCGCTGG	CARGFCKLRALRW	IGHV4-38-2	IGHJ4
TGTGCGAGCCCGTGGTACGGTGACGGCTGGTTCGACCCCTGG	CASPWYGDGWFDPW	IGHV1-3	IGHJ5
TGTGCGAGACGAATGCCTATTACTATGATAGTAGTGGTTATTGACTCCCACCACAACTGGTTCGACCCCTGG	CARRMPITMIVVVIDSHHNWFDPW	IGHV5-51	IGHJ5
TGTGCGAGAGATGGTGTGGTGCGCTTGGTAGGATATTGTAGTGGTGGTAGCTGCTACTCGTTAGGTGACTACTGG	CARDGVVRLVGYCSGGSCYSLGDYW	IGHV3-53	IGHJ4
TGCGATTTACAAATACCGATAGTAGTGGTCTACACCTGTACCGTAACCTTTTATAACGTTGACTACTGG	CDLQIPIVVVYTCTVTFYNVDYW	IGHV1-18	IGHJ4
TGTGCGAGGAAAACGGTGGTAACTCGTCGATCGTGCGTCCGGGCGCTTGACTACTGG	CARKTVVTRRSCVRALDYW	IGHV1-2	IGHJ4
TGTGCGAGAGATTATCAGTACCCCACCGGCCGAGATATTGTAGTAGTACCAGCTGCTGATATAAAGTACTACTACTACTACATGGACGTCTGG	CARDYQYPTGRDIVVVPAADIKYYYYYMDVW	IGHV3-11	IGHJ6
TGTGCGAGACGTCTTACTATGGTTCGGGGAGTTATTATAATCCTCGGCTACTGG	CARRLTMVRGVIIILGYW	IGHV3-48	IGHJ4
TGTGCGAGAGATTCCCGAATAGTAGTACCCTTGGCCCTTGACTACTGG	CARDSRIVVPLALDYW	IGHV1-18	IGHJ4
TGTGCGAAAGATGGGACGCCGGGCGCCATTGTAGTAGTACCAGCTGCTACCTTTCCACAGCTCCAGCCCCACAACTGGTTCGACCCCTGG	CAKDGTPGAIVVVPAATFPQLQPHNWFDPW	IGHV3-23	IGHJ5
TGTGCAAGAGGGTCGAGGCGATACTACTACTACTACTACATGGACGTCTGG	CARGSRRYYYYYYMDVW	IGHV6-1	IGHJ6
TGTGCGAGAGCTTATTGTAGTAGTACCAGCTGCTATCCCATGGTTGACTACTGG	CARAYCSSTSCYPMVDYW	IGHV3-53	IGHJ4
TGTGCAAAAGAGGTTCGTCATTTCCGTATTGTAGTGGTGGTAGCTGCTTACACGGGGCGGGACTACTGG	CAKEVRHFRIVVVVAAYTGRDYW	IGHV3-43D	IGHJ4
TGTGCGAGACTTAGTAGTGGCTGGTACTCCCAGCTCGGACCCAACTACTACTACTACATGGACGTCTGG	CARLSSGWYSQLGPNYYYYMDVW	IGHV5-51	IGHJ6
TGTGCGAAAGACCTCATTACTATGATAGTAGTGGTTATTAGGGCCACCCGGGCTTTTGATATCTGG	CAKDLITMIVVVIRATRAFDIW	IGHV3-23	IGHJ3
TGTACTAGACAGGAGCGTATTACGATTTTTGGAGTGGTTATTATACACTACTACTACTACTACATGGACGTCTGG	CTRQERITIFGVVIIHYYYYYMDVW	IGHV3-73	IGHJ6
TGTGCAACAGATCGAGTGGGATGTATAGCAGCAGCTGGTTTGGGGTTTGACTACTGG	CATDRVGCIAAAGLGFDYW	IGHV1-24	IGHJ4
TGTGCAAGAGTAAGGCAGCTGGCTAAACCTGATCATCGCAAAGGCTACTGG	CARVRQLAKPDHRKGYW	IGHV6-1	IGHJ4
TGTGCAAAAGGTGGGGTAGTAACTACGCCAGGCGCCCTTTATGCTTTTGATATCTGG	CAKGGVVTTPGALYAFDIW	IGHV3-43D	IGHJ3
TGTGCGAAAGCCGGGATGCGTGATATTGTACTGGTGGTGTATGCGGAACGCTACTACTACTACTACATGGACGTCTGG	CAKAGMRDIVLVVYAERYYYYYMDVW	IGHV3-23	IGHJ6
TGTGCGAAAGCGTACGTATTACTATGGTTCAGGGAGTGCTACTACTACTACTACATGGACGTCTGG	CAKAYVLLWFRECYYYYYMDVW	IGHV3-NL1	IGHJ6
TGTGCGAAAGACGTCCACGATTTTTGGAGTGGTTATTATCATTACTACTACTACTACATGGACGTCTGG	CAKDVHDFWSGYYHYYYYYMDVW	IGHV4-38-2	IGHJ6
TGTGCGAAAGATTCAACTAAAAGCTATTGTAGTGGTGGTAGCTGCAAGGCGTGGAGGTCACACTACTACTACTACTACATGGACGTCTGG	CAKDSTKSYCSGGSCKAWRSHYYYYYMDVW	IGHV3-23	IGHJ6
TGTCCTAGGCGGGATTACTATGGTTCAGGGAGTCTTGACTACTGG	CPRRDYYGSGSLDYW	IGHV4-30-2	IGHJ4
TGTGCGAGAAGGCCTATGGTTCAGGGAGTTATTATCCAACGGTTTCAATTCCTCTACTGG	CARRPMVQGVIIQRFQFLYW	IGHV4-34	IGHJ4
TGTATGGGGGGGGGCGCTGCTACTTTTGACTACTGG	CMGGGAATFDYW	IGHV3-49	IGHJ4
TGCCTTATCGAGGGTGACTATTACTACTTTGACTACTGG	CLIEGDYYYFDYW	IGHV5-10-1	IGHJ4
TGTGCGAAAGCATCTACCCATGACTACGGTGGTAGGGACTACTTTGACTACTGG	CAKASTHDYGGRDYFDYW	IGHV3-NL1	IGHJ4
TGTGCACACATCCCCATCTATGGTTCGGGGAGTTATTATAAGGATCCACGACATGATGCTTTTGATATCTGG	CAHIPIYGSGSYYKDPRHDAFDIW	IGHV2-5	IGHJ3
TGTGCGAGAGATCTTGCCCTACGTATTACTATGATAGTAGTGGTCGATGCTAGGTTTGACTACTGG	CARDLALRITMIVVVDARFDYW	IGHV3-7	IGHJ4
TGTGTAGGCCCCAATACTATGATAGTAGTGGTTATTACTGACGGTGATGCTTTTGATATCTGG	CVGPNTMIVVVITDGDAFDIW	IGHV3-74	IGHJ3
TGTGCGAAACCGGCCCTTTGGGGGTCAGAGAACGAACCATATTCCCGGTACCCCCCAACTCACCGAAGGTACTACTACTACTACATGGACGTCTGG	CAKPALWGSENEPYSRYPPTHRRYYYYYMDVW	IGHV3-23	IGHJ6
TGTGCAAGACTTGCCAGTAGTGGTTATTACCGACCAGTTACTTTCCCTTCTTGCTTTGACTACTGG	CARLASSGYYRPVTFPSCFDYW	IGHV3-13	IGHJ4
TGTGCGAAAGGTCGGGTAGGGCTAGTGGCTATGGTTCAGGGAGTTATTACTGACTACTACTACTACTACATGGACGTCTGG	CAKGRVGLVAMVQGVITDYYYYYMDVW	IGHV3-23	IGHJ6
TGTGCGATACTGGGTATAGCAGTGGCTGTCAAGCTGGCTTTTGACTACTGG	CAILGIAVAVKLAFDYW	IGHV1-2	IGHJ4
TGTGCCCCCCTCGAATATCGTAGTAGTACCAGCTGCTGTGATCCCTACTACTACTACTACATGGACGTCTGG	CAPLEYRSSTSCCDPYYYYYMDVW	IGHV3-53	IGHJ6
TGTGCGAGAATTGGCTGTGATTACATTTGGGGGAGTTATCGTTATGACTACTGG	CARIGCDYIWGSYRYDYW	IGHV4-39	IGHJ4
TGTGCGAAAGCCGATTATCGGGGCTGCATAGCAGCAGCTGGTATTGATTTCCGGTTTCCTTGTTATCACTACTGG	CAKADYRGCIAAAGIDFRFPCYHYW	IGHV3-23	IGHJ4
TGTGCAAGACCCTTCAGGAATAGCAGCTCCCTTGCTTTTGATATCTGG	CARPFRNSSSLAFDIW	IGHV3-13	IGHJ3
TGTGCGTTAGGATGCCGGGGATATTGTAGTGGTGGTAGCTGCTACTCCGGCTTTGACTACTGG	CALGCRGYCSGGSCYSGFDYW	IGHV3-23	IGHJ4
TGTGCGAGAGATCCAGAGGGGCATATTGTGGTGGTGACTGCTATGGGTGACTACTGG	CARDPEGHIVVVTAMGDYW	IGHV3-53	IGHJ4
TGTGCGAGAGGACTCTTAAACTATGGTTCAGGGAGTTATTATCGTAACTGG	CARGLLNYGSGSYYRNW	IGHV1-69	IGHJ4
TGTACTAGAGAGACAAGTATTACTATGGTTCAGGGCACTTTTGATATCTGG	CTRETSITMVQGTFDIW	IGHV3-49	IGHJ3
TGTGCGAAGGAAGTAGTACCAGGCCCCCGGGGGTGGTTCGACCCCTGG	CAKEVVPGPRGWFDPW	IGHV3-23	IGHJ5
TGTACAGGTCGGCCAATTACTATGATAGTAGTGGTTATTACTACGCAGGTCATCCCTCTTGACTACTGG	CTGRPITMIVVVITTQVIPLDYW	IGHV3-15	IGHJ4
TGTGCGAAAGGAGTAAGTAGTGGGAGCTACTCCCCGGACTACTGG	CAKGVSSGSYSPDYW	IGHV3-NL1	IGHJ4
TGTTTCTTGGAGAACTGG	CFLENW	IGHV3-13	IGHJ4
TGTGCGAGAGCCGCACCGGGTATAGCAGTGGCTGGTCGCGGGAGGTACTTTGACTACTGG	CARAAPGIAVAGRGRYFDYW	IGHV1-2	IGHJ4
TGTGCGATTCTCCGAGCAGCTCGTAGTAAACGCTTTGACTACTGG	CAILRAARSKRFDYW	IGHV3-48	IGHJ4
TGTGCGAAAAATTGGATCCAAAGGGTGACTACTGATGCTTTTGATATCTGG	CAKNWIQRVTTDAFDIW	IGHV3-NL1	IGHJ3
TGTGCGAGAGATATAGCAGCTCGCCCCCCGTTCCAGTTCGATAGCTGG	CARDIAARPPFQFDSW	IGHV3-30	IGHJ4
TGTGCGGCGCGACAGATTCAAGCAGTGGCTGGTAGGTTCTGGGCGGTCCCCATTCAGGCCGATGCTTTTGATATCTGG	CAARQIQAVAGRFWAVPIQADAFDIW	IGHV1-58	IGHJ3
TGTGTACGTATAGCAGCAGCTGGTACTTTCGCGATAAACTGGTTCGACCCCTGG	CVRIAAAGTFAINWFDPW	IGHV1-2	IGHJ5
TGTGCACGAACCGGGGGGGTAAGTTGGAAGAGGCTCGTACTGCTCGGGGTATGGTTCAGGGAGTTCAACCGTTACTACTACTACTACTACATGGACGTCTGG	CARTGGVSWKRLVLLGVWFREFNRYYYYYYMDVW	IGHV2-70	IGHJ6
TGTGCGAGATATTGTAGTAGTACCAGCTGCTATATTACCCACTGGTTCGACCCCTGG	CARYCSSTSCYITHWFDPW	IGHV4-4	IGHJ5
TGTGCGAGAGCGGCTGTACTAATGGTGTATGCAAATGGCTGGTTCGACCCCTGG	CARAAVLMVYANGWFDPW	IGHV1-8	IGHJ5
TGTGCGAGAGGGTCAACACTAACTAACATTACTATGATAGTAGTGGTTATTACTCGTAGAGGGACCTTTGACTACTGG	CARGSTLTNITMIVVVITRRGTFDYW	IGHV1-69	IGHJ4
TGTGCAAGAGGGACTATTACGATTTTTGGAGTGGCCCGTCCCTGG	CARGTITIFGVARPW	IGHV1-45	IGHJ4
TGTGCAACAGGGGAAGGTATAGCAGCAAAAAAGGGGCACAACTGGTTCGACCCCTGG	CATGEGIAAKKGHNWFDPW	IGHV1-24	IGHJ5
TGTGCGAGAGACCAGGCCCGTGCCCGATACGATTTTTGGAGTGGTTATTATATAGACTACTACTACTACTACATGGACGTCTGG	CARDQARARYDFWSGYYIDYYYYYMDVW	IGHV1-18	IGHJ6
TGTGCGAAAGATGCATTACTATGGTTCGGGGAGTTATCAGATGCCTGGTACTTCGATCTCTGG	CAKDALLWFGELSDAWYFDLW	IGHV3-NL1	IGHJ2
TGTGGATATTGTAGTGGTGGTAGCTGCCCCGATGCTTTTGATATCTGG	CGYCSGGSCPDAFDIW	IGHV3-49	IGHJ3
TGTGCGAAAGGTTTAGGTCTTGCTGGTAGTACCAGCTGCTATGCTTCCAACTGGTTCGACCCCTGG	CAKGLGLAGSTSCYASNWFDPW	IGHV3-23	IGHJ5
TGTACTAGAACGGGAGGTCGTATTGTGGTGGTGACTGCTATTCTGAAAACACTTGACTACTGG	CTRTGGRIVVVTAILKTLDYW	IGHV3-73	IGHJ4
TGTGCGAAGATTTACTATGATAGTAGTGGTTACGCCAACTGGTTCGACCCCTGG	CAKIYYDSSGYANWFDPW	IGHV3-30	IGHJ5
TGTGCGAGAGATTCCCGGCATGGTTCAGGGAGTTATGGGGGTAGGCTTGACCACCGTCGACCCCTGGATTTACACTACTACTACTACTACATGGACGTCTGG	CARDSRHGSGSYGGRLDHRRPLDLHYYYYYMDVW	IGHV3-53	IGHJ6
TGTGCACGGATACGGGTACCTGATAGCAGTGGCTGGTACACTGCTTTTGATATCTGG	CARIRVPDSSGWYTAFDIW	IGHV2-26	IGHJ3
TGTGCGAGAGATCGAAAGGGAGAACGTATTACGATTTTTGGAGTGGTTATTCCCTGGTTCGACCCCTGG	CARDRKGERITIFGVVIPWFDPW	IGHV3-30	IGHJ5
TGTGCGAGAGGCCTCCTCTCCTTTGTAGTGGTGGTAGCTGCTACTCGGAATATGCACTGG	CARGLLSFVVVVAATRNMHW	IGHV4-34	IGHJ1
TGTGCGAGCCATGTATTACTATGGTTCGGGGAGTTATTAGATAAAGCGTGTGACGAGGACTACTGG	CASHVLLWFGELLDKACDEDYW	IGHV4-59	IGHJ4
TGTGCGAGAGATTGGTACGATATTTTGACTGGTTATTATAGGGCATTTCACTACTACTACTACTACATGGACGTCTGG	CARDWYDILTGYYRAFHYYYYYMDVW	IGHV4-59	IGHJ6
TGTGCACGGATTCCCGTGCATAACTGGTTCGACCCCTGG	CARIPVHNWFDPW	IGHV2-26	IGHJ5
TGTGCGAGACACGAGATTGTTAGCAGCAGCTCGAAGTCTCTTCGGGATCCCGGGGGCTACTACTACTACATGGACGTCTGG	CARHEIVSSSSKSLRDPGGYYYYMDVW	IGHV5-51	IGHJ6
TGTACTAGAGATCGCCCTCGCGTCCGGGTCCGGGCGAGTCTGAGTTCCTGTAGTGGTGGTAGCTGCTACTCCGTTCGACCGCACTACTACTACTACATGGACGTCTGG	CTRDRPRVRVRASLSSCSGGSCYSVRPHYYYYMDVW	IGHV3-49	IGHJ6
TGTGCGAGTCGGGGGGTACCAAATTACGATTTTTGGAGTGGTTATTGTACATACTACTACTACTACATGGACGTCTGG	CASRGVPNYDFWSGYCTYYYYYMDVW	IGHV4-38-2	IGHJ6
TGTGCGAGAACCTGCGGTGACTACGGCATCTACTGG	CARTCGDYGIYW	IGHV7-4-1	IGHJ4
TGTGCACTTCCCCCCCATTACGATTTTTGGAGTGGTTATTATATCCTTTCCAAAAACTTTGACTACTGG	CALPPHYDFWSGYYILSKNFDYW	IGHV2-5	IGHJ4
TGTGCGAGAGACGTAATTGTAGTGGTGGTAGCTGCTACTCTGCTTCCCTACTACTACTACATGGACGTCTGG	CARDVIVVVVAATLLPYYYYMDVW	IGHV1-2	IGHJ6
TGTGCGAGATTGGGTATTGTAGTGGTGGTAGCTGCTTCCTACAACTGGTTCGACCCCTGG	CARLGIVVVVAASYNWFDPW	IGHV4-59	IGHJ5
TGTGCGAAAGATATGAGGGTTTTTCCGGAATACTGGTTCGACCCCTGG	CAKDMRVFPEYWFDPW	IGHV3-23	IGHJ5
TGTGCGAGACGGAGATATTGTAGTGGTGGTAGCTGCTACAGCAATGGTGACTACTGG	CARRRYCSGGSCYSNGDYW	IGHV7-4-1	IGHJ4
