TGTGCACGGGACCCCGGAAAACTTAGGCCGAATATACCAGAGTTTTGTAGTAGTACCAGCTGCGGGCATGGCTACTGG	CARDPGKLRPNIPEFCSSTSCGHGYW	IGHV2-70	IGHJ4
TGTGCGAGAAACCTCCATATTGTAGTGGTGGTAGCTGCTACTCCCCCTATCTACTGG	CARNLHIVVVVAATPPIYW	IGHV7-4-1	IGHJ4
TGTGCGAGAGATCCCTATGGATATTGTAGTAGTACCAGCTGCTACGGGTACTACTACTACTACATGGACGTCTGG	CARDPYGYCSSTSCYGYYYYYMDVW	IGHV3-11	IGHJ6
TGTGCGAGACTGGACTCATTACGATTTTTGGAGTGGTTATTATGTTTGGCAACCTGCTACTACTACTACTACTACATGGACGTCTGG	CARLDSLRFLEWLLCLATCYYYYYYMDVW	IGHV3-53	IGHJ6
TGTGCACGGTCCCATACAGCTATGGAGCCGGGCTACTTTGACTACTGG	CARSHTAMEPGYFDYW	IGHV2-70	IGHJ4
TGTACCACAGGGAATAGCAGTGGCTCATTTGACTACTGG	CTTGNSSGSFDYW	IGHV3-15	IGHJ4
TGTGCGAGAGATGCCCTTATGATTACATTTGGGGGAGTTGCAAGAAGCCCTCCGTACAACTGGTTCGACCCCTGG	CARDALMITFGGVARSPPYNWFDPW	IGHV3-53	IGHJ5
TGTGCGAGGAACCATATTGTGGTGGTGATTGTGCCAAACTGGTTCGACCCCTGG	CARNHIVVVIVPNWFDPW	IGHV4-4	IGHJ5
TGTGCGAGAGATGGGGAATCGATAGTAGTGGTTATCCCCTACTACTTTGACTACTGG	CARDGESIVVVIPYYFDYW	IGHV4-61	IGHJ4
TGTGCGAGATCCGGAGCGGGGACGTCCTTTGATTGTAGTGGTGGTAGCTGCTACTTTAACTGGTTCGACCCCTGG	CARSGAGTSFDCSGGSCYFNWFDPW	IGHV4-39	IGHJ5
TGTGCGATACTGTCAATTTTTGGAGTGGTTCATGCTTTTGATATCTGG	CAILSIFGVVHAFDIW	IGHV4-39	IGHJ3
TGTGCCATGATTACATTTGGGGGAGTTATCGTTATGCCCTCAAGTGGCGCTTGGTTCCAGCACTGG	CAMITFGGVIVMPSSGAWFQHW	IGHV3-30	IGHJ1
TGTGCGAGAGAACCCATGATGATCACGGAAAACACGGGCCATGACTACTGG	CAREPMMITENTGHDYW	IGHV4-61	IGHJ4
TGTGCGAGAGATCGTCCCGGGTACTCATATTGTGGTGGTGACTGCTCCCCGTACAACTGGTTCGACCCCTGG	CARDRPGYSYCGGDCSPYNWFDPW	IGHV1-3	IGHJ5
TGTGCGAGAGATAGGATTCGGGTTTGCCGGTCCGTGAGGAATGACTACTGG	CARDRIRVCRSVRNDYW	IGHV3-21	IGHJ4
TGTGCGAAAGGGGATTGTAGTGGTGGTAGCTGCTACGGGTACTACTTTGACTACTGG	CAKGDCSGGSCYGYYFDYW	IGHV3-23	IGHJ4
TGTGCGAGAGAACCAGGGACCATTACGATTTTTGGAGTGGTTATTAACTTCTTTGACTACTGG	CAREPGTITIFGVVINFFDYW	IGHV3-7	IGHJ4
TGTGCAAAAGATATGTTTGTAGTAGTACCAGCTGCTATGGGCGGCAGGGCTTACTACTACTACTACTACATGGACGTCTGG	CAKDMFVVVPAAMGGRAYYYYYYMDVW	IGHV3-43	IGHJ6
TGTGCGAAAGATCCCCGACCCTTAGCCCGAAGTTACTACTTTGACTACTGG	CAKDPRPLARSYYFDYW	IGHV3-23	IGHJ4
TGTCAGCTTCACGTTCCTCAGGGCTACTTTGACTACTGG	CQLHVPQGYFDYW	IGHV1-2	IGHJ4
TGTGCGAGAGATGGGGGTCTAGCCCCTACGATTTTTGGAGTGGTTATTATCACGGTTTTCCAGCCTGACTACTGG	CARDGGLAPTIFGVVIITVFQPDYW	IGHV4-61	IGHJ4
TGTGCGAGAGCTTCCTACGATTTTTACCCACTTGAATCGTCGTTCGACCCCTGG	CARASYDFYPLESSFDPW	IGHV1-3	IGHJ5
TGTGCGAGAGATAGCTTATTACGATTTTTGGAGTGGTTATTACGCGGCCGGGCCTACTACTTTGACTACTGG	CARDSLLRFLEWLLRGRAYYFDYW	IGHV3-20	IGHJ4
TGTGCGAAACGTAGTAGTGGTTATTACGGAGCCTACTTTGACTACTGG	CAKRSSGYYGAYFDYW	IGHV3-23	IGHJ4
TGTGCGAGAGATCATTCATGGGCCCACTACTACTACTACTACTACATGGACGTCTGG	CARDHSWAHYYYYYYMDVW	IGHV3-21	IGHJ6
TGTGCGAAAGATCCGAACTGGACGTTCTTACGGTTATTTGGACTGTACTACTTTGACTACTGG	CAKDPNWTFLRLFGLYYFDYW	IGHV3-NL1	IGHJ4
TGTGCTAGAGATTCTGCCATTGTAGTAGTACCAGCTGCTATGGAAAGCTACTACTACTACTACATGGACGTCTGG	CARDSAIVVVPAAMESYYYYYMDVW	IGHV3-72	IGHJ6
TGTGCGAAATACAGTCCGAGGTTCAGGGAGTTATATCGCTACTACTACTACTACATGGACGTCTGG	CAKYSPRFRELYRYYYYYMDVW	IGHV1-69	IGHJ6
TGTACCACAGAAAGGAGTACCAGCTGCTATGGTTTTGACTACTGG	CTTERSTSCYGFDYW	IGHV3-15	IGHJ4
TGTGCACACACGGAGGTATTACGATATTTTGACTGGTTAGTGAACTACTACATGGACGTCTGG	CAHTEVLRYFDWLVNYYMDVW	IGHV2-5	IGHJ6
TGTGCGAGAGACCCGGCCCCTCTCCAGACCAATTGTAGTGGTGGTAGCTGCTATGGTAGACCCAGGGTTAACTGGTACTTCGATCTCTGG	CARDPAPLQTNCSGGSCYGRPRVNWYFDLW	IGHV1-3	IGHJ2
TGTGCGAGAGGGGTTCGCGGCCGATTTTTGGAGTGGTTATTATCGTGCTACTACTACTACTACATGGACGTCTGG	CARGVRGRFLEWLLSCYYYYYMDVW	IGHV1-3	IGHJ6
TGTGCAAGAGATGGGACCCACGCCCCGGGCGTAGTACCAGCTGCTATAAACGGGTTCTGG	CARDGTHAPGVVPAAINGFW	IGHV3-74	IGHJ5
TGTGCGAGAGATGAGGCGGAATTGGTAGCTGCTAGGGGCTTCAACTACTACTACTACTACATGGACGTCTGG	CARDEAELVAARGFNYYYYYMDVW	IGHV3-21	IGHJ6
TGTGCGAAAGATCGGGGAGGTATTACTATGATAGTAGTGGTACGCTTTGACTACTGG	CAKDRGGITMIVVVRFDYW	IGHV3-NL1	IGHJ4
TGTGCGAAAGATCACACCTATAGGGGCATACCACGTATTACTATGATAGTAGTGGTTAGGTCCCAGTTTCCACAGTACTACTTTGACTACTGG	CAKDHTYRGIPRITMIVVVRSQFPQYYFDYW	IGHV3-NL1	IGHJ4
TGTACCACAGGGAATAGCGTGGGGGAAATGGATCATATTGTAGTGGTGGTAGCTGCTACTGCTACCCCTGAACGCGGTGACTACTGG	CTTGNSVGEMDHIVVVVAATATPERGDYW	IGHV3-15	IGHJ4
TGTGCGAAAGATCGGCCCGTAGGTATTACTATGATAGTAGTGGTTATCTCGCACTTTGACTACTGG	CAKDRPVGITMIVVVISHFDYW	IGHV3-NL1	IGHJ4
TGTACCACAGGTTTTGTAGGGGTGCAGCAGCTGGTACGGTACAGCTACTACTACTACTACATGGACGTCTGG	CTTGFVGVQQLVRYSYYYYYMDVW	IGHV3-15	IGHJ6
TGTGCGAGAGATCACCTCCTAACTGGCTGGTTCGACCCCTGG	CARDHLLTGWFDPW	IGHV3-30	IGHJ5
TGTGCGAGAAATATTCGTATAGCAGCAGCTGGTAAGTTTGACTACTGG	CARNIRIAAAGKFDYW	IGHV7-4-1	IGHJ4
TGTGCGAGAGAAGGTCGGCCGGATATTGTGGTGGTGACTGTTTATTTAATCCCCGGCCGCTACTGG	CAREGRPDIVVVTVYLIPGRYW	IGHV3-7	IGHJ4
TGTGCGAGAGCTTCCACGTCTATTACGATTTTTGGAGTGGTTGATAGGTTCTTTGACTACTGG	CARASTSITIFGVVDRFFDYW	IGHV3-7	IGHJ4
TGTGCGAGAGCAAGACCGGGGGGTAGCTGCTACTCTGACTACTGG	CARARPGGSCYSDYW	IGHV4-34	IGHJ4
TGTGCGAAAGATCGTGGCGGGGGTGGTAGCTGCTACCAAAAGGGATTTGACTACTGG	CAKDRGGGGSCYQKGFDYW	IGHV3-NL1	IGHJ4
TGTGCGAGAGGCTTGGTGGCTACGATCCCCTGCTACTACATGGACGTCTGG	CARGLVATIPCYYMDVW	IGHV4-59	IGHJ6
TGTGCGAGAGTTACCGGGATGCCGGGTATAGCAGCAGCTGGTACGGCTGCTGACTACTGG	CARVTGMPGIAAAGTAADYW	IGHV1-2	IGHJ4
TGTGCGAGAGATGGGTTACGATTTTTGGAGTGGTTATTATGTTGCCAGTACTACTACTACTACTACATGGACGTCTGG	CARDGLRFLEWLLCCQYYYYYYMDVW	IGHV3-53	IGHJ6
TGTGCGAGCCGCGGGGACGTAGTGGCTACGCCGGCTAGGATACTGACTCGCGGTGGAGGGGTAAAGCACTTTGACTACTGG	CASRGDVVATPARILTRGGGVKHFDYW	IGHV3-7	IGHJ4
TGTACCACATTACGATATATAGACTACTGG	CTTLRYIDYW	IGHV3-15	IGHJ4
TGTGCGAAAGCAGGTGGTTCAGGGAGTTATTCCCCGAAGGATGACTCGTACTACTACTACTACTACATGGACGTCTGG	CAKAGGSGSYSPKDDSYYYYYYMDVW	IGHV3-23	IGHJ6
TGTGCGCCGATTCCACGCAGTGGCTGGTACGGATACTACTTTGACTACTGG	CAPIPRSGWYGYYFDYW	IGHV3-11	IGHJ4
TGTGCGAGAATAGCAGTGGCTGGCATTCATCTTGACTACTGG	CARIAVAGIHLDYW	IGHV3-30	IGHJ4
TGTGCGCCCTGGTTCAGGGAGTTATTACCCTGGTTCGACCCCTGG	CAPWFRELLPWFDPW	IGHV3-21	IGHJ5
TGTGCGAGTAAATTACGATTTTTGGAGTGGTTATTATTCTTTTGGTTCGACCCCTGG	CASKLRFLEWLLFFWFDPW	IGHV4-28	IGHJ5
TGTGCGAGACAGAGAAATTGTAGTAGTACCAGCTGGGTTTGGGTT	CARQRNCSSTSWVWV	IGHV1-3	IGHJ5
TGTGCGAGAGATACCCTAGGATATTGTAGTGGTGGTAGCTGCTACGATATTGCGATTTACTACTACTACTACATGGACGTCTGG	CARDTLGYCSGGSCYDIAIYYYYYMDVW	IGHV3-7	IGHJ6
TGTGCGAGCCATCCACGTTCCGATGGTTCAGGGAGTTATTATAACCAACACTACTTTGACTACTGG	CASHPRSDGSGSYYNQHYFDYW	IGHV7-4-1	IGHJ4
TGTGCGAGAGACAGTCTCCATGACTACGGTGACTACGTCGCTTCCTACTGG	CARDSLHDYGDYVASYW	IGHV3-30	IGHJ4
TGTGCGAGCCGGGACGTGTGGGAGCTACTAGAGTTCCCCTACTTCCAGCACTGG	CASRDVWELLEFPYFQHW	IGHV1-3	IGHJ1
TGTGCAAGTTCCCCGGTGGGACACGCAGGGTTACGATTTTTGGAGTGGTTATCTGACTACTGG	CASSPVGHAGLRFLEWLSDYW	IGHV3-13	IGHJ4
TGTGCGAAAGATCGCCCTGCAACCTTAGTACCAGACTACTTTGACTACTGG	CAKDRPATLVPDYFDYW	IGHV3-NL1	IGHJ4
TGTGCGAGAGACTATGATAGCAGTGGCTGGTCATGGCGGAACCTGTACTACTTTGACTACTGG	CARDYDSSGWSWRNLYYFDYW	IGHV1-69	IGHJ4
TGTGCGAGAGGGGGATCCGGTTATTGTAGTAGTACCAGCTGCTATGGGGACTACTACATGGACGTCTGG	CARGGSGYCSSTSCYGDYYMDVW	IGHV3-53	IGHJ6
TGTGCAAAAGATCTGAAGCATCATGTAGTGGTGGTAGCTGCCGTGACGTACTACTTTGACTACTGG	CAKDLKHHVVVVAAVTYYFDYW	IGHV3-43D	IGHJ4
TGTGCGGGGGCTCCCCCTGTAGTACCAGCTGCTTGCTACTACTACTACTACATGGACGTCTGG	CAGAPPVVPAACYYYYYMDVW	IGHV3-53	IGHJ6
TGTGCACGGTTAATTGTAGTGGTGGTAGCTGCCCCCCAAGGTTGTGACTACTGG	CARLIVVVVAAPQGCDYW	IGHV1-2	IGHJ4
TGTGCGAGACGAGCGGGGGCTACAATTCCCCTATACTGGTACTTCGATCTCTGG	CARRAGATIPLYWYFDLW	IGHV7-4-1	IGHJ2
TGTACCACAGATCCTTCCATCGGGTATTACTATGGTTCAGGGAGTTACCCCCCTAACTACTACTACTACATGGACGTCTGG	CTTDPSIGYYYGSGSYPPNYYYYMDVW	IGHV3-15	IGHJ6
TGTGCGAGAGGGGGAGACTACAGTTTTGCTCCGCACTACTACTACTACTACATGGACGTCTGG	CARGGDYSFAPHYYYYYMDVW	IGHV4-59	IGHJ6
TGTGCACGCTTTGTTTTCCACCTAGGCCATATTGTACTAATGGTGTATGCTCGGTGG	CARFVFHLGHIVLMVYARW	IGHV2-70	IGHJ2
TGTGCGAGAGATCCGGTCTCGGTAGTGGTGGTAGCTGCTACAAAATGCTTTGGGGATAGCCCGCGAATTCGGGCTGACTACTGG	CARDPVSVVVVAATKCFGDSPRIRADYW	IGHV3-66	IGHJ4
TGTGCGAGAGGCCAGAGTAGTGGGAGCTACTGGGGCTTTGACTACTGG	CARGQSSGSYWGFDYW	IGHV5-10-1	IGHJ4
TGTGGTAAAGATAGCAGTGGCTGGTACGGGTGTAACAGGGAAGCCGCCGACTACTGG	CGKDSSGWYGCNREAADYW	IGHV4-30-2	IGHJ4
TGTGCGAGAGGCTCGAGGCAGCAGCTGGTGGTTAGAAATTTCTACTACTACTACTACATGGACGTCTGG	CARGSRQQLVVRNFYYYYYMDVW	IGHV3-66	IGHJ6
TGTGCGAGAGGACCCCCATTACTATGGTTCAGGGAGTGGCGGGTTGACTACTGG	CARGPPLLWFREWRVDYW	IGHV3-66	IGHJ4
TGTGCGAGACAAAACTCGGGTGGTAGCTGTGATGCTTTTGATATCTGG	CARQNSGGSCDAFDIW	IGHV5-51	IGHJ3
TGTGCGAGAGAACTGGTAACTACAACTGGTACCGTCACATACAACTGGTTCGACCCCTGG	CARELVTTTGTVTYNWFDPW	IGHV3-21	IGHJ5
TGTGCGAGCTTTATAGCAGTGGCTGGTACTAACGGCAACTTGGTCGATGCTTTTGATATCTGG	CASFIAVAGTNGNLVDAFDIW	IGHV4-34	IGHJ3
TGTGCGAAAGATAGGTGTATTACGATTTTTGGAGTGGTTACCCTTAAATACTTTGACTACTGG	CAKDRCITIFGVVTLKYFDYW	IGHV3-23	IGHJ4
TGTGCGACCCGGATGCCCATTGTAGTAGTACCAGCTGCTACTAGATACATGATTCCAGTGTTCCCGAGAAAATACTGGTTCGACCCCTGG	CATRMPIVVVPAATRYMIPVFPRKYWFDPW	IGHV3-11	IGHJ5
TGTGCGAAACCGGTGCTGGCAGCAGCTGCCAGAATGGTCCGGGACAACTGGTTCGACCCCTGG	CAKPVLAAAARMVRDNWFDPW	IGHV3-NL1	IGHJ5
TGTGCGAGAAACACGTCTTTAGGATATTGTAGTGGTGGTAGCTGCTACTTCCCGTACTACTTTGACTACTGG	CARNTSLGYCSGGSCYFPYYFDYW	IGHV5-10-1	IGHJ4
TGTGCGAGGGAATATATAGTGGCTACGATCCACCCCAACTCAATCCGTCCTGACTACTGG	CAREYIVATIHPNSIRPDYW	IGHV3-7	IGHJ4
TGTGCGAGAGCTTTGACTAAAGAGTACGGTGACTACCGTAGGGAGCTCATGGCGGCTGTGTTAGCATCGGTGCGGGTTGACTACTGG	CARALTKEYGDYRRELMAAVLASVRVDYW	IGHV3-7	IGHJ4
TGTGCGAAAGATTTGGTTACACGCTCTTTGATTACTATGATAGTAGTGGTCGCGGGGGTGTTTGACTACTGG	CAKDLVTRSLITMIVVVAGVFDYW	IGHV3-23	IGHJ4
TGTGCGAGGGCTTTGCCCTGTCCAGGATGGTTCAGGGAGTTAAAACTAGCCCCAAACTACTGG	CARALPCPGWFRELKLAPNYW	IGHV3-48	IGHJ4
TGTGCGAGAGATAGGTTACTTAGAGATGGCTACAATTTATACTACTTTGACTACTGG	CARDRLLRDGYNLYYFDYW	IGHV4-61	IGHJ4
TGTGCGAGGAAGGGGTGCGTGGCTGGTATATATGGATTCGGACCCTACTGG	CARKGCVAGIYGFGPYW	IGHV3-7	IGHJ4
TGTGCGAGAGGCCCATCCCATAGCAGCAGCTGGCCAGCCATGCTCTGGTTCGACCCCTGG	CARGPSHSSSWPAMLWFDPW	IGHV4-34	IGHJ5
TGTGCGAGACAAGTTGTACTGGTGGTGTATGCTATCCTCTTTGACTACTGG	CARQVVLVVYAILFDYW	IGHV7-4-1	IGHJ4
TGTACCACAGATGACCCCCGCCATATTGTGGTGGTGACTGGTCATTTTTACTGG	CTTDDPRHIVVVTGHFYW	IGHV3-15	IGHJ4
TGTGCGCCGGTCCTTACTATGATAGTAGTGGTTAGGCCGGGGCTTGACTACTGG	CAPVLTMIVVVRPGLDYW	IGHV1-46	IGHJ4
TGTGCGAGACTTCTCAAGTACTATGATAGTAGTGGTTATTACTACGCTGAATACTTCCAGCACTGG	CARLLKYYDSSGYYYAEYFQHW	IGHV4-59	IGHJ1
TGTGCGAGAGGCCCGTGGTGTCGTTACGATATTTTGACTGGTTATCAGTCCAGCCCCCCTAAAAGTTGG	CARGPWCRYDILTGYQSSPPKSW	IGHV3-53	IGHJ5
TGTGCGAAAGATCTAGGAGCAGTGGGAGCTACTACTAACCTAACCTACTGG	CAKDLGAVGATTNLTYW	IGHV3-NL1	IGHJ4
TGTGCGAGAGATCTCGCTAATGACTACGGTGACTACTCCTTGTCACTTGCTTCCCAGCCTGCTTTTGATATCTGG	CARDLANDYGDYSLSLASQPAFDIW	IGHV4-59	IGHJ3
TGTGCAAGAGATCCAAGGCCCGTACAGATGGTAGTACTAATGGTGTATGCTATACCCTACTTTGACTACTGG	CARDPRPVQMVVLMVYAIPYFDYW	IGHV3-13	IGHJ4
TGTGCGAGAGATCAGCTCAAGGGGACATGGGAAGAGGACTACTGG	CARDQLKGTWEEDYW	IGHV1-18	IGHJ4
TGTGCACGGAGTGGGATTTACTACTACTACTACTACATGGACGTCTGG	CARSGIYYYYYYMDVW	IGHV2-26	IGHJ6
