TGTGCGAGAGAGGATGACTACGGTGGTAACTCCCTCAGCTTTGACTACTGG	CAREDDYGGNSLSFDYW	IGHV1-2	IGHJ4
TGTGCAGTACATCCCGACATAGTATTACGATTTTTGGAGTGGTTATTATTTACCTACTACTACTACTACATGGACGTCTGG	CAVHPDIVLRFLEWLLFTYYYYYMDVW	IGHV3-74	IGHJ6
TGTGCGAGAGATCGAGGTCCTACGGTGACTACGATGTTTCATTTTGACTACTGG	CARDRGPTVTTMFHFDYW	IGHV3-53	IGHJ4
TGTGCGAGACATATGGGAACGGGGATACAGCTATGGTTCAGTGGGAATGCTTTTGATATCTGG	CARHMGTGIQLWFSGNAFDIW	IGHV5-51	IGHJ3
TGTGCGAGAGGCAGCTCGTCGGTATTTTCTATTGACTACTGG	CARGSSSVFSIDYW	IGHV3-66	IGHJ4
TGTGCGAAACCTTTCCGACCGGTGGATGAGCAGTGGCTGGTGTACTACTTTGACTACTGG	CAKPFRPVDEQWLVYYFDYW	IGHV3-23	IGHJ4
TGTGCGAGATTACTCCTGGAGGTGTATGCTATTTTAATTAAGTCTGACTACTGG	CARLLLEVYAILIKSDYW	IGHV4-38-2	IGHJ4
TGTGCGAGAGATGAAACACCTGGATCCATTGTAGTAGTACCAGCTGCTATATACCACCAGTTGTTTGACTACTGG	CARDETPGSIVVVPAAIYHQLFDYW	IGHV3-7	IGHJ4
TGTGCGAGACTTCGGACTGGTACGATAGCAGCAGCTGACCCAATTGACTACTGG	CARLRTGTIAAADPIDYW	IGHV5-51	IGHJ4
TGTGCGAGACATGTAGCAGCAGCTGGTGGTTGCCTCATGGATCGGTATGGCATCCCTTACTACTACTACATGGACGTCTGG	CARHVAAAGGCLMDRYGIPYYYYMDVW	IGHV4-39	IGHJ6
TGTGCGAAACCCAGAGTGCATCAGGTTGCTATACCCCCCTCGCGCGAGGGATACTACTACTACTACTACATGGACGTCTGG	CAKPRVHQVAIPPSREGYYYYYYMDVW	IGHV3-7	IGHJ6
TGTGCGAGAGCTGCCCGGCTGAGGATTGTAGTGGTGGTAGCTGCTACTCCGGGTCGGTACTACTACTACTACTACATGGACGTCTGG	CARAARLRIVVVVAATPGRYYYYYYMDVW	IGHV3-7	IGHJ6
TGTGCAAAAGATATCCAAGCCCTTAATTTTACTATGGTTCGGGGAAACTACTTTGACTACTGG	CAKDIQALNFTMVRGNYFDYW	IGHV3-43D	IGHJ4
TGTGCGAGAGAGCCCCTACGATATTTTGACTGGTTATTGGGCCTACCCAACTGGTTCGACCCCTGG	CAREPLRYFDWLLGLPNWFDPW	IGHV1-46	IGHJ5
TGTGCGAGAGTCCCCTATTACTATGATAGTAGTGGTTATATAATTTACTACTTTGACTACTGG	CARVPYYYDSSGYIIYYFDYW	IGHV3-7	IGHJ4
TGTGCGAGCCTCCTTGGGGGATATTGTAGTGGTGGTAGCTGCTACTCTGACTACTACTACTACATGGACGTCTGG	CASLLGGYCSGGSCYSDYYYYMDVW	IGHV4-39	IGHJ6
TGTGCGAGAGACGTTATAGTAGTGGTTGCCCCCTTTGACTACTGG	CARDVIVVVAPFDYW	IGHV3-53	IGHJ4
TGTGGCCGGAAACGTATTACGATTTTTGGAGTGGTTATTGTTGAGGGTGACATGGACGTCTGG	CGRKRITIFGVVIVEGDMDVW	IGHV7-4-1	IGHJ6
TGTGCGAGAGGTCCACCGGGAGATAGTAGTACCAGCTGCTTTGACTACTGG	CARGPPGDSSTSCFDYW	IGHV4-61	IGHJ4
TGTGCGAGCCGAGGATATTGTAGTAGTAGCCGTCGGCCAACTCGACCTGGGGAGGTACCCAAATACTACTACTACTACATGGACGTCTGG	CASRGYCSSSRRPTRPGEVPKYYYYYMDVW	IGHV4-34	IGHJ6
TGTGCGAGAGAAACCAGCCCCGGCCCTGACTACTGG	CARETSPGPDYW	IGHV3-11	IGHJ4
TGTGCAAGACCTGGCTGCTTTGGGGGGTATTGTGGTGGTGACTGCTTCTGG	CARPGCFGGYCGGDCFW	IGHV3-74	IGHJ5
TGTGCAATTATAGCAGTGGCTGGGGCGCACTGGTACTACTTTGACTACTGG	CAIIAVAGAHWYYFDYW	IGHV3-74	IGHJ4
TGTGCAAGAGATCAAAGAGGATATTGTACTGGTGGTGTATGCTATCCCCTTCTCTGGTACTTCGATCTCTGG	CARDQRGYCTGGVCYPLLWYFDLW	IGHV3-74	IGHJ2
TGTGCGAAACCGGGACCCCCGTATATTGTAGTGGTGGTAGCTGCTACCGAGCGGTTTGACTACTGG	CAKPGPPYIVVVVAATERFDYW	IGHV3-23	IGHJ4
TGTGCGAGAGCCTCCATCTTATCAGTGGTGGTAGCTGCTACACCTTTATACTACTACTACTACATGGACGTCTGG	CARASILSVVVAATPLYYYYYMDVW	IGHV1-69	IGHJ6
TGTGCACGGATACTGGGTAGTCCCAGGTTGCAATACTACTACTACTACATGGACGTCTGG	CARILGSPRLQYYYYYMDVW	IGHV2-26	IGHJ6
TGTGCAAGAGAGCCCGTACTGGTGGTGTATGCTGGACAGCAACGACTCGAGCTTGACTACTGG	CAREPVLVVYAGQQRLELDYW	IGHV1-45	IGHJ4
TGTGCAAGAGATGTGTTAAGCGTACCGGGTGACTACCCAGTTGACTACTGG	CARDVLSVPGDYPVDYW	IGHV3-13	IGHJ4
TGTGCGAGAGGTTGGTATTACGATATTTTGACTGGTTGCCCTTTTGACTACTGG	CARGWYYDILTGCPFDYW	IGHV3-53	IGHJ4
TGTGCGTTCGTGCCATATCGCCCGAGTATAGCAGCAGCTGCGAGGAACCACGCTGACTACTGG	CAFVPYRPSIAAAARNHADYW	IGHV1-18	IGHJ4
TGTGCGAGAGAATTACGTCAACGTGGATACAGCTATGGTTACGTATGGGAAAAGGGACACTTTGACTACTGG	CARELRQRGYSYGYVWEKGHFDYW	IGHV1-2	IGHJ4
TGTGGTTACCATCAGAAGGTGGTAGCTGCTACTCGGCCTGACTACTGG	CGYHQKVVAATRPDYW	IGHV3-30	IGHJ4
TGTGCGGGTAGATCATTTAAAAATGGAATTGTAGTGGTGGTAGCTGCTTCCGAACGGGAGACGTCTGACTACTGG	CAGRSFKNGIVVVVAASERETSDYW	IGHV3-30-3	IGHJ4
TGTGCAAGAGAACTCGGGGGTATAGCAGCAGACATTGACTACTGG	CARELGGIAADIDYW	IGHV6-1	IGHJ4
TGTGCGAAAACAATAGTATGGTTCAGGGAGTTATCGTTTGACTACTGG	CAKTIVWFRELSFDYW	IGHV3-NL1	IGHJ4
TGTGCGAGACGGGCTAGGCTAGCAGCTCGGGACATTGTGTACTACTACTACTACTACATGGACGTCTGG	CARRARLAARDIVYYYYYYMDVW	IGHV7-4-1	IGHJ6
TGTGCGAGCCTTTGTAGTAGTACCAGCTGCTATGTAAAAGCAATAGCTTTTGATATCTGG	CASLCSSTSCYVKAIAFDIW	IGHV3-21	IGHJ3
TGTGCGAGAGATGCCTTAGGTGACTACGACCAGGGGGCCCTCTCAAGGCGCAGGGTCCCGTATCCCTACCTGACGTACTTTGACTACTGG	CARDALGDYDQGALSRRRVPYPYLTYFDYW	IGHV3-53	IGHJ4
TGTGCAAGAGATGCCGGGCGTGCTAGAAGGGTAGTAGTACCAGCTGCTATGGGATGTCAGCAACTTGACTACTGG	CARDAGRARRVVVPAAMGCQQLDYW	IGHV3-13	IGHJ4
TGTGCGAGAGCGGGGGCAAGCTACAATTACGTCTCCCCTATAAGGAATCACGTAGATCCAAGGAGGCACTACTTTGACTACTGG	CARAGASYNYVSPIRNHVDPRRHYFDYW	IGHV1-46	IGHJ4
TGTGCGAGAGATCCTGATGCACGGCTTGTAGTACCAGCTGCTATAGGTGACAACCCCTGG	CARDPDARLVVPAAIGDNPW	IGHV1-69	IGHJ4
TGTGCGAGTGTTTGGGTATTACGATTTTTGGAGTGGTTATTATCTTTGCCCCCGCCTGGGTTCGACCCCTGG	CASVWVLRFLEWLLSLPPPGFDPW	IGHV3-7	IGHJ5
TGTGCGAGGGGAGGAATCCGGAGGGAACCGACGATTGTCGGGAATTACTGG	CARGGIRREPTIVGNYW	IGHV3-7	IGHJ4
TGTGCGAGAGAAATGCCCGGTATAGCAGCAGCTGGAGCAACGCCCCTGGGGAATGCTTTTGATATCTGG	CAREMPGIAAAGATPLGNAFDIW	IGHV3-21	IGHJ3
TGTGCGAGAGTGGGTATAGTGGCTACGATTTATGAAAGTTACTACTACTACTACTACATGGACGTCTGG	CARVGIVATIYESYYYYYYMDVW	IGHV5-10-1	IGHJ6
TGTGCGAGCCAGCAACTCCGAGGATATTGTAGTAGTACCAGCTGCTATGGGAAGAATTACTACTACTACTACATGGACGTCTGG	CASQQLRGYCSSTSCYGKNYYYYYMDVW	IGHV1-69	IGHJ6
TGTACTAGAGGGCCTAAACTAGGATATTGTAGTAGTACCAGCTGCCCGGCGAAGGGGGACCCCTACTACTACATGGACGTCTGG	CTRGPKLGYCSSTSCPAKGDPYYYMDVW	IGHV3-49	IGHJ6
TGTGCGCAAAGCAGGGGGAGGGCAGGACTATTACTATGGTTCGGGACCGCGAGAGGGAAACTAGTTGACTACTGG	CAQSRGRAGLLLWFGTARGKLVDYW	IGHV4-34	IGHJ4
TGTGCGAGAGATTCTCCAGTATTGTACTGGTGGTGTATGCTAGTAGGTTTGGAAACGTACTACTTTGACTACTGG	CARDSPVLYWWCMLVGLETYYFDYW	IGHV5-10-1	IGHJ4
TGTGCGAGAAGTTGCCATAATCAGTACCGCGGCCTCTACTGG	CARSCHNQYRGLYW	IGHV1-69	IGHJ4
TGTGCGAAAGACCCCGTATTACTATGGTTCAGGGAGTTATTATCGGAAAGCGTCAAATTTGCTGGGTACTACTACTACTACATGGACGTCTGG	CAKDPVLLWFRELLSESVKFAGYYYYYMDVW	IGHV3-NL1	IGHJ6
TGTGCAAGAGCTGGGGTGGTGATAGTCATCTTTGACTACTGG	CARAGVVIVIFDYW	IGHV6-1	IGHJ4
TGTACCCCGCAGCGCGGGGTCGATTACTATGGTTCAGGGAGTTATTATAATTACGCCTTTGACTACTGG	CTPQRGVDYYGSGSYYNYAFDYW	IGHV3-15	IGHJ4
TGTGCAAGAGCCGTACGATATTTTGACTGGGAGTGCGAAGGGGAGTTGTACAACTGGTTCGACCCCTGG	CARAVRYFDWECEGELYNWFDPW	IGHV3-13	IGHJ5
TGTGCGAGAGCCCCCCATGCGAGACGTATAGTGGGAGATTCGGTAAGAAGCTCCTTTGACTACTGG	CARAPHARRIVGDSVRSSFDYW	IGHV1-2	IGHJ4
TGTACTAGAGCGCAGGGAGGTACTATGGTTCAGGGAGTTATTACGAACTATGATGCTTTTGATATCTGG	CTRAQGGTMVQGVITNYDAFDIW	IGHV3-73	IGHJ3
TGTACTAGAGGTGGTGGTAGCTGCTACTCACGCCTAGTCCATCACAATGACAACTGGTTCGACCCCTGG	CTRGGGSCYSRLVHHNDNWFDPW	IGHV3-49	IGHJ5
TGTGCGAGACTCCTAGGGGGGGTGGTAGCTGCTACTCCCACCCATTACTTTGACTACTGG	CARLLGGVVAATPTHYFDYW	IGHV4-38-2	IGHJ4
TGTGCGAGAGGGAATTACGATATTTTGACTGGTTATTATGGGCCGTCGAAAATTAACTTTGACTACTGG	CARGNYDILTGYYGPSKINFDYW	IGHV3-20	IGHJ4
TGTGCGAGAGATAGGATAGCAGTGGCTGGTACGAGTCTCCACTGGTTCGACCCCTGG	CARDRIAVAGTSLHWFDPW	IGHV3-64	IGHJ5
TGTGCGAGAGATCTCCTGCAGCACGGTACGTGGAGTGGTTATTTGGGGGAGGAGGTCGACCCCTGG	CARDLLQHGTWSGYLGEEVDPW	IGHV4-61	IGHJ5
TGTGCGAAAGATAAACTTGCATCGAAATTACTATGGTTCAGGGAGAGCGATGATGCTTTTGATATCTGG	CAKDKLASKLLWFRESDDAFDIW	IGHV3-NL1	IGHJ3
TGTGCGAGAGATCAAATGGTTGACTACGGTGACTACTACTGG	CARDQMVDYGDYYW	IGHV1-3	IGHJ4
TGTGCGAGAGCCTCCGTGGCTGGTATACGCTACTTTGACTACTGG	CARASVAGIRYFDYW	IGHV3-30	IGHJ4
TGTGCGAGAGTGTATTACGATTTTTGGAGTGGTTATTATAGCTCGGGGAACTACTACTACTACTACATGGACGTCTGG	CARVYYDFWSGYYSSGNYYYYYMDVW	IGHV5-10-1	IGHJ6
TGTGCGAGAGATCGTATTACTATGGTTCAGGGAGTTATTTTGAACCCCAACTACTACTACTACTACATGGACGTCTGG	CARDRITMVQGVILNPNYYYYYMDVW	IGHV3-7	IGHJ6
TGTGCGAGAGGCCGGGTTGTAGTAGTACCAGCTGCTATGCCATTCTACTACTACTACTACATGGACGTCTGG	CARGRVVVVPAAMPFYYYYYMDVW	IGHV4-34	IGHJ6
TGTGCGAGAACCCTCGGGACCACCGGATATTGTACTGGTGGTGTATGCTATAGGTACTTTGACTACTGG	CARTLGTTGYCTGGVCYRYFDYW	IGHV1-46	IGHJ4
TGTGCGAGACCAATGGGGTTAGCATATTGTGGTGGTGACTGCTTAATTTGGGAGACTAACCCGCGGTTCGACCCCTGG	CARPMGLAYCGGDCLIWETNPRFDPW	IGHV4-39	IGHJ5
TGTGCGAAAGATAAGATTGTAGTGGTGGTAGCTGCTACTCCCAGGAACCGGGAGGTGGACTTTGACTACTGG	CAKDKIVVVVAATPRNREVDFDYW	IGHV3-NL1	IGHJ4
TGTGCTGTGAGAAAGCGGGCATTATGGAGTAGTACCAGCTGCTATGTGAAATACAACTGGTTCGACCCCTGG	CAVRKRALWSSTSCYVKYNWFDPW	IGHV5-10-1	IGHJ5
TGTGCGAGTCACGTGGCAGCTGCTATGGTTGTTTGTTTTCGAAGAACAGGCCTCAAAGGTGACTACTGG	CASHVAAAMVVCFRRTGLKGDYW	IGHV3-7	IGHJ4
TGTGCGAGAGAGTTATGGAGTATAGCAGCAGCTGGTACTCGAGTGTACTACTTTGACTACTGG	CARELWSIAAAGTRVYYFDYW	IGHV1-2	IGHJ4
TGTGCGAGAGATCTGGCCAACACGCCCATACGATTTTTGGAGTGGTTATTAGGTCACAACTACTACTACTACATGGACGTCTGG	CARDLANTPIRFLEWLLGHNYYYYMDVW	IGHV4-61	IGHJ6
TGTGCGAAAATAGTATTACGATTTTTGGAGTGGCCAACCGCCACACGGGGCTTTGTCATGCCAGCCCACCACTACTACTACTACATGGACGTCTGG	CAKIVLRFLEWPTATRGFVMPAHHYYYYMDVW	IGHV3-23	IGHJ6
TGTGCACACAAAAGGGAACTAGCCTGCGCGTGGATACAGCTAGGAATCTACCGTGACTACTGG	CAHKRELACAWIQLGIYRDYW	IGHV2-5	IGHJ4
TGTACTAGAGATTTATATTGTAGTAGTTCCCCGCCCGGGAGGATTGACTACTGG	CTRDLYCSSSPPGRIDYW	IGHV3-49	IGHJ4
TGTGCACACAGACTGGATAGGGGACACCGGCGTATCTATAGCAGTGGCTGGCTGGTATACTTCCAGCACTGG	CAHRLDRGHRRIYSSGWLVYFQHW	IGHV2-5	IGHJ1
TGTGCGAGAGATCGGGAATCGTTCAGACTACGGACTGAAAGGGCTGAATACTTCCAGCACTGG	CARDRESFRLRTERAEYFQHW	IGHV3-53	IGHJ1
TGTGCGAGTTCTTATGGTCTCCGCACTGGTGGTGTATGCTATAAGCTATCGCTCCACGCCGGCGCCGCCCACTACTACTACATGGACGTCTGG	CASSYGLRTGGVCYKLSLHAGAAHYYYMDVW	IGHV4-34	IGHJ6
TGTGCGAGAGATCCGGACATTGTAGTAGTACCAGCCGGTAGGTACTACTACTACTACATGGACGTCTGG	CARDPDIVVVPAGRYYYYYMDVW	IGHV1-3	IGHJ6
TGTGCGAGACTGGGAGGACCCTCCGGGCTAACTGGAACTACGGGGGGAACCTACTGG	CARLGGPSGLTGTTGGTYW	IGHV4-34	IGHJ4
TGTGCGAAAGAGAGCCTTTATTACGATATTTTGACTGGTTATTACATTGACTACTGG	CAKESLYYDILTGYYIDYW	IGHV3-NL1	IGHJ4
TGTGCGAAAGATCGAGCAAACTGCGGGTACGGTGACACGAGACTCTGGTTCGACCCCTGG	CAKDRANCGYGDTRLWFDPW	IGHV3-23	IGHJ5
TGTGCGAGAGAGCCCCGAGGGATTACGTTTGGGGGAGTTATCGTGTGTTACACGAACAGCGCCTGGTACTGG	CAREPRGITFGGVIVCYTNSAWYW	IGHV1-69	IGHJ4
TGTGCGAGAGATTGCCCTCCCTTACGAGTTATGCGCCTAGGGATTACGATTTTTGGAGTGGTTATTAGCTTGACGACACGCCCTTACTACATGGACGTCTGG	CARDCPPLRVMRLGITIFGVVISLTTRPYYMDVW	IGHV3-30	IGHJ6
TGTACTAGACATGTGCGCACACAAATTACTATGGTTCAGGGAGTTATTATAAGGTCGTTCCTCTACTACTACTACTACATGGACGTCTGG	CTRHVRTQITMVQGVIIRSFLYYYYYMDVW	IGHV3-73	IGHJ6
TGTGCGAGATCCCTAGTAGTAGAGCAAATGCTACATGATGCTTTTGATATCTGG	CARSLVVEQMLHDAFDIW	IGHV7-4-1	IGHJ3
TGTGCGAGAGAGGGGGAGGTGCAGTGGCCCTATGTGGTGGGGGCTTTTGATATCTGG	CAREGEVQWPYVVGAFDIW	IGHV1-18	IGHJ3
TGTGCGAAAGATTTCTGGGTTTCGAGTATAGCAGCTCATGCCAAATACTGG	CAKDFWVSSIAAHAKYW	IGHV3-23	IGHJ4
TGTGCGAGAGATGTTTTCTTATTACGATTTTTGGAGTGGTCCGGCCATAGAAAGGCTCCGAACCTATGG	CARDVFLLRFLEWSGHRKAPNLW	IGHV3-21	IGHJ4
TGTGCACACAGAAAGAGAGTAACTACGGTTAACTGGTTCGACCCCTGG	CAHRKRVTTVNWFDPW	IGHV2-5	IGHJ5
TGTGCGAGCCCGGCTATTGTAGTAGTACCAGCTGCTGGGCCGAGAGATGTGCACAACTGGTTCGACCCCTGG	CASPAIVVVPAAGPRDVHNWFDPW	IGHV7-4-1	IGHJ5
TGTGCGAGAGATCACAAGGAGAGTGGTTATTACCGGGCAAAGGACTACTTTGACTACTGG	CARDHKESGYYRAKDYFDYW	IGHV1-2	IGHJ4
TGTGCGAGGCCAATGGGAGCTACTACGTGGGGGTACTTTGACTACTGG	CARPMGATTWGYFDYW	IGHV4-38-2	IGHJ4
TGTACTACGATGTATTACGATTTTTGGAGTGGTCCAACAATGGATGCTTTTGATATCTGG	CTTMYYDFWSGPTMDAFDIW	IGHV3-73	IGHJ3
TGTGCGAGCACCGGGTTAGCAGTGGCTGAAAATGATTACTACTACTACTACTACATGGACGTCTGG	CASTGLAVAENDYYYYYYMDVW	IGHV4-38-2	IGHJ6
TGTGCGAGAGATCTGTTACGATTTTTGGAGTGGTTACGTAGATTTGACTACTGG	CARDLLRFLEWLRRFDYW	IGHV1-3	IGHJ4
TGTGCGAGACATGATACCGGGGGGACTACGTCACCCTGG	CARHDTGGTTSPW	IGHV1-46	IGHJ4
