TGTGCGAGAGGCAGGGGAGGATTACGATTACCGGCTCACTACTTTGACTACTGG	CARGRGGLRLPAHYFDYW	IGHV4-34	IGHJ4
TGTGCAAAAGATATAATTTGCCGAGGGGTTACCAGCTGCTATAGCCCCAAATACTACTACTACTACTACATGGACGTCTGG	CAKDIICRGVTSCYSPKYYYYYYMDVW	IGHV3-43D	IGHJ6
TGTGCGAACCCCGGGAAGGTTAACGGAAATTGTAGTAGTACCAGCTGCTATGTGTTTGACTACTGG	CANPGKVNGNCSSTSCYVFDYW	IGHV1-46	IGHJ4
TGTGCGAGTCCGTATTACTATGATAGTAGTGGTGTTTCTATCTTTGACTACTGG	CASPYYYDSSGVSIFDYW	IGHV4-4	IGHJ4
TGTGCGAGAGATGCCAAAGGGCCGATTGTAGTAGTACCAGCTGCTAGTTACTACTACTACATGGACGTCTGG	CARDAKGPIVVVPAASYYYYMDVW	IGHV3-53	IGHJ6
TGTGCGAGATCCCAAGCAGTGGCTGGTACAACCTACTTTGACTACTGG	CARSQAVAGTTYFDYW	IGHV1-18	IGHJ4
TGTGCGAGAGGCTTTACCACTGGAACGACTCCTGATGCTTTTGATATCTGG	CARGFTTGTTPDAFDIW	IGHV4-34	IGHJ3
TGTACTAGACACACGTATTACTATGGTTCAGGGAGTTATTGCTACTACTACTACTACATGGACGTCTGG	CTRHTYYYGSGSYCYYYYYMDVW	IGHV3-73	IGHJ6
TGCCTTACTGGTGGTGTTAACTACATGGACGTCTGG	CLTGGVNYMDVW	IGHV3-53	IGHJ6
TGTGCGAAAGTGCCGTATTGTAGTGGTGGTAGCTGCTACAACTACTTTGACTACTGG	CAKVPYCSGGSCYNYFDYW	IGHV3-23	IGHJ4
TGTGCAAGAGATGCTCACCTTATGTATAGCAGCAGCTGGCGGGAAAACTGGTTCGACCCCTGG	CARDAHLMYSSSWRENWFDPW	IGHV3-13	IGHJ5
TGTGCGAACCCAGCCGGGTATAGCAGCAGCGACCCACACCTTGACTACTGG	CANPAGYSSSDPHLDYW	IGHV3-23	IGHJ4
TGTACCACAGCTAATCAGTTACGATTTTTGGCGCCACCGGCCATGGACGTCTGG	CTTANQLRFLAPPAMDVW	IGHV3-15	IGHJ6
TGTGCGAGCCGGGACCTTATAGCAGCAGCTGGTATGGGAGGCTACTACATGGACGTCTGG	CASRDLIAAAGMGGYYMDVW	IGHV4-4	IGHJ6
TGTGCGAGACATATCGGCGGATATTGTAGTAGTACCAGCTGCATTAATTGGTTCGACCCCTGG	CARHIGGYCSSTSCINWFDPW	IGHV5-51	IGHJ5
TGTGCGACTCATAGTGGCTACGATTATGATGCTTTTGATATCTGG	CATHSGYDYDAFDIW	IGHV3-30-3	IGHJ3
TGTGCGAGAGCGAGTACCGATACCAGCTGCTTGAAAATTTTTAGGTACTTTGACTACTGG	CARASTDTSCLKIFRYFDYW	IGHV1-69	IGHJ4
TGTGCGAGAGCCAAGTTTCCGGAGGGTCAACAGCAGACCTGG	CARAKFPEGQQQTW	IGHV3-53	IGHJ4
TGTGCGAGAGATCTCGGATACGATTTTTGGAGTGTCGGGGTAGGCCACCCCCCGGACTACTGG	CARDLGYDFWSVGVGHPPDYW	IGHV1-2	IGHJ4
TGTGCGAGCTTGTTTCGGGGGGTGACTCTGGCTGACTACTGG	CASLFRGVTLADYW	IGHV3-21	IGHJ4
TGTGCGAGAGATCAAGACACGAAGTATTGTGGTGTCTACTGG	CARDQDTKYCGVYW	IGHV3-7	IGHJ4
TGTGCGAGAGCGGATTACTATGGTTCAGGGAGTTATTATAACCCCGTCACATATTACTACTACTACTACTACATGGACGTCTGG	CARADYYGSGSYYNPVTYYYYYYYMDVW	IGHV1-69	IGHJ6
TGTGCGAGAGATATACTCTTGCGTGACTATTCCGGCTCCACTCAAGCAGGAAACGTTGACTACTGG	CARDILLRDYSGSTQAGNVDYW	IGHV3-53	IGHJ4
TGTGCGAGAGCCCCCCCGGCATATTGTGGTGGTGACTGCTATGGGGGGCTCTTTGACTACTGG	CARAPPAYCGGDCYGGLFDYW	IGHV4-34	IGHJ4
TGTACTAGCGTAGAGGTAGGATATTGTAGTAGTACCAGCAAGGATATCAACTGGTTCGACCCCTGG	CTSVEVGYCSSTSKDINWFDPW	IGHV3-49	IGHJ5
TGTGCGAGAGAGTATTATGATTACATTTGGGGGAGTTTTCCACTCTGG	CAREYYDYIWGSFPLW	IGHV4-39	IGHJ5
TGTACCACAGATTTAGATAGCCCATCGCGAGCCCGGTACGGTGACTATTTTGACTACTGG	CTTDLDSPSRARYGDYFDYW	IGHV3-15	IGHJ4
TGTGCAAGAGATATAGTGGCCAGAATCACGATTGACTACTGG	CARDIVARITIDYW	IGHV3-13	IGHJ4
TGTGCGAAAGAAAGGAACTATGATAGTAGTGGGAGCCTATACTTTGACTACTGG	CAKERNYDSSGSLYFDYW	IGHV3-NL1	IGHJ4
TGTGCGACTCCATTAGCAGCTCGTCTCAGAGGAAAGCACTTTGACTACTGG	CATPLAARLRGKHFDYW	IGHV3-30	IGHJ4
TGTGCGAAAGCCCCACCCGAGATTGGTATTACGATTTTTGGAGTGGGGGGGCCCCCGTGGTTCGACCCCTGG	CAKAPPEIGITIFGVGGPPWFDPW	IGHV3-23	IGHJ5
TGTGCGAGACAGAGGGCCCTACCCTTCGATATTGTAGTAGTACCAGCTGCTAGACCGAACGGATACTACTACTACTACATGGACGTCTGG	CARQRALPFDIVVVPAARPNGYYYYYMDVW	IGHV5-51	IGHJ6
TGTGCGCCCTGGCCTTCTATTGAGAAACCCCGAGGGGGTGAAAACTTTGACTACTGG	CAPWPSIEKPRGGENFDYW	IGHV1-18	IGHJ4
TGTGCGAGACCGCGGCCCGCATTTACTATGATAGTAGTGGTTATCCCCTACTGG	CARPRPAFTMIVVVIPYW	IGHV4-39	IGHJ4
TGTGCGAGAGCGTCCGGGCACGTACCCTATAGCAGTGGCTGGTACGTGGGGTTGCCGAACTACTACTACTACTACATGGACGTCTGG	CARASGHVPYSSGWYVGLPNYYYYYMDVW	IGHV3-11	IGHJ6
TGTGCAAGAGATCCGGGGCCCCCCGTTCGCTTTTCCCGCCAAATTACGATTTTTGGATCCTACTACTTTGACTACTGG	CARDPGPPVRFSRQITIFGSYYFDYW	IGHV3-13	IGHJ4
TGTGCGAGACCCTCTAATCCCGAGGAAGCCCCGAGACTAGCCGCCTATTACTATGATAGTAGTGGACTCTACTGG	CARPSNPEEAPRLAAYYYDSSGLYW	IGHV7-4-1	IGHJ4
TGTTCAGGTGGGTATTACTATGGTTCAGGGAGTGTTGTCCAGAGGCGGTACTACTACTACTACTACATGGACGTCTGG	CSGGYYYGSGSVVQRRYYYYYYMDVW	IGHV1-46	IGHJ6
TGTGCGAGAGTGAAGGGAGAAAACTATATTGTAGTGGTGGTAGCTGCTATTAACTGGTTCGACCCCTGG	CARVKGENYIVVVVAAINWFDPW	IGHV1-2	IGHJ5
TGTGCGAGAGATCTGGGCGAGTTCATGCTTCCTATAGCAGCTCGTCTACCCGAATTTGACTACTGG	CARDLGEFMLPIAARLPEFDYW	IGHV4-61	IGHJ4
TGTGCGAGACCTGGATATTGTAGTGGTGGTAGCTGCTATTCCGCCCCGCATTGGTACTACTACTACTACTACATGGACGTCTGG	CARPGYCSGGSCYSAPHWYYYYYYMDVW	IGHV1-3	IGHJ6
TGTGCGAGAGGAAGTGGATATAGTGGCTACAACAACTACTACTACTACATGGACGTCTGG	CARGSGYSGYNNYYYYMDVW	IGHV1-2	IGHJ6
TGTGCGAAAGCCAACGCCAGACAGTGGCTGGTACGAGGGTTCTACTGG	CAKANARQWLVRGFYW	IGHV3-23	IGHJ4
TGTGCGAAAGATCAAATGGTAGCAGTGGCTGGCCCCTTTTTAATCAGTTACTACTACTACTACTACATGGACGTCTGG	CAKDQMVAVAGPFLISYYYYYYMDVW	IGHV3-NL1	IGHJ6
TGTACCCCGACGACTACAGTAACTACGGTTGACTACTGG	CTPTTTVTTVDYW	IGHV3-9	IGHJ4
TGTACCACAGATAGTATAGCAGCAGCTGGTACCTGGTTCGACCCCTGG	CTTDSIAAAGTWFDPW	IGHV3-15	IGHJ5
TGTGCGAAACCAGTAAAGGTATATTGTAGTAGTACCAGCCGCTCATACTGGTTCGACCCCTGG	CAKPVKVYCSSTSRSYWFDPW	IGHV3-23	IGHJ5
TGTGCAAAAGATATGCGAGGGGGAGGTGTAGTAGTACCAGCTGCCAACTACTACTACTACTACTACATGGACGTCTGG	CAKDMRGGGVVVPAANYYYYYYMDVW	IGHV3-43D	IGHJ6
TGTGCGAAAATTATTACTATGATAGTAGTGGTTATTAACTCCGACTACTGG	CAKIITMIVVVINSDYW	IGHV3-7	IGHJ4
TGTGCGAGTACGATTCCAACTGGAACGACCCACGTTAATTACTACTACTACTACTACATGGACGTCTGG	CASTIPTGTTHVNYYYYYYMDVW	IGHV1-69	IGHJ6
TGTACCACAGAACGGAGCAGCTCGGGGAAAATGGTGGAGGCAGGTGTTGACTACTGG	CTTERSSSGKMVEAGVDYW	IGHV3-15	IGHJ4
TGTGCCCCGGTAAACGGCCTAGTAGTACCAGCTGCTAACTTCCCGAGAATCTGGTTCGACCCCTGG	CAPVNGLVVPAANFPRIWFDPW	IGHV7-4-1	IGHJ5
TGTGCGAGAGTTGGATACTACTTTGACTACTGG	CARVGYYFDYW	IGHV3-7	IGHJ4
TGTGCAAGAGATTCTATGGTGGTAGCTGCCCCTCCATTTGACTACTGG	CARDSMVVAAPPFDYW	IGHV3-13	IGHJ4
TGTGCGAAAGGCCTTGTTGTAGTGGTGGTAGCTGCGCGAATGGATTACTACTACTACTACTACATGGACGTCTGG	CAKGLVVVVVAARMDYYYYYYMDVW	IGHV4-38-2	IGHJ6
TGTGCGAGAGTTGGGGTACATCGGAGACATGAATATTGTAGTAGTACCAGCTGCTATTTATCCGCAGCGCCCGGGTACTACTACTACTACATGGACGTCTGG	CARVGVHRRHEYCSSTSCYLSAAPGYYYYYMDVW	IGHV1-8	IGHJ6
TGTATACGAAAGTCCTACGGTGACTACGTCATTGACTACTGG	CIRKSYGDYVIDYW	IGHV3-13	IGHJ4
TGTGGAGGTATTGTAGTAGTACCAGCTGCTACCGGCGACTACTACTACTACTACATGGACGTCTGG	CGGIVVVPAATGDYYYYYMDVW	IGHV1-8	IGHJ6
TGTTGGATGAAAGGAGACTACTGG	CWMKGDYW	IGHV3-7	IGHJ4
TGTGCGAGCCAGGATTATGATTACGTTTGGGGGAGTTATCGTTTGCGTCGCCGAGGATCGGAAACTGTCAACTGGTTCGACCCCTGG	CASQDYDYVWGSYRLRRRGSETVNWFDPW	IGHV3-21	IGHJ5
TGTGCGAAGTATCGGGTAATCCATATTGTACTGGTGGTGTATGCTATAGAGTACTACTACTACTACATGGACGTCTGG	CAKYRVIHIVLVVYAIEYYYYYMDVW	IGHV3-NL1	IGHJ6
TGTGCGAAACAGAACTTATTACGATATTTTGACTGGTTATTATGGTGGGGCTGG	CAKQNLLRYFDWLLWWGW	IGHV3-23	IGHJ4
TGTGCGAAAATGGAGGTGGATATTGTAGTAGTACCAGCTGCTAGCTTGCCGGGTTTGCGGATGATCGACTACTACTACTACTACATGGACGTCTGG	CAKMEVDIVVVPAASLPGLRMIDYYYYYMDVW	IGHV3-23	IGHJ6
TGTGCGAGAGATCAGGTGGTCATGCGGGAAGGGGGTCGTTACTACTTTGACTACTGG	CARDQVVMREGGRYYFDYW	IGHV3-11	IGHJ4
TGTGCAAGACCCTGCATTACACATATGCCAGGGAGAAGACTCAGCAGTGGCTGGTACGCTCTGGGTCTTGTTGGGTACTTCGATCTCTGG	CARPCITHMPGRRLSSGWYALGLVGYFDLW	IGHV1-45	IGHJ2
TGTGCGCCCAAGGGAACCCCGGCGACAGAACACCCCAGACCTTGCTTTTTGGAGTGGTTAGCTACGAACTGGTTCGACCCCTGG	CAPKGTPATEHPRPCFLEWLATNWFDPW	IGHV1-46	IGHJ5
TGTGCGAGAAGGGGACTAGCATATTGTGGTGGTGACTGCTATTCGAGAAACTACTGG	CARRGLAYCGGDCYSRNYW	IGHV1-3	IGHJ4
TGTGCGAAGCGGGTTCGTTCCGGCCCTATTGTACTGGTGGTGTATGCTGCGCCTGGACCATTCTGGTTCGACCCCTGG	CAKRVRSGPIVLVVYAAPGPFWFDPW	IGHV3-NL1	IGHJ5
TGTGCGAGGCGTTTTGACTGGTTATTGGGGCACTGG	CARRFDWLLGHW	IGHV3-30	IGHJ4
TGTGCGAAAGAACGTTGTGTCTACTATGGTTCAGGGACAACTGCTTGGAATCTGGCCCGAGAGACCCCCGGGTTGCAGTTATGGTCCCTCTGG	CAKERCVYYGSGTTAWNLARETPGLQLWSLW	IGHV3-NL1	IGHJ3
TGTGCGAAAGAGAGTAGCTGCTCCGACTACTGG	CAKESSCSDYW	IGHV3-23	IGHJ4
TGTGCGATCTCCCCCTGGCGATATTGTAGTGGTGGTAGCTGCGGCACAGATGCTTTTGATATCTGG	CAISPWRYCSGGSCGTDAFDIW	IGHV1-46	IGHJ3
TGTACCACAGTGGTGAGCGCTAATTCTCTTGACCAGGAGGGTAGCTGCCCCGGTGCCTGG	CTTVVSANSLDQEGSCPGAW	IGHV3-15	IGHJ5
TGTGCGAGTTTAGGGACGATTTTTGGAGTGGTTATTATAGTCCCCTGG	CASLGTIFGVVIIVPW	IGHV3-30	IGHJ5
TGTGCGAGACGGCTTACGCAACACATAACTGGAACTTACTTGGTGTTTGACTACTGG	CARRLTQHITGTYLVFDYW	IGHV1-46	IGHJ4
TGTGCGAGCCCGGTCTCTGCGTTAGGTCAAATGAAGTACTACTGG	CASPVSALGQMKYYW	IGHV1-46	IGHJ4
TGTGCGAAAGACCTCTCCTTTGGAGTGGTTAGAATCTACTACTACTACATGGACGTCTGG	CAKDLSFGVVRIYYYYMDVW	IGHV3-23	IGHJ6
TGTGCACACAGTAGCTTCGACTACGGTGACCCTTACTTTGACTACTGG	CAHSSFDYGDPYFDYW	IGHV2-5	IGHJ4
TGTGCGAGACCCCTGGACGTATTACTATGGTTCAGGGAGTTATATAGCGGCTGG	CARPLDVLLWFRELYSGW	IGHV1-69	IGHJ4
TGTGCGAAAGATCGAGATATTGTAGTGGTGGTAGCTGCTACAGACTACTGG	CAKDRDIVVVVAATDYW	IGHV3-23	IGHJ4
TGTGCAAGGTATGTCCGTATTACTATGATAGTAGTGGTTAGAGAGGGTGCTTTTGATATCTGG	CARYVRITMIVVVREGAFDIW	IGHV3-74	IGHJ3
TGTGCGAGAGATCAAATTGTAGTGGTGGTAGCTGCTACTCCATTTTACTACATGGACGTCTGG	CARDQIVVVVAATPFYYMDVW	IGHV3-53	IGHJ6
TGTGCGAGTCGGTCGGCCAAAGGTTTTGTGAATAGCAGCAGCTGGTACTTTGACTACTGG	CASRSAKGFVNSSSWYFDYW	IGHV3-7	IGHJ4
TGTGCGAGAGAAAAAAATCCAGACGTATTACTATGGTTCAGGGTTGCGGAAAATTACTACTACTACTACTACATGGACGTCTGG	CAREKNPDVLLWFRVAENYYYYYYMDVW	IGHV1-2	IGHJ6
TGTGCGAAACTTTACGATTTTTGGAGTGGTTATTTTTACTACTACTACTACATGGACGTCTGG	CAKLYDFWSGYFYYYYYMDVW	IGHV3-23	IGHJ6
TGTGCGAGAGATGTGATTACTATGGTTCAGGGAGTTATTATAGGGGAGGACTTTGACTACTGG	CARDVITMVQGVIIGEDFDYW	IGHV3-30	IGHJ4
TGTAGCTACTGG	CSYW	IGHV3-30-3	IGHJ4
TGTGCGAAGTGCCCGACTTACATTACTATGATAGTAGTGGTTTTTTCAGACTACTGG	CAKCPTYITMIVVVFSDYW	IGHV7-4-1	IGHJ4
TGTACTAGAGATGTACCGATAGCAGTGGCTGGTACGAGCGAGGAATTTCTTAACTGGTTCGACCCCTGG	CTRDVPIAVAGTSEEFLNWFDPW	IGHV3-49	IGHJ5
TGTGCGAGGTCCTGCCCGTGGCTACTTCCGGCAAGGGTTGACTACTGG	CARSCPWLLPARVDYW	IGHV1-3	IGHJ4
TGTGCGAGACGATCATGGCCAAATTCCGGAGTGCCTACCTGGTACCAGCTGCTATGCCGGTGGTTCGACCCCTGG	CARRSWPNSGVPTWYQLLCRWFDPW	IGHV1-18	IGHJ5
TGTGCGAAAGATAGGCCGGAGTCCATTTCAGTACCAGCTGCCCCATATTACTACTACTACTACTACATGGACGTCTGG	CAKDRPESISVPAAPYYYYYYYMDVW	IGHV3-23	IGHJ6
TGTGCGAGCTATGGTTCAGGGAGGCACTTTGACTACTGG	CASYGSGRHFDYW	IGHV3-21	IGHJ4
TGTGCGAGAGATGTGGGTCTGCTGCTAGTACCAGCTGCTATACTCCACTTTGACTACTGG	CARDVGLLLVPAAILHFDYW	IGHV3-11	IGHJ4
TGTGCGAGGGCGGTAGTACCAGCTGCTATTTTTGCCTATAGAGGACCCCCTAATTTCCCCCGACCCTACATGGACGTCTGG	CARAVVPAAIFAYRGPPNFPRPYMDVW	IGHV4-34	IGHJ6
TGTGCAAGAGCATACGCCATTGGTATTACTATGATAGTAGTGGGCTGTGATGCTTTTGATATCTGG	CARAYAIGITMIVVGCDAFDIW	IGHV3-13	IGHJ3
TGTGCAAGAGTCTGCATGCAGGGTCCCTACGGTGACGGTGTTGACTACTGG	CARVCMQGPYGDGVDYW	IGHV3-13	IGHJ4
TGTGCGAGCGGATCCTCCTCGTATTACTATGATAGTAGTGGTTATTACAATCTTAGGTACTTCGATCTCTGG	CASGSSSYYYDSSGYYNLRYFDLW	IGHV1-2	IGHJ2
TGTGCGAGGCGGTCTACCCCCTGTAGTGGTGGTAGCTGCTACTCACACTACTACTACTACTACATGGACGTCTGG	CARRSTPCSGGSCYSHYYYYYMDVW	IGHV4-59	IGHJ6
TGTGCGAGACATGGTCAGTTTCATTGTAGCAGTGGCTGGCATGTGCATTCATCCTTTGACTACTGG	CARHGQFHCSSGWHVHSSFDYW	IGHV5-51	IGHJ4
