TGTGCGAGCCGGTGTACGCAGCAGCTGCCCTTGTTCGACCCCTGG	CASRCTQQLPLFDPW	IGHV3-21	IGHJ5
TGTGCGATGGGCATTCCCTCAAGCAAGGTCATCAACTGGTTCGACCCCTGG	CAMGIPSSKVINWFDPW	IGHV3-30	IGHJ5
TGTGCGAGAGTGGACTTCTTGATTACATTTGGGGGAGTTATCGTTATTTTTGACTACTGG	CARVDFLITFGGVIVIFDYW	IGHV4-34	IGHJ4
TGTGCGAGACCCGTGGCTACGTATCCTTTAGTGTACTACTACTACTACTACATGGACGTCTGG	CARPVATYPLVYYYYYYMDVW	IGHV5-51	IGHJ6
TGTGCGAGATGGGACGCCGGGGGGATCGCGTTGGGTCTAGGATATTGTAGTAGTACCAGCTGCCACTGCTTTGACTACTGG	CARWDAGGIALGLGYCSSTSCHCFDYW	IGHV5-10-1	IGHJ4
TGTGCGAGAGAGGTCGCTGGAGCTGCTATGCCGGTGGGCAACTGGTTCGACCCCTGG	CAREVAGAAMPVGNWFDPW	IGHV1-2	IGHJ5
TGTGCACGGATAGGACCGATGGCGTATTACGATATTTTGACTGGCCCCTACTTTGACTACTGG	CARIGPMAYYDILTGPYFDYW	IGHV2-26	IGHJ4
TGTGCGAAAGATTCGACGTATGGTTCGGAGGGCTACTGG	CAKDSTYGSEGYW	IGHV3-NL1	IGHJ4
TGTGCGAGAGACCCACGTAGTGGTGGTAGCTGCTACGCAAACTTTGACTACTGG	CARDPRSGGSCYANFDYW	IGHV3-30	IGHJ4
TGTGCGAGAGATCCCGCGTTATTGTACTGGTGGTGTATGCTATCGAATCCCCCGGGACTGGGGTATATTCTTGACTACTGG	CARDPALLYWWCMLSNPPGLGYILDYW	IGHV4-61	IGHJ4
TGTGCGAGAATTGTAGTAGTACCAGCTGCTATATTCTATCGCCTAAATAGCTACTACTACTACTACATGGACGTCTGG	CARIVVVPAAIFYRLNSYYYYYMDVW	IGHV1-2	IGHJ6
TGTGCGAAAGATCTCCTAATCATAACTGGAACTACTTCAATCCTCCAAAGGCCCTACTACTACTACATGGACGTCTGG	CAKDLLIITGTTSILQRPYYYYMDVW	IGHV3-23	IGHJ6
TGTGCGAGCCTCGATGTAGTGGTGGTAGCTGCTACCGTGGACTGGTTCGACCCCTGG	CASLDVVVVAATVDWFDPW	IGHV3-20	IGHJ5
TGTGCGAGAGTAGTGGCTACGATTAATGCTAAGTACTGG	CARVVATINAKYW	IGHV7-4-1	IGHJ4
TGTGCGGGGTATGGACTACCTTTGGCGCGATTCTACTGG	CAGYGLPLARFYW	IGHV3-30-3	IGHJ4
TGTGCGAACCTAAACCATACTATGATAGTAGTGGTGGTTGACTACTGG	CANLNHTMIVVVVDYW	IGHV3-23	IGHJ4
TGTGCAAAAGATATACGAATAGTAGTGGTGGTAGCTGCTAGTTTGGTTGATGCTTTTGATATCTGG	CAKDIRIVVVVAASLVDAFDIW	IGHV3-43	IGHJ3
TGTGCTAGCTGGAACTCTGTATTACGATATTTTGACTGGTTATACCCCGACGGAGTCGCCCCTTACTACTACTACTACATGGACGTCTGG	CASWNSVLRYFDWLYPDGVAPYYYYYMDVW	IGHV3-72	IGHJ6
TGTGCGAGAGCCACGATAGCAGCAGCTGGTGGGGTATGG	CARATIAAAGGVW	IGHV3-21	IGHJ4
TGTGCGAGAGATGCCAGTGGCTGGGCGGCATACTTCCAGCACTGG	CARDASGWAAYFQHW	IGHV3-7	IGHJ1
TGTGCAAGTAAAAGTAGCAGCAGCTGGGTTGACTACTGG	CASKSSSSWVDYW	IGHV3-13	IGHJ4
TGTGCGAAAGATGCGCGAATAGCAGTGGCTGGAATCGTGAATGATGCTTTTGATATCTGG	CAKDARIAVAGIVNDAFDIW	IGHV3-NL1	IGHJ3
TGTGCAAGAGATCTAAGTCTACCCTTGGATGATATAGCAGCGAAGCCCCTTATTGACTACTGG	CARDLSLPLDDIAAKPLIDYW	IGHV3-74	IGHJ4
TGTGCACGGAACGATTTAGGATATTGTAGTAGTACCAGCTGCTATGTCCTTCATTACTACTACTACTACTACATGGACGTCTGG	CARNDLGYCSSTSCYVLHYYYYYYMDVW	IGHV2-26	IGHJ6
TGTGCGAAAGATTTGGCCGGCATGATAGTAGAAATCCCCCCTACCCAAGGGCGTTTCATCGAGCACTGG	CAKDLAGMIVEIPPTQGRFIEHW	IGHV3-23	IGHJ1
TGTGCGAGTTTGGAGCATATTGTGGTGGTGACTGCTATTCGGGGTGACTACTGG	CASLEHIVVVTAIRGDYW	IGHV1-69	IGHJ4
TGTGCGAGAGCTGTGGGAAGCCCCAGATATTGTAGTAGTACCAGCTGCTATGCCCGCAACCTACGAAGGCCATACTTTGACTACTGG	CARAVGSPRYCSSTSCYARNLRRPYFDYW	IGHV4-59	IGHJ4
TGTGCGAGAACTCGGCAGATTACTATGATATTTGACTACTGG	CARTRQITMIFDYW	IGHV3-64	IGHJ4
TGTGCGAGAGCGGATATTGTAGTAGTACCAGCTGCCACCTACTTTGACTACTGG	CARADIVVVPAATYFDYW	IGHV4-38-2	IGHJ4
TGTGCAAGGGGCACGATTTTTGGAGTGGTTACCTGGTTCGACCCCTGG	CARGTIFGVVTWFDPW	IGHV3-74	IGHJ5
TGTGCGAGAGAATGGTTCGCCCATATTGTAGTGGTGGTAGCTGCTACTCTTCGCCTGGGGTACTGG	CAREWFAHIVVVVAATLRLGYW	IGHV4-61	IGHJ4
TGTGCGAAAGATGCCTACTATGGTTCGGGGAGTTATTATAGCCAAATATTTGACTACTGG	CAKDAYYGSGSYYSQIFDYW	IGHV3-23	IGHJ4
TGTGCACACTTTATTGTAGTAGTACCAGCTGCTCCCTCCTACTACTACTACTACTACATGGACGTCTGG	CAHFIVVVPAAPSYYYYYYMDVW	IGHV2-5	IGHJ6
TGTGCGAGAGGCCTGATTACATTTGGGGGAGGGTCCGATGCTTTTGATATCTGG	CARGLITFGGGSDAFDIW	IGHV4-61	IGHJ3
TGTGCATTTATTACTATGATAGTAGTGGTCGTAATTGACTACTGG	CAFITMIVVVVIDYW	IGHV3-NL1	IGHJ4
TGTGCGAGAGAACCATTTCCCAAGGATATTGTAGTGGTGGTAGCTGCCGAGGATCTTTACTACTACTACTACTACATGGACGTCTGG	CAREPFPKDIVVVVAAEDLYYYYYYMDVW	IGHV4-59	IGHJ6
TGTGCGAGAGATAAAATTGTAGTGGTGGTAGCTGCTCCTTCCGTATGGTTCGACCCCTGG	CARDKIVVVVAAPSVWFDPW	IGHV3-11	IGHJ5
TGTGCAAGATCCTATATTGTGGTGGTGATTGCCCCCACTGGTGAATACTTCCAGCACTGG	CARSYIVVVIAPTGEYFQHW	IGHV3-13	IGHJ1
TGTGCGAGATGTCGGGGGCAATTCATGACACTAGGATATTGTAGTGGTGGTAGCTGCTACTCACCCCCACTCTACTGG	CARCRGQFMTLGYCSGGSCYSPPLYW	IGHV1-18	IGHJ4
TGTGCGAAAGGGCAACCCGGATATTGTAGTGGTGGTAGCTGCTCAGCGTCCCACTACTACATGGACGTCTGG	CAKGQPGYCSGGSCSASHYYMDVW	IGHV3-NL1	IGHJ6
TGTGCACACAGACCTTATAGCAGTGGCTGGATTGACTACTGG	CAHRPYSSGWIDYW	IGHV2-5	IGHJ4
TGTGCGAGAGGGACCCCTGTATATTGTAGTGGTGGTAGCTGCTGGTGCTTTGACTACTGG	CARGTPVYCSGGSCWCFDYW	IGHV3-53	IGHJ4
TGTGCGAAAGATGTAGGCCCCAGCTTGGTTTGGCACCCCGATGCTTTTGATATCTGG	CAKDVGPSLVWHPDAFDIW	IGHV3-23	IGHJ3
TGTACTAGAGAGAAGGGGGTATGG	CTREKGVW	IGHV3-49	IGHJ4
TGTACCACAACCCCTACGGTGACTACATCCCTTTCATTAGAGCCGAAGAGACCGGGTGTTCTGTACTACTTTGACTACTGG	CTTTPTVTTSLSLEPKRPGVLYYFDYW	IGHV3-15	IGHJ4
TGTGCGAGAGGGTACCGATACTGG	CARGYRYW	IGHV1-18	IGHJ4
TGTGCGAGACATGTGGTTACTATGATAGTAGTGGTTATTCTAAAGTCCTTCGGTAGTCAGCTCCCGGGGCGTCTCTGG	CARHVVTMIVVVILKSFGSQLPGRLW	IGHV5-51	IGHJ4
TGTACTAGAAGCTATGATAGTAGTGGTTATAAACAGTACTACTTTGACTACTGG	CTRSYDSSGYKQYYFDYW	IGHV3-49	IGHJ4
TGTGCGAAACGCGGAGTTTCGGGGCTACTGAAACAGTGTACACGTTTAATTCGACATTACTACTACTACTACTACATGGACGTCTGG	CAKRGVSGLLKQCTRLIRHYYYYYYMDVW	IGHV3-NL1	IGHJ6
TGTGCGAGAACGTTAGAGAGAAGTAGGGTTACTATGGTTCGGGGAGTTACGGACTTTGACTACTGG	CARTLERSRVTMVRGVTDFDYW	IGHV3-66	IGHJ4
TGTGCGAAAGGTACGGCGGGCCGTATTTTGACTGGTTATTACCAGCCCGTTTACTACTACTACTACTACATGGACGTCTGG	CAKGTAGRILTGYYQPVYYYYYYMDVW	IGHV3-23	IGHJ6
TGTGCGAGCAGAGGGGGGTCCCTGTTAATATGTACCAGCGGGAGCTACTACTACTACTACATGGACGTCTGG	CASRGGSLLICTSGSYYYYYMDVW	IGHV1-2	IGHJ6
TGTGCGAGACTGGGAATTGGGATAAGGATATTGTACTGGTGGTGTATGCTATACGACCCGTACTACTACTACTACATGGACGTCTGG	CARLGIGIRILYWWCMLYDPYYYYYMDVW	IGHV5-51	IGHJ6
TGTGCGAAAGGTGACGACCCTGTAGTGGTGGTAGCTGCTACTCAATGGCAGCACTGG	CAKGDDPVVVVAATQWQHW	IGHV3-23	IGHJ1
TGTGCGAGTAAATACTATGATAGTAGTGGTTATAATGACTACTGG	CASKYYDSSGYNDYW	IGHV1-3	IGHJ4
TGTGCGACTCGCTATGGTTCAGGGACTGGCTGG	CATRYGSGTGW	IGHV3-NL1	IGHJ5
TGTGCGAGAGGGTGGAATCATGTTCCGAAACTGCGGGGTGGTAGCTGCTACCACCAGTTCGACCCCTGG	CARGWNHVPKLRGGSCYHQFDPW	IGHV1-3	IGHJ5
TGTGCACGGATAATTCCCGGTAGCAGTGGCTGGTACGTTGTTGACTACTGG	CARIIPGSSGWYVVDYW	IGHV2-26	IGHJ4
TGTGCGAGAAAGGAAGAGTATTACTATGGTTCAGGGAGTTATACTCCCATGTGGTTTACGAATCTATATTACTACTACTACTACTACATGGACGTCTGG	CARKEEYYYGSGSYTPMWFTNLYYYYYYYMDVW	IGHV7-4-1	IGHJ6
TGTGCACACACTTTCCAGCAGTGGCTGGCGAGCTACTGG	CAHTFQQWLASYW	IGHV2-5	IGHJ4
TGTGCGAAAGTGTTACGATTTTTGGAGTGGTTATTATGGGATCCCGGGCATAGCTGG	CAKVLRFLEWLLWDPGHSW	IGHV3-23	IGHJ5
TGTGCGAAGCATACGCAGCTGGAGCCGTACTACTTTGACTACTGG	CAKHTQLEPYYFDYW	IGHV4-59	IGHJ4
TGTGCGAGAGGCCGGGAACCTACTATGATAGTAGTGGTTAGCTTATACTTCCAGCACTGG	CARGREPTMIVVVSLYFQHW	IGHV1-18	IGHJ1
TGTGCGTGGTTCGGGGAGTTTCGTGACTACTTTGACTACTGG	CAWFGEFRDYFDYW	IGHV3-11	IGHJ4
TGTGCGAGAGGAAGTATTACTATGGTTCAGGGAGTTATTATAAGATACTACTACTACTACTACATGGACGTCTGG	CARGSITMVQGVIIRYYYYYYMDVW	IGHV4-4	IGHJ6
TGTGCGAGAGCGTCCATAGTATTACTATGGTTCAGGGACGATGACTACTGG	CARASIVLLWFRDDDYW	IGHV4-4	IGHJ4
TGTGCAAGAGATGGGGAGGTATGGACCCCAAATAGCAGCAGCATCTCATGGCATATCCGGCCCCAGTGTTACTACTACTACATGGACGTCTGG	CARDGEVWTPNSSSISWHIRPQCYYYYMDVW	IGHV3-74	IGHJ6
TGTGCACACAGACGGGGCTTTAGGATACGGTCTGACTACTGG	CAHRRGFRIRSDYW	IGHV2-5	IGHJ4
TGTGCGAAAGAGTTTTACTATGGTTCAGGGAGTTATCGGAACTGGTTCGACCCCTGG	CAKEFYYGSGSYRNWFDPW	IGHV3-NL1	IGHJ5
TGTGCGAGAGCGACCCCCGCCCAGTGGCTGTTTAGGTTCGACCCCTGG	CARATPAQWLFRFDPW	IGHV3-21	IGHJ5
TGTGCGAGAGGCATCAGTGGTAGCTGCTACTCAAACCTGCGCGTTGACTACTGG	CARGISGSCYSNLRVDYW	IGHV4-34	IGHJ4
TGTGCGAGAGATCGACAAGGGGTACCTGTAGCAGCTCGTAGGCGGCAAATTGACTACTGG	CARDRQGVPVAARRRQIDYW	IGHV3-7	IGHJ4
TGTGCGAGAGGTCCCTACCCCGGAGACGTATTGTGGTGGTGGGGGTTGTATACTTCCTACTGG	CARGPYPGDVLWWWGLYTSYW	IGHV1-2	IGHJ4
TGTGCGAGACGTTATATAGTGGTGGTAGCTGCTACTCGAGACTTTAACGGGCCGGCCCCACTCTGTTACTACTACTACTACATGGACGTCTGG	CARRYIVVVAATRDFNGPAPLCYYYYYMDVW	IGHV5-51	IGHJ6
TGTGCGAAAGATGACTTTGGAGTGGTTATTATAGATGGCTACTACTACTACTACATGGACGTCTGG	CAKDDFGVVIIDGYYYYYMDVW	IGHV3-NL1	IGHJ6
TGTGCGAGAAGGCCCAGCCTGCCGTATTACGATTTTCGCCAGGGCAACAACTGGTTCGACCCCTGG	CARRPSLPYYDFRQGNNWFDPW	IGHV7-4-1	IGHJ5
TGTGCGAGAGGATTTGGATGGCTACAATTAGAGGAGTACTACTTTGACTACTGG	CARGFGWLQLEEYYFDYW	IGHV4-59	IGHJ4
TGTGCGAGACGCATTATCCCGTCTAGTGGTGGTAGCCGGGCAGTGGCCGGTCAGTACTACTTTGACTACTGG	CARRIIPSSGGSRAVAGQYYFDYW	IGHV1-3	IGHJ4
TGTACCACAGATAAATTAAATACAATACTAAAGACCTACTGG	CTTDKLNTILKTYW	IGHV3-15	IGHJ4
TGTGCGAAAGATACAGGGTGGAGTGTGGCTACGGAATACTACTACTACATGGACGTCTGG	CAKDTGWSVATEYYYYMDVW	IGHV3-NL1	IGHJ6
TGTGCGAAGCGCAGGGTCGTTTGTAGTAGTACCAGCTGCTATGTACTTAATTACTACTACTACTACTACATGGACGTCTGG	CAKRRVVCSSTSCYVLNYYYYYYMDVW	IGHV3-NL1	IGHJ6
TGTGCGAGTAGCTTACGATTTTTGTGGGTGGCAACGGGTCGGCCCTCGGGAAGAAGGCTACCTATCGGCTACTGG	CASSLRFLWVATGRPSGRRLPIGYW	IGHV3-20	IGHJ4
TGTGCGAGAGCTCTAGGAGATTACTATGATAGTAGTGGTTATTACTCTTATGATGCTTTTGATATCTGG	CARALGDYYDSSGYYSYDAFDIW	IGHV4-34	IGHJ3
TGTGCGAGGAGAGCCCCGTTAATTGTAGTAGTACCAGCTGCTATGAGTCCCTACTACTACATGGACGTCTGG	CARRAPLIVVVPAAMSPYYYMDVW	IGHV3-11	IGHJ6
TGTGCTAGCAGCTCGTCCAGAGCGACGATGGACGTCTGG	CASSSSRATMDVW	IGHV3-23	IGHJ6
TGTACCACAGTTCCGCAGTGGCTGGGTTGTGGCGCTGATGCTTTTGATATCTGG	CTTVPQWLGCGADAFDIW	IGHV3-15	IGHJ3
TGTGCGAGAGACACGGATATAGTGGCTACGATTAGAAACAACTGGTTCGACCCCTGG	CARDTDIVATIRNNWFDPW	IGHV1-18	IGHJ5
TGTGCGAGCCATGATGGTGGCTACGATTGCGAAAGCTGGTTCGACCCCTGG	CASHDGGYDCESWFDPW	IGHV5-10-1	IGHJ5
TGTACTAGACGAGGGGACCTAGGATATTGTAGTAGTACCAGCTGCTTGATGTACTACTACTACTACTACATGGACGTCTGG	CTRRGDLGYCSSTSCLMYYYYYYMDVW	IGHV3-73	IGHJ6
TGTGCACACAGCCGGCATTGGCAACTTCTCGGTTGCTTATTACGATTTTTGGAGTGGTTATTATCCTTGTGGTTCGACCCCTGG	CAHSRHWQLLGCLLRFLEWLLSLWFDPW	IGHV2-5	IGHJ5
TGTGCGAGCGGAGGGGCCAGTGGTGGTAGCTGCTACCGGAGGTACTTCGATCTCTGG	CASGGASGGSCYRRYFDLW	IGHV7-4-1	IGHJ2
TGTGCGAGGGGGAGGCCTTTTTGGAGTGGGGAGGATTCAGGTTCGGCCCCGTCAATCTACTACTACTACTACATGGACGTCTGG	CARGRPFWSGEDSGSAPSIYYYYYMDVW	IGHV3-20	IGHJ6
TGTGCTAGAGCCGCGGGAAAAAAACCACCTCCTAAGTACAGACGTATTACTATGATAGTAGTGGTTGTGGTAGGGGGAACCTTTGACTACTGG	CARAAGKKPPPKYRRITMIVVVVVGGTFDYW	IGHV3-72	IGHJ4
TGTGCGAAAGATCGCCCCAGTGATATTGTAGTAGTACCAGCTGCGTACAACTGGTTCGACCCCTGG	CAKDRPSDIVVVPAAYNWFDPW	IGHV3-23	IGHJ5
TGTGCGAAAGCGCCGGATTACTATGGGGTGCGCAAAAGGGTCGCCTACTACTACTACTACATGGACGTCTGG	CAKAPDYYGVRKRVAYYYYYMDVW	IGHV3-NL1	IGHJ6
TGTGCGAGAGGGGTAGTGGTGGATACAGCTATGGTTACTTCTGATGCTTTTGATATCTGG	CARGVVVDTAMVTSDAFDIW	IGHV5-51	IGHJ3
TGTGCGAGACGGACCGGGTATAGCAGTGGCTGGTACGGGTCCCCCCCCTACTGCTTTGACTACTGG	CARRTGYSSGWYGSPPYCFDYW	IGHV4-39	IGHJ4
TGTGCGAGAGATGTTGCTCGGACCCGTTGGACCGTTCCCCACAACTGGTTCGACCCCTGG	CARDVARTRWTVPHNWFDPW	IGHV3-7	IGHJ5
TGTGCGAAAGAAGCCTGGACGGGTACAGAACTGGGGATCAACTACTGG	CAKEAWTGTELGINYW	IGHV3-23	IGHJ4
TGTACTAGAGTAATGGGATCACCATATTGTAGTGGTGGTAGCTGCTACAACTTTTTCACGTACTGG	CTRVMGSPYCSGGSCYNFFTYW	IGHV3-49	IGHJ4
