TGTGCGAGAGATCCCAGTGGTCTCAGGGCTATACCCACGTGGATACAGCTATGGTTATTTGTTTGTGACTACTGG	CARDPSGLRAIPTWIQLWLFVCDYW	IGHV1-3	IGHJ4
TGTGCGAGAGATCTCTGGTATCTTTACTATGATAGTAGTGGTTATTGTGTTCCTGACTACTGG	CARDLWYLYYDSSGYCVPDYW	IGHV3-53	IGHJ4
TGTGCGAGAGAACGGAACCCCCCTCGACATGACTACAGTAACTACGGGGGGCGGTACATGGACGTCTGG	CARERNPPRHDYSNYGGRYMDVW	IGHV3-53	IGHJ6
TGTGCGAGAGATCCCCCGCGAATCCATAGCAGCAGCTGGTACTACTACTTTGACTACTGG	CARDPPRIHSSSWYYYFDYW	IGHV3-53	IGHJ4
TGTGCACACAGCGCTATGCCGATGGCTTCCCCCAATGGCTACTACTACTACTACATGGACGTCTGG	CAHSAMPMASPNGYYYYYMDVW	IGHV2-5	IGHJ6
TGTGCGAGACTTCGCTGCGTATTACGATTTTTGGAGTGGTTATTAATGGTCCACTTTGACTACTGG	CARLRCVLRFLEWLLMVHFDYW	IGHV5-51	IGHJ4
TGTGCACTGCTAGGATATTGTAGTAGTACCAGCTGCATTTGGTTATACTACTTTGACTACTGG	CALLGYCSSTSCIWLYYFDYW	IGHV3-74	IGHJ4
TGTGCGAGAGACGGTACTGACAAAGGTATAGCAGCAGCTGGTAGTGGAAGGAGCTCTCGCTTTGACTACTGG	CARDGTDKGIAAAGSGRSSRFDYW	IGHV3-11	IGHJ4
TGTGCGAGAGAATCTCGGCGGAGCGGTATTACTATGGTTCAGGGAGTTATAATTTTTGATATCTGG	CARESRRSGITMVQGVIIFDIW	IGHV3-20	IGHJ3
TGTACTAGAGATCCTGATACTGGTAGTGGTGGTAGCTGCTTTCGGCCCTACTACTACTACATGGACGTCTGG	CTRDPDTGSGGSCFRPYYYYMDVW	IGHV3-49	IGHJ6
TGTGCGAGAGGAGAACGTTGGTGTATGTTCCCCTACTACTACTACTACATGGACGTCTGG	CARGERWCMFPYYYYYMDVW	IGHV1-2	IGHJ6
TGTGCGAGAGCCACCCCACGTATTACGATTTTTGGAGTGGTTATTAGAGATTGGCCCTTTGACTACTGG	CARATPRITIFGVVIRDWPFDYW	IGHV7-4-1	IGHJ4
TGTGCGAGTGAGAACCAGCAATATAGCAGTGGCTGGTACGAATTCTACTACTTTGACTACTGG	CASENQQYSSGWYEFYYFDYW	IGHV3-21	IGHJ4
TGTGCGAGAGATTCCACCGTTTATGGTTCAGGGAGTTATTATAACTACCCCGGAAGGATCGACGGCGACTACTGG	CARDSTVYGSGSYYNYPGRIDGDYW	IGHV1-3	IGHJ4
TGTGCGAGAGTGAAGAAGTATAGCAGCAGCTCCACCGGGGACGACTTCCAGCACTGG	CARVKKYSSSSTGDDFQHW	IGHV4-39	IGHJ1
TGTGCGAGAGCGCCCCGCCCCCAATTTCACGCACTATGGTTCAGGGAGTTATTGTTCTACTGG	CARAPRPQFHALWFRELLFYW	IGHV4-34	IGHJ4
TGTGCGAGAGAGGGTTCGAATACGATTTTTGGAGTGGCACTGGACTCCATGGACGTCTGG	CAREGSNTIFGVALDSMDVW	IGHV3-66	IGHJ6
TGTGCGAGAGCCCTAGCAGTGGCTGGTTCCGAGCAAGACTACTACTACTACTACATGGACGTCTGG	CARALAVAGSEQDYYYYYMDVW	IGHV1-2	IGHJ6
TGTGCACGGAGCCGCTTCATACTACGATTTTTGGAGTGGTTATCTACTAACAACTGGTTCGACCCCTGG	CARSRFILRFLEWLSTNNWFDPW	IGHV2-26	IGHJ5
TGTGGAAAACAGCTATGGTTTGGGTTTGACTACTGG	CGKQLWFGFDYW	IGHV3-30-3	IGHJ4
TGTGCGAGAGGCGGTGGAGAGCAGCAGCTGGCCTTTGACTACTGG	CARGGGEQQLAFDYW	IGHV4-34	IGHJ4
TGTGCACGGATACGAACCGCGGGTATTGAACCACGATTTTTGGAGTGGTTATTACCCCTAAACTGGTTCGACCCCTGG	CARIRTAGIEPRFLEWLLPLNWFDPW	IGHV2-26	IGHJ5
TGTGCAAAAGATATTGCCAGCCTCCTCGAGTACGGTGACTACGTCAACTTTGACTACTGG	CAKDIASLLEYGDYVNFDYW	IGHV3-43	IGHJ4
TGTGCTTTGACCTATTGTAGTGGTGGTAGCTGCTACTCCCCCTACTACTACTACTACATGGACGTCTGG	CALTYCSGGSCYSPYYYYYMDVW	IGHV1-46	IGHJ6
TGTGCGAGAGATGCCTTTTGGAGTGGTTATGTACCCCACTGGAACTGGTTCGACCCCTGG	CARDAFWSGYVPHWNWFDPW	IGHV1-69	IGHJ5
TGTGCGAGAGAACTCCCCCTAGTAGAGATGGCTACAATACTTTTGGTTGACTACTGG	CARELPLVEMATILLVDYW	IGHV3-30	IGHJ4
TGTGCGAAAGATCCCCGTTTCATCTTCTACTACTTTGACTACTGG	CAKDPRFIFYYFDYW	IGHV3-23	IGHJ4
TGTGCGAGACTCCCATCTTTCCTTGGAGTGGTTATTATCGGCCTAGGCCAGGTCTACTGG	CARLPSFLGVVIIGLGQVYW	IGHV7-4-1	IGHJ4
TGTGCACGGACTTACAGACGGGGGGTTATCTACGATATTGTAGTGGTGGTAGCTGCTACTTTGACCAAGGTCTTTGACTACTGG	CARTYRRGVIYDIVVVVAATLTKVFDYW	IGHV2-26	IGHJ4
TGTGCGAGAGTCTCCTCGCCGTGGATACAGCTATGGGCCGATGACTACTGG	CARVSSPWIQLWADDYW	IGHV3-30	IGHJ4
TGTGCGAGGAAGATAGGATATTGTAGTGGTGGTAAAGGGGACGACTACTGG	CARKIGYCSGGKGDDYW	IGHV1-46	IGHJ4
TGTGATGGAACTACGCCTGACTACTGG	CDGTTPDYW	IGHV3-30	IGHJ4
TGTGCGGAGAGGAGACGCATCCCTGACTACGGTGACTCTTTTTGCGTACGGGACTACTTTGACTACTGG	CAERRRIPDYGDSFCVRDYFDYW	IGHV5-51	IGHJ4
TGTGCGAAAGATTACGGTTTACGATTTTTGGAGTGGTTAGGCCATTTTGACTACTGG	CAKDYGLRFLEWLGHFDYW	IGHV3-NL1	IGHJ4
TGTGCCATTTCTGGAACTACGCCCAGGTTGGGGCACTACTACTACATGGACGTCTGG	CAISGTTPRLGHYYYMDVW	IGHV4-30-2	IGHJ6
TGTGCACGGATCCGATCAGCGAAAACGGCGCCCCTAGGGGGGAATTACTACTACTACTACTACATGGACGTCTGG	CARIRSAKTAPLGGNYYYYYYMDVW	IGHV2-70	IGHJ6
TGTGCGAGAGATCGCAAGGGTATAGCAGCAGCTGGATGGACTTGCGATGACTACTGG	CARDRKGIAAAGWTCDDYW	IGHV1-46	IGHJ4
TGTGCGTTCGAACGTATTATGATTACGTTTGGGGGAGTTATCGTCAGAGGGTCAAAGTCGTACTGG	CAFERIMITFGGVIVRGSKSYW	IGHV4-39	IGHJ4
TGTGCGAGACCCGGGATCCAGTGGCTGGTACCACGGGTTCGTAACGGGCGTAGGTTCGACCCCTGG	CARPGIQWLVPRVRNGRRFDPW	IGHV3-48	IGHJ5
TGTGCGAGAGCCGGGAAGGTGGTGGTGGAATACTTCCAGCACTGG	CARAGKVVVEYFQHW	IGHV1-18	IGHJ1
TGTGCAAGACCTTGGGTGGAAGTACGCTACTGG	CARPWVEVRYW	IGHV1-45	IGHJ4
TGTGCGAGACGTACGCCTATAGCAGCTCGTCCCGACTGCCCCAAAGTCTACTACTACTACATGGACGTCTGG	CARRTPIAARPDCPKVYYYYMDVW	IGHV3-21	IGHJ6
TGTGCCAGCCCTTATGACTACGGTGACTACGGGGTGTTTGACTACTGG	CASPYDYGDYGVFDYW	IGHV3-43D	IGHJ4
TGTGCGAGACGAAAGTATTGTACTGGTGGTGTATGCCTAATTATTGACTACTGG	CARRKYCTGGVCLIIDYW	IGHV5-51	IGHJ4
TGTGCGAGAGATCTGTACCCTATGGTTCGGGGAGTTCTCACCTCAGACTACTGG	CARDLYPMVRGVLTSDYW	IGHV3-30	IGHJ4
TGTGCGAGACCCGACTACGGTGACTACAAAGACGCCATAAACCGGCGGAGGAGAGGCGGCTTTGACTACTGG	CARPDYGDYKDAINRRRRGGFDYW	IGHV1-46	IGHJ4
TGTGCGAGAGATGGTACTATTACTATGGTTCGGGGAGTTATTACCCCTTCACTCTCAACTTTGGAAACGTACTTTGACTACTGG	CARDGTITMVRGVITPSLSTLETYFDYW	IGHV3-48	IGHJ4
TGTGCGAGAGATAGGTGGGTGGCTGGATTTGACTACTGG	CARDRWVAGFDYW	IGHV3-30	IGHJ4
TGTGCGAGATCTTGCCATATTGTGGTGGTGATTGCTATATTTGACTACTGG	CARSCHIVVVIAIFDYW	IGHV4-61	IGHJ4
TGTGCGAAAGGGTGGATAAATATTGTAGTGGTGGTAGCTGCTACTCCGGGCTCCGGGATTCTAGCCGGGCGGGAACCATACTTCCAGCACTGG	CAKGWINIVVVVAATPGSGILAGREPYFQHW	IGHV3-23	IGHJ1
TGTGCGAGATCATCGACTACAGTAACTGATAAACCCCCCTCCTGG	CARSSTTVTDKPPSW	IGHV4-38-2	IGHJ4
TGTGCGAGAGGAGCAGTGGCTGGTACATATGCTTTTGATATCTGG	CARGAVAGTYAFDIW	IGHV1-18	IGHJ3
TGTGCGAGAGGAGTTAGTGGCTACCCGGGGTTTGACTACTGG	CARGVSGYPGFDYW	IGHV4-4	IGHJ4
TGTGCGAAAGATGGATACAGCTATGGTAATATGTACTACTTTGACTACTGG	CAKDGYSYGNMYYFDYW	IGHV3-NL1	IGHJ4
TGTGTAGCCCGGGACTGTATAGCAGCAGCTGGTACTACTGACTACTGG	CVARDCIAAAGTTDYW	IGHV3-30	IGHJ4
TGTGCGAAAGGTTACGATTTTTGGAGTGGTTATTATGCACGGGGTTGGATCTACTACTACTACTACATGGACGTCTGG	CAKGYDFWSGYYARGWIYYYYYMDVW	IGHV3-23	IGHJ6
TGTACTAGTGAGTGGTGGGATACTATGGTTCAGGGAGTGGGCGATTACGACTACTGG	CTSEWWDTMVQGVGDYDYW	IGHV3-73	IGHJ4
TGTGCGAGCGGGGCCGGGTATAGCAGCAGCTGGTACGACGGACCATGGGCTTTTGATATCTGG	CASGAGYSSSWYDGPWAFDIW	IGHV5-10-1	IGHJ3
TGTACCACAGCACGGCCCCCGTTTTTACTGTATTACGATTTTTGGAGTGGTTACTATTACTACTACTACTACTACATGGACGTCTGG	CTTARPPFLLYYDFWSGYYYYYYYYMDVW	IGHV3-15	IGHJ6
TGTGCGAGAGATCGAGATTATTACTATGGTTCGGGGAGTTATTATAACGGACCCGACCGCTCGGAATACTTCCAGCACTGG	CARDRDYYYGSGSYYNGPDRSEYFQHW	IGHV3-7	IGHJ1
TGTGCGAAAGATCTGGCGCCTGCCCTTACGGTGAGCTTTACCAGGTACTGG	CAKDLAPALTVSFTRYW	IGHV3-23	IGHJ4
TGTGCACACCTCTTGTGTAGTGGTGGTAGCTGCTACGGTTCCACTGAGGCCTACTGG	CAHLLCSGGSCYGSTEAYW	IGHV2-5	IGHJ4
TGTCCCGGATATTACGATTTTTGGAGTGGGCTATCATCATATTACTACTACTACTACTACATGGACGTCTGG	CPGYYDFWSGLSSYYYYYYYMDVW	IGHV3-30-3	IGHJ6
TGTGCGAGAGATCTCCACCACGTATTACGATTTTTGGAGTGGACCGTTTATATCTTTGACTACTGG	CARDLHHVLRFLEWTVYIFDYW	IGHV1-2	IGHJ4
TGTGCGAGAGAGCCCTGGCCAGTGGTGGTGACTGCTATTTTATGCGTCTCCTGGTACTTCGATCTCTGG	CAREPWPVVVTAILCVSWYFDLW	IGHV4-59	IGHJ2
TGTGCGAAAGAGGGTGGCATACGATTTTTGGAGTACTTTCACTGG	CAKEGGIRFLEYFHW	IGHV3-NL1	IGHJ4
TGTGCGAGAGGGTATTATAGCAGCAGCTGGTACCGGGAATGCTTCTGG	CARGYYSSSWYRECFW	IGHV1-46	IGHJ3
TGTGCGAGAGACCCTATGATACGATTTTTGGAGTGGTTAATACAATACTACATGGACGTCTGG	CARDPMIRFLEWLIQYYMDVW	IGHV1-2	IGHJ6
TGTGCACAGGACGGGATAGCAGTGGCTGGTACCGAATGGGGCTACAACTGGTTCGACCCCTGG	CAQDGIAVAGTEWGYNWFDPW	IGHV3-13	IGHJ5
TGTGCGAAAGATCAGAGTTTTTGGAGTGGTTATCGTTACATGGACGTCTGG	CAKDQSFWSGYRYMDVW	IGHV3-NL1	IGHJ6
TGTGCGAGGGATATTGTGGTGGTGACTGCAAACTTTGACTACTGG	CARDIVVVTANFDYW	IGHV4-4	IGHJ4
TGTGCAAGAGATTTCGAGTTCTACTTTGACTACTGG	CARDFEFYFDYW	IGHV6-1	IGHJ4
TGTGCGAGAACAATAGAGATGGCTCTGGTCAGATTTGACTACTGG	CARTIEMALVRFDYW	IGHV1-2	IGHJ4
TGTGCGAGAAAGTCTTTAATTCTTTTCGTGGCTGGTAACTACTTTGACTACTGG	CARKSLILFVAGNYFDYW	IGHV3-7	IGHJ4
TGTGCGAGGCCCGTCGATATGATAGTAGTGGTTCCTCGGGCGCCGCTCCAACTGGGATATTGCAATACTGACTACTGG	CARPVDMIVVVPRAPLQLGYCNTDYW	IGHV4-34	IGHJ4
TGTTGTCGGAACGATAGCAGTGGCACGGTTGCTTTTGATATCTGG	CCRNDSSGTVAFDIW	IGHV1-2	IGHJ3
TGTGCGAGACGTTTGATAGCAGCAGCTGGTAGAAACCGGTATGCTTTTGATATCTGG	CARRLIAAAGRNRYAFDIW	IGHV5-51	IGHJ3
TGTGCGAGAACGGAGATGGCTACAATTCCTGCCTATGCGTTTGACTACTGG	CARTEMATIPAYAFDYW	IGHV1-3	IGHJ4
TGTGCGAAAAAGCCGAAACATAGCAGTGGCTGTGGAACTCGCCACTACTACTACTACATGGACGTCTGG	CAKKPKHSSGCGTRHYYYYMDVW	IGHV3-23	IGHJ6
TGTGCGAGAGATCAGCCCAAGGGAAACTACGGTGACTACGCAGTGGGCTACTTTGACTACTGG	CARDQPKGNYGDYAVGYFDYW	IGHV1-69	IGHJ4
TGTGTTTCCCGTAAGTGGAAACCGGAAAAACCCGTCTTTGACTACTGG	CVSRKWKPEKPVFDYW	IGHV3-30	IGHJ4
TGTGCGAAACAGGTGCGTCATGGGCGGTTCGGGGAGTTATGTTTTCCTCGCGGGGTCTACAACTGGTTCGACCCCTGG	CAKQVRHGRFGELCFPRGVYNWFDPW	IGHV3-NL1	IGHJ5
TGTGCGAGAAGGGGGTCGACTACGTTGGTGACCTTTGACTACTGG	CARRGSTTLVTFDYW	IGHV5-51	IGHJ4
TGTGTAAAACCCAGTCGCGTACGCGACGGATTCTACTGG	CVKPSRVRDGFYW	IGHV3-30	IGHJ4
TGTACTCGCAGCAGTGGCTGGTACCATGAGAGGAAAGAGAGCCGATTTGACTACTGG	CTRSSGWYHERKESRFDYW	IGHV3-73	IGHJ4
TGTGCGAGAGAGGGTCTGGGGCTTGTAGTGGTGGTAGCTGCTACGGGGATGTTTGACTACTGG	CAREGLGLVVVVAATGMFDYW	IGHV3-11	IGHJ4
TGTGCGAGGCCCCTCATATTGTACTGGTGGTGTATGCTAGAGCCACTCCTTAATTTCTGG	CARPLILYWWCMLEPLLNFW	IGHV5-10-1	IGHJ3
TGTGCGAAGCAGCAGCTGGTACGAGACCAAACACTACTTTCTGACTACTGG	CAKQQLVRDQTLLSDYW	IGHV3-NL1	IGHJ4
TGTGCGAGAGCGAGTCGAGGGGAGCAGTGGCTGGTACCTAGTAAATACCCCCCACGTAACCCTGCTTTTGATATCTGG	CARASRGEQWLVPSKYPPRNPAFDIW	IGHV1-2	IGHJ3
TGTGGAAAGTATATGAGATATTTTGACTGGTTACACAGTTCCTACTACTACTACTACATGGACGTCTGG	CGKYMRYFDWLHSSYYYYYMDVW	IGHV3-30	IGHJ6
TGTGCGAGACATGAGGGTGTAGTAGTACCAGCTGCTATGAACTTAGGTGCTTTTGATATCTGG	CARHEGVVVPAAMNLGAFDIW	IGHV4-39	IGHJ3
TGTGCGAGACCCTTACGATATTTTGACTGGTTATCAGTCCCATACTACTACTACTACATGGACGTCTGG	CARPLRYFDWLSVPYYYYYMDVW	IGHV4-38-2	IGHJ6
TGTGCGAAAGCCTGTAGTACCAGCTGCCGGGCCAATGACTACTGG	CAKACSTSCRANDYW	IGHV3-23	IGHJ4
TGTGCGAGAGGGTACGGTGGTAATTGGGCTAGGGCCTTTGACTACTGG	CARGYGGNWARAFDYW	IGHV1-2	IGHJ4
TGTGCGAGAGATTGTAGGCCCTTAGGCGCTCCCCTGGTTAGGGTTTGCCCTATACCCCCCTGGTTCGACCCCTGG	CARDCRPLGAPLVRVCPIPPWFDPW	IGHV4-59	IGHJ5
TGTGCGAGACCGCGTTACTATGATAGTAGTGGTTATTTGAGGTACTACTTTGACTACTGG	CARPRYYDSSGYLRYYFDYW	IGHV5-51	IGHJ4
TGTGCGAGACGCAGGGTGGGGGGGAGTTGTATTACTATGATAGTAGTGGTTATCGTTGACTACTGG	CARRRVGGSCITMIVVVIVDYW	IGHV1-18	IGHJ4
TGTGCGAGTCTAGGATATTGTACTGGTGGTGTATGCTTGTACGGCTACTACTACTACTACATGGACGTCTGG	CASLGYCTGGVCLYGYYYYYMDVW	IGHV3-7	IGHJ6
TGTGCGAGAGCATACAGTGAGTTAGTAGTGGTTATTAGTTTGTCCCAACCCCTGTTTGACTACTGG	CARAYSELVVVISLSQPLFDYW	IGHV3-53	IGHJ4
TGTGCGAAAGATCGGTATAGCAGCTCGTCGGTGGACTACTTTGACTACTGG	CAKDRYSSSSVDYFDYW	IGHV3-NL1	IGHJ4
