TGTGCGAAAGAAAGGGGCATTATGATTACATTTGGGGGAGTTATCGTTAGCCTTGACTACTGG	CAKERGIMITFGGVIVSLDYW	IGHV3-23	IGHJ4
TGTGCGAGAAGCCGTATTACGATTTTTGGAGTGGTTATTATCCGGATGGACTGG	CARSRITIFGVVIIRMDW	IGHV7-4-1	IGHJ4
TGTGCGAGAGTTTATAGCAGTGGCCATTACTACTACTACTACTACATGGACGTCTGG	CARVYSSGHYYYYYYMDVW	IGHV3-11	IGHJ6
TGTGCGAGGGCTGTTGATAGTAGTGGTTATTACTACGAGTTAGGTGCCCCTGACTACTGG	CARAVDSSGYYYELGAPDYW	IGHV1-3	IGHJ4
TGTGCGAGAGGTACCGATATTTTGACTGGTTATTATTATTCTCCTTACTACTACTACTACTACATGGACGTCTGG	CARGTDILTGYYYSPYYYYYYMDVW	IGHV4-59	IGHJ6
TGTGCACACAGAGCAGCTGGTGACCCTGGCGGGTCTCTTGACTACTGG	CAHRAAGDPGGSLDYW	IGHV2-5	IGHJ4
TGTGCGAGAGATGACGAATGTCATTACGATATTTTGACTGGTTATTACATCGACGGGCCCCATGATGCTTTTGATATCTGG	CARDDECHYDILTGYYIDGPHDAFDIW	IGHV3-66	IGHJ3
TGTACCACAGATACACTCAACGGAGTCCACCGGCATATTGTGGTGGTGATTGCTATTTACTGG	CTTDTLNGVHRHIVVVIAIYW	IGHV3-15	IGHJ4
TGTGCAAGAACCTACAGTAACTCCCGACTTATTTACTGG	CARTYSNSRLIYW	IGHV1-45	IGHJ4
TGTGCACGGAGTAGAGTCCATTGTAGTAGTACCAGCTGCTATTACGGGTTTCCGAGTACCTCATACTACATGGACGTCTGG	CARSRVHCSSTSCYYGFPSTSYYMDVW	IGHV2-70	IGHJ6
TGTGCGAGAGATCCCGGAGTTATAAAGCTGCACGGGGACTACTTTGACTACTGG	CARDPGVIKLHGDYFDYW	IGHV3-53	IGHJ4
TGTGCACGGATCAAATATGGTTCAGGGAGTTATTACCCCTACTGG	CARIKYGSGSYYPYW	IGHV2-70	IGHJ4
TGTGCGAGAAGCCGACCAGCTGCTATGTTGCTTAGCCAATGTTACTACTACTACTACATGGACGTCTGG	CARSRPAAMLLSQCYYYYYMDVW	IGHV4-38-2	IGHJ6
TGTGCGAGAGGGGGTATTACTATGGTTCAGGGAGTGCTGTATAGAGACTTTGACTACTGG	CARGGITMVQGVLYRDFDYW	IGHV4-34	IGHJ4
TGTGCGAGTCGATGCGCTATGATAGTAGTGGTTATTACTACCCGACCCACCTTCCAGCACTGG	CASRCAMIVVVITTRPTFQHW	IGHV3-7	IGHJ1
TGTGCGAAATGGAGAGTCTTTGGCTACTACGGTGACTACGGGTTTGACTACTGG	CAKWRVFGYYGDYGFDYW	IGHV3-23	IGHJ4
TGTGCGAGAGATCCGGGAGGAGGATATTGTAGTTTTCTCCCCTCCTACTACTACTACATGGACGTCTGG	CARDPGGGYCSFLPSYYYYMDVW	IGHV3-7	IGHJ6
TGTGCGAGGCATTGTAGTAGTACCAGCTGCTATGCCTGCCTTTTGGGGGGGACCGGGAGACGCTACTACTACTACTACATGGACGTCTGG	CARHCSSTSCYACLLGGTGRRYYYYYMDVW	IGHV5-51	IGHJ6
TGTACTAGCCCCCGGGCCGGTAGCTGCTACTCAGGGGGTGGGTTCGACCCCTGG	CTSPRAGSCYSGGGFDPW	IGHV3-73	IGHJ5
TGTGCGAAAGTGACGGGGTATAGCAGTGGCTGGTTTTGGTTCGACCCCTGG	CAKVTGYSSGWFWFDPW	IGHV3-NL1	IGHJ5
TGTGCAAGAGGTTCCCGTATTGTAGTAGTACCAGCTGCTATACCTGATGCTTTTGATATCTGG	CARGSRIVVVPAAIPDAFDIW	IGHV3-13	IGHJ3
TGTACTAGAGCGTTGCTCGCGTCCCAAACTGCTATGGAGGTCAAATCCTTTGACTACTGG	CTRALLASQTAMEVKSFDYW	IGHV3-49	IGHJ4
TGTGCGAGAGTTTATACGGTGACGCCCATTAACATCCCCACGGACTTTGACTACTGG	CARVYTVTPINIPTDFDYW	IGHV1-69	IGHJ4
TGTGCGAGACGTCCCGCGTATAGCAGTGGCTGGGTGGACTGGTTCGACCCCTGG	CARRPAYSSGWVDWFDPW	IGHV4-39	IGHJ5
TGTGCGAGAGATCAATACGATATAGCAGCAGCTGGTACGACGGCTGAATACTTCCAGCACTGG	CARDQYDIAAAGTTAEYFQHW	IGHV3-53	IGHJ1
TGTGCGAGAGATATTGTAGTAGTACCAGCTGCTAGTATGGGGGGGGAAGACTACTGG	CARDIVVVPAASMGGEDYW	IGHV3-11	IGHJ4
TGTGCGAGTTCGGGCCGTATTACGATTTTTGGAGTGGTTAGATCCTTTGACTACTGG	CASSGRITIFGVVRSFDYW	IGHV1-3	IGHJ4
TGTGCGAGAGGCACAGTTCTCCGGGGGTGCTATTTTGACTGGTTATTATCCCTATTCGACCCCTGG	CARGTVLRGCYFDWLLSLFDPW	IGHV4-34	IGHJ5
TGTGCGAACATACGTATTATGATTACGTTTGGGGGAGTTAACACCCCGGGGCTGATGCCCGACTACTGG	CANIRIMITFGGVNTPGLMPDYW	IGHV4-61	IGHJ4
TGTGCGAGAGTCGAGACAGGGGGTGGTGAGCTCCCCGCAGCTGGTACCGCTGCTTTTGATATCTGG	CARVETGGGELPAAGTAAFDIW	IGHV1-3	IGHJ3
TGTGCGAGAGGTCCAGCAGCTGGTGGGGACTACTGG	CARGPAAGGDYW	IGHV4-38-2	IGHJ4
TGTGCGAGAGGTTCACCCCTATCTGGAACGTTGGATGCTTTTGATATCTGG	CARGSPLSGTLDAFDIW	IGHV4-59	IGHJ3
TGTGCGAAACCCCCATATTACGATTTTTGGAGTGGTTATTATTTTTGGACCGGCTTTGACTACTGG	CAKPPYYDFWSGYYFWTGFDYW	IGHV3-23	IGHJ4
TGTGCGAGACAACGCGTTAAACCAGCGGGGCAGCAGCTGGTTGAAGATGCTTTTGATATCTGG	CARQRVKPAGQQLVEDAFDIW	IGHV3-53	IGHJ3
TGTGCGAGAGGAACTGAACGGCCCCACGATTACTACTACTACTACTACATGGACGTCTGG	CARGTERPHDYYYYYYMDVW	IGHV4-4	IGHJ6
TGTGCGAGAGATGTAGGGGGGGCAAATTGTAGTAGTACCAGCTGCTATCGAGGGGGCGGGGGATACTGGTTCGACCCCTGG	CARDVGGANCSSTSCYRGGGGYWFDPW	IGHV3-66	IGHJ5
TGTGCACGGATGAAGGGCCCGTCGGCGATCCGCTACGGTGACTACCACTGG	CARMKGPSAIRYGDYHW	IGHV2-26	IGHJ5
TGTGCGAGAGAGGGTATTACGATTTTTGGAGTGGTTATTATATGCGTCCCCTCAGTAATTCAAGACTACTGG	CAREGITIFGVVIICVPSVIQDYW	IGHV1-2	IGHJ4
TGTGCGAGAAAGGTTCACCTCCTAGTAGTACCAGCTGCTATCTACGGAGACTACTACTACTACTACTACATGGACGTCTGG	CARKVHLLVVPAAIYGDYYYYYYMDVW	IGHV1-8	IGHJ6
TGTGCAACAGATTATACTGGTCTTACATATTGTAGTAGTACCAGCTGCTATCCCTACTACTACTACATGGACGTCTGG	CATDYTGLTYCSSTSCYPYYYYMDVW	IGHV1-24	IGHJ6
TGTGCGAGACCGGAGTCAGAAGCGGTGGTAACTCCCAGGAATCGCAACTGGTTCGACCCCTGG	CARPESEAVVTPRNRNWFDPW	IGHV7-4-1	IGHJ5
TGTGCGAAATCGGGTGACCCGCACCCGTTTTGTACGATTTTTGGAGTGGTGAAAGGGTTTGACTACTGG	CAKSGDPHPFCTIFGVVKGFDYW	IGHV3-23	IGHJ4
TGTGCGAGAGATCCTCGCAGCTCGATACCTGGGCCTCCCTACTGG	CARDPRSSIPGPPYW	IGHV1-2	IGHJ4
TGTGCGAAAGACGAAAGTGCGGGCGATTTTTGGAGTGGTTACGCATACTACTACTACTACATGGACGTCTGG	CAKDESAGDFWSGYAYYYYYMDVW	IGHV3-NL1	IGHJ6
TGTGCGAGACCCCACTATGATAGTAGTGGTATGTACTTTGACTACTGG	CARPHYDSSGMYFDYW	IGHV1-69	IGHJ4
TGTGCGAGACCTTGGCGGAATTTACGATTTGAACACTACTACTACTACATGGACGTCTGG	CARPWRNLRFEHYYYYMDVW	IGHV4-38-2	IGHJ6
TGTGCGAGACGGATTACTATGATAGTAGTGGTGGACTACTGG	CARRITMIVVVDYW	IGHV4-39	IGHJ4
TGTGCGAGAGGACCCCAGGATTACGATATTTTGACTGGTTATTATATGGGGAGGTTTGGCTTTCGCTGG	CARGPQDYDILTGYYMGRFGFRW	IGHV7-4-1	IGHJ4
TGCGGGGGCCGATATTGTAGTAGTACCAGCTGCTACAACTGGTTCGACCCCTGG	CGGRYCSSTSCYNWFDPW	IGHV3-30-3	IGHJ5
TGTGCGAAACGGGAGAACAAGGGTTCAGGGAGTTATTATAGACTGCTTGACTACTGG	CAKRENKGSGSYYRLLDYW	IGHV3-23	IGHJ4
TGTGCAAGCAGGGGTATAGCAGCTCGTCCCCCCTGGTTCGACCCCTGG	CASRGIAARPPWFDPW	IGHV3-74	IGHJ5
TGTGCGAGAGGCATACATAGTATTACTATGATAGTAGTGGGTATTGACTACTGG	CARGIHSITMIVVGIDYW	IGHV3-7	IGHJ4
TGTGCGAGATTCAGGCATCAGTACGGTGACTACGTCAGGGGCTGGTTCGACCCCTGG	CARFRHQYGDYVRGWFDPW	IGHV7-4-1	IGHJ5
TGTGCGAACGTAGTAGTACCAGCTGCTGACTGGTTCGACCCCTGG	CANVVVPAADWFDPW	IGHV3-NL1	IGHJ5
TGTACTAGAGATCGCACCCTGACTACGGTGACTCAAGGGTACTACTACTACTACTACATGGACGTCTGG	CTRDRTLTTVTQGYYYYYYMDVW	IGHV3-49	IGHJ6
TGTACAATGGTACTGTGGGTGAGAGAAAAGATTTGTAGTGGTGGTAGCTGCATCCTAGTGATAAATTACTACTACTACTACTACATGGACGTCTGG	CTMVLWVREKICSGGSCILVINYYYYYYMDVW	IGHV3-73	IGHJ6
TGTGAGAGATCCGATATTGTAGTAGTACCAGCTGCTATGGTCAAACAGTTTGACTACTGG	CERSDIVVVPAAMVKQFDYW	IGHV3-30	IGHJ4
TGTGCGAGAGATCTGAGTATTGTAGTAGTACCAGCTGCTATGGGGATTTGGTTCGACCCCTGG	CARDLSIVVVPAAMGIWFDPW	IGHV4-59	IGHJ5
TGTGCGAGAGCCACGGGATCCCGTATAGCAGTGGCTGGTACCCGACCCAACTGGTTCGACCCCTGG	CARATGSRIAVAGTRPNWFDPW	IGHV1-69	IGHJ5
TGTGCGAGACCCCCTGTCGACCCCTGG	CARPPVDPW	IGHV7-4-1	IGHJ5
TGTGCGAGAGCGGGCCCAGTAACTACGCAAGACTACTGG	CARAGPVTTQDYW	IGHV3-53	IGHJ4
TGTGCGAAAGATCGCGAGCAGTGGCTGGCATCCTGGTTCGACCCCTGG	CAKDREQWLASWFDPW	IGHV3-NL1	IGHJ5
TGTACCACAGATCGGGTCGCAGTGGCTGGTACCCGTGACTACTGG	CTTDRVAVAGTRDYW	IGHV3-15	IGHJ4
TGTGCGAAATTGGTAGCTGCTATTGTTCTTTTTTACTACTTTGACTACTGG	CAKLVAAIVLFYYFDYW	IGHV3-23	IGHJ4
TGTGCACGGATTGGTCATACGGTGACTACGTCGGGGGGTTCCTACTACTACTACTACATGGACGTCTGG	CARIGHTVTTSGGSYYYYYMDVW	IGHV2-26	IGHJ6
TGTACCTTCGGACCCCCTGAGGATATTGTACTAATGGTGTATGCTATTGCAGATGCTTTTGATATCTGG	CTFGPPEDIVLMVYAIADAFDIW	IGHV3-15	IGHJ3
TGTGCGAGAGGGATTATGCCGTATAGCAGCTCGTCCGGATTTCATAAGAACAACTGGTTCGACCCCTGG	CARGIMPYSSSSGFHKNNWFDPW	IGHV3-53	IGHJ5
TGTGCGAGGAGACGTCGCTACAGTAACTTTTGGTGTTTGGGGGTAGGGTACTTTGACTACTGG	CARRRRYSNFWCLGVGYFDYW	IGHV4-59	IGHJ4
TGTGCACGGGATATTGTAGTAGTACCAGCTGCTGTTTTTGACTACTGG	CARDIVVVPAAVFDYW	IGHV2-70	IGHJ4
TGTGCGAGAGGGCGTAATTTTGACTGGCGCTACTGG	CARGRNFDWRYW	IGHV1-3	IGHJ4
TGTGCGAGAGGGGAGTGGGAGCTACTCTGGGGGCTACTTGACTACTGG	CARGEWELLWGLLDYW	IGHV1-2	IGHJ4
TGTGCAAGGGGTAGTACCAGCTGCGACTACTACTACTACTACATGGACGTCTGG	CARGSTSCDYYYYYMDVW	IGHV3-13	IGHJ6
TGTGCGAGAGTAAGTATTACGATTTTTGGAGTGGTTATTAGCGTCTACTACTACTACTACATGGACGTCTGG	CARVSITIFGVVISVYYYYYMDVW	IGHV4-61	IGHJ6
TGTGCGAGAGAGGCTAGTAGTACCAGCTGCTATGAGTACTACTACTACTACTACATGGACGTCTGG	CAREASSTSCYEYYYYYYMDVW	IGHV1-46	IGHJ6
TGTGCGAAACCCGTGGACTACTGG	CAKPVDYW	IGHV3-23	IGHJ4
TGTGCGAGTCATTATTGTAGTAGTACCAGCTCGACCTACTACTTTGACTACTGG	CASHYCSSTSSTYYFDYW	IGHV3-7	IGHJ4
TGTGCGAGAGTAGAGCGTGAATACCCGTATTACGATTTTTGGAGTGGTTATTATTACGGGTACTACTACTACTACTACATGGACGTCTGG	CARVEREYPYYDFWSGYYYGYYYYYYMDVW	IGHV3-11	IGHJ6
TGTGCTCGGAACCCTGATTACATTTGGGGGAGTTATGGAGACTACTGG	CARNPDYIWGSYGDYW	IGHV3-21	IGHJ4
TGTGCGAGGACTCTAACCCGCCAGAGGCTTACTATGATAGTAGTGGTTAGAAATTACTACTACTACTACTACATGGACGTCTGG	CARTLTRQRLTMIVVVRNYYYYYYMDVW	IGHV1-2	IGHJ6
TGTGCGATAGGAGAGTGTAGTAGTACCAGCTGCTGCCCAAGCTACTGG	CAIGECSSTSCCPSYW	IGHV4-38-2	IGHJ4
TGTACTAGAGATCGGGGCAGCAGCTGGTACTCCTGGTACTACTTTGACTACTGG	CTRDRGSSWYSWYYFDYW	IGHV3-49	IGHJ4
TGTGCGAGAACCGGATATTGTAGTGGTGGTAGCTGCGTGATACACATGGACGTCTGG	CARTGYCSGGSCVIHMDVW	IGHV4-38-2	IGHJ6
TGTGCGAGTATGATTACATTTGGGGGAGTTATCGTTATGACTACGTGGGACTACTGG	CASMITFGGVIVMTTWDYW	IGHV1-18	IGHJ4
TGTGCGAGATGCGCCGGGTATAGCAGCAGCTGGTACGGGCGTTTCTGG	CARCAGYSSSWYGRFW	IGHV4-61	IGHJ4
TGTGCGAAAGGAAGCATTACTATGATAGTAGTGGTTATTGGTCTGGGCTACAGCCGTGACTACTGG	CAKGSITMIVVVIGLGYSRDYW	IGHV3-23	IGHJ4
TGTGCGAGAGAAACTGTTATTACTATGGTTCGGGGAGTTATTATAACACACTGG	CARETVITMVRGVIITHW	IGHV1-3	IGHJ4
TGTGCGAGAGGCCTTATGACTACGGTGACTACCGGACTGGAGTACTACTTTGACTACTGG	CARGLMTTVTTGLEYYFDYW	IGHV4-34	IGHJ4
TGTGCGAGGTTTCCCGGGAGGTATTACTATGGTTCAGGGAGTTATAAAGCGGGGGGGTGG	CARFPGRYYYGSGSYKAGGW	IGHV3-21	IGHJ5
TGTGCGAGATCAGTCCCGGGAGTCCCAAGGAACCTAGGATATTGTAGTAGTACCAGCTGCTACGATTTAACAGTGCCCTACTTTGACTACTGG	CARSVPGVPRNLGYCSSTSCYDLTVPYFDYW	IGHV7-4-1	IGHJ4
TGTGCGAAAGACGTAAGTACGATATTTCAACCTGGAAAAAACTGGTTCGACCCCTGG	CAKDVSTIFQPGKNWFDPW	IGHV3-NL1	IGHJ5
TGTGCGAAAGATCGTTGGGATAAAAGTATAGCAGCAGCTGGTAGAGGCTTTGACTACTGG	CAKDRWDKSIAAAGRGFDYW	IGHV3-NL1	IGHJ4
TGTGCGAGAGAAGTTAGTCCCATGATAGTAGTGGTTATTACGGATCTCTCCCCGAAACCCTGG	CAREVSPMIVVVITDLSPKPW	IGHV1-18	IGHJ5
TGTGCGAGAGAGTCCCCACGTATTACTATGGTTCAGGGACGAAACCGCCGGGCGTGGCGAGTTTACTACTACTACTACATGGACGTCTGG	CARESPRITMVQGRNRRAWRVYYYYYMDVW	IGHV1-18	IGHJ6
TGTGCGAGAGATCCTAGTGGATTACTATGGTTCGGGGAGGTGTCCTGTGACTACTGG	CARDPSGLLWFGEVSCDYW	IGHV1-69	IGHJ4
TGTACTAGACATGTCAGCCTTTTGGAGTGGTTAGGTTTTCAACGTGCATATTACTACTACTACTACTACATGGACGTCTGG	CTRHVSLLEWLGFQRAYYYYYYYMDVW	IGHV3-73	IGHJ6
TGTGCGAGACATCCCCAGCGCAGGCTGTCCGGGTCCAATAGCAGTGGCTGTGGAGATGCTTTTGATATCTGG	CARHPQRRLSGSNSSGCGDAFDIW	IGHV4-39	IGHJ3
TGTGCGAGACGCTGGGTAGGATATTGTAGTGGTGGTAGCTGCTACAAAGAGGGCTACTGG	CARRWVGYCSGGSCYKEGYW	IGHV5-51	IGHJ4
TGTGCGAGGCTAACTTGCCCCGTATTACGATTTTTGGAGTGGTTATTCAGCCGCTACTTTGACTACTGG	CARLTCPVLRFLEWLFSRYFDYW	IGHV5-51	IGHJ4
TGTGCGAAAGAATTCCGCCACGACAGTAACTACACCGGGTACTACTACTACTACTACATGGACGTCTGG	CAKEFRHDSNYTGYYYYYYMDVW	IGHV3-NL1	IGHJ6
TGTGCGAGAGTCCTGTATAGCAGTGGCTGGTGTGCTTTTGATATCTGG	CARVLYSSGWCAFDIW	IGHV1-46	IGHJ3
