TGTGCAAGTAGGCATCCGGTTCAGGGAGTTATTAGGGGGGTCGCCTTGTACTGG	CASRHPVQGVIRGVALYW	IGHV3-13	IGHJ4
TGTGCGAGAGAGGGGCCGATCTGTATTACTATGATAGTAGTGGTTATTACTTTCCCTGACTACTGG	CAREGPICITMIVVVITFPDYW	IGHV3-21	IGHJ4
TGTGCGAGAGCGGATACCGAACGATTTTTGGAGTGGTTATTAAGGGCAGTCCTTGCAGCCGGGAACTGGTACTTCGATCTCTGG	CARADTERFLEWLLRAVLAAGNWYFDLW	IGHV1-46	IGHJ2
TGTGCGAAAGGGGAGATCGGGCCATTGCCTTACGATTTTTGGAGTGGTTATTATTCCCGCCTGAAAAACTGGTACTTCGATCTCTGG	CAKGEIGPLPYDFWSGYYSRLKNWYFDLW	IGHV3-23	IGHJ2
TGTGCGAAAGAACACCTGAATGGTGTATGCTATAGGGCCGGTACTGATGGCTACTACTACTACATGGACGTCTGG	CAKEHLNGVCYRAGTDGYYYYMDVW	IGHV3-23	IGHJ6
TGTGCGAGACGGTTAATAAGGGGCGCTTACGACGCGGGTGTTGACTACTGG	CARRLIRGAYDAGVDYW	IGHV7-4-1	IGHJ4
TGTGCAAGAGATACGATTTTTGGAGTGCCCCACATCTACTACTACTACATGGACGTCTGG	CARDTIFGVPHIYYYYMDVW	IGHV3-74	IGHJ6
TGTACTAGACATACTCCACCGGTAATTTGTCTCGCAGCAGCTGGTGGTCAGACCTACTACTGG	CTRHTPPVICLAAAGGQTYYW	IGHV3-73	IGHJ4
TGTGCAAGACGAACCCCTAGGCTACATGACTACGGTGACCTGATTGACTACTGG	CARRTPRLHDYGDLIDYW	IGHV3-74	IGHJ4
TGTGCGAGAGGATCCCCCCCTAAACGTTATGATTACATTTGGGGGAGTTATCGTTGGCCCGCGCATTACTACTACTACTACTACATGGACGTCTGG	CARGSPPKRYDYIWGSYRWPAHYYYYYYMDVW	IGHV4-34	IGHJ6
TGTGCGAGAGGGTATAGCAGCAGCTGGTACGGATCCGCTGGAATCTTTGACTACTGG	CARGYSSSWYGSAGIFDYW	IGHV3-66	IGHJ4
TGTGCGAGAGACGATATTGTGGTGGTGACTGCTACTTTATCCCACTTTGACTACTGG	CARDDIVVVTATLSHFDYW	IGHV3-20	IGHJ4
TGTGCGAGAGTAAGTCGTAGGATATTGTACTGGTGGTGTATGCTATACAGAAAACCTTGTGTCCTTTACTACTACTACATGGACGTCTGG	CARVSRRILYWWCMLYRKPCVLYYYYMDVW	IGHV3-11	IGHJ6
TGTGCAAGACAAGAGCACCTCTACTACTACTACTACATGGACGTCTGG	CARQEHLYYYYYMDVW	IGHV1-45	IGHJ6
TGTGCGAGAGGTTCCGAAGTTCTTATTGTACTAATGGTGTATGCTATCCCCCAAATTGACTACTGG	CARGSEVLIVLMVYAIPQIDYW	IGHV3-11	IGHJ4
TGTGCGAAAGTGGAACCCCTTTGGGGATACAGCTATGGTTTTCGCGCCTGGTTCGACCCCTGG	CAKVEPLWGYSYGFRAWFDPW	IGHV3-23	IGHJ5
TGTGCGAGAGACGAAGGTATTGTAGTAGTACCAGCTGGCATAGTTGACTACTGG	CARDEGIVVVPAGIVDYW	IGHV3-7	IGHJ4
TGTACTAGAGACCCGGCCGGGACGTCGGGCAGGTATGGTTCAGGTAGATACTACTACTACATGGACGTCTGG	CTRDPAGTSGRYGSGRYYYYMDVW	IGHV3-49	IGHJ6
TGTGCACGGAACCAGCCCATTACTATGATAGTAGTGGTTATTAGGTATCGCATCTGGTTCGACCCCTGG	CARNQPITMIVVVIRYRIWFDPW	IGHV2-70	IGHJ5
TGTACCACAGATATTTGGAGTGGTTATTATATTTTTGACTACTGG	CTTDIWSGYYIFDYW	IGHV3-15	IGHJ4
TGTACTAGAGGTCCGTATAGCAGCTCGCAGTACTACTTTGACTACTGG	CTRGPYSSSQYYFDYW	IGHV3-73	IGHJ4
TGTGGCTGGGTGAAATACGGTGACTACGTTGACCAAATCTATTATGATGCTTTTGATATCTGG	CGWVKYGDYVDQIYYDAFDIW	IGHV3-30	IGHJ3
TGTGCGAGACGGGATGATAGTAGTGGTTATTACTACGGGATCGAGAGCCACTACTGGTACTTCGATCTCTGG	CARRDDSSGYYYGIESHYWYFDLW	IGHV4-34	IGHJ2
TGTGCGAGAATTATTACTATGATAGTAGTGGTTATTACTACCTCTGACTACTGG	CARIITMIVVVITTSDYW	IGHV3-20	IGHJ4
TGTGCGAGCCTGGGCGTAGTAGTACCAGCTGCTATGGGGAAGAATAACTGGTTCGACCCCTGG	CASLGVVVPAAMGKNNWFDPW	IGHV1-69	IGHJ5
TGTGCGAGAGTAAGGAGATGGTATAGCAGCAGCTGGTACGGGAATTTCTGG	CARVRRWYSSSWYGNFW	IGHV3-7	IGHJ3
TGTGCGAAAGATGTTCAGCAGCTCCCATTTGACTACTGG	CAKDVQQLPFDYW	IGHV3-23	IGHJ4
TGTGCGAAAGATATATTTGGTGCCCCCAAGAAGATTACTATGATAGTAGTGGTTATTACTACTACATTAAACTTTGACTACTGG	CAKDIFGAPKKITMIVVVITTTLNFDYW	IGHV3-NL1	IGHJ4
TGTGCAAGAGGGGGACCCGCGGGTATAGCAGCTCGATATTTCAGACTAAGGATGTTTGACTACTGG	CARGGPAGIAARYFRLRMFDYW	IGHV1-45	IGHJ4
TGTGCGACCCCCTATTGTAGTGGTGGTAGCTGCTACCTTGCTTTTGATATCTGG	CATPYCSGGSCYLAFDIW	IGHV3-NL1	IGHJ3
TGTGCGAAAGATTTGGACTCCCCATATTGTGGTGGTGACTGCCGTTACTACTTTGACTACTGG	CAKDLDSPYCGGDCRYYFDYW	IGHV3-NL1	IGHJ4
TGTACCACGGCGGGGGACCCCGTTACTTTATTGTGTCAAAACCTTAGCAGCTCGGACTACTACTACTACTACATGGACGTCTGG	CTTAGDPVTLLCQNLSSSDYYYYYMDVW	IGHV3-15	IGHJ6
TGTGCGAGAGACCTCTGTAGTGGTGGTAGCTGCTACACTTACTACTGG	CARDLCSGGSCYTYYW	IGHV3-11	IGHJ4
TGTACTAGAGCCCACTATTACTATGGTTCAGGGAGTTATGACAAACTGAATTACTACTACTACTACTACATGGACGTCTGG	CTRAHYYYGSGSYDKLNYYYYYYMDVW	IGHV3-49	IGHJ6
TGTGCGCATCAGGAAAAGTGGATACAGCTATGGTTACGATGTAACGCCGCGTACTGG	CAHQEKWIQLWLRCNAAYW	IGHV1-3	IGHJ4
TGTGCGAAAGTGGACCGCGGATCATTACGATTTTTGGAGTGGTTATTATACTGGATGGGGAAGAACTATTACTACTACTACTACTACATGGACGTCTGG	CAKVDRGSLRFLEWLLYWMGKNYYYYYYYMDVW	IGHV3-NL1	IGHJ6
TGTGCGAGACGTCTCCCCTACGGTGACTACGTGTACATGGACGTCTGG	CARRLPYGDYVYMDVW	IGHV3-21	IGHJ6
TGTGCGAGAGAGACACGTATTACGATTTTTGGAGTGGTTATTACGGGCTACTACTACTACTACATGGACGTCTGG	CARETRITIFGVVITGYYYYYMDVW	IGHV3-7	IGHJ6
TGTGCGAGAGAAGAGCAGTGGCTGGTAATGGTTAGGAACTACTGG	CAREEQWLVMVRNYW	IGHV5-10-1	IGHJ4
TGTGCGAGAGGTTCTTACGATTTTTGGAGTGGTTATTGGCAAGTTCCTGTCTACTACTACTACTACATGGACGTCTGG	CARGSYDFWSGYWQVPVYYYYYMDVW	IGHV3-21	IGHJ6
TGTGCGACTAGTCGCGAAAATTGTAGTAGTACCAGCTGCTATGACCCCCTGTCCGAGGTGGGACACTGGTTCGACCCCTGG	CATSRENCSSTSCYDPLSEVGHWFDPW	IGHV3-11	IGHJ5
TGTACCACATCCCTTCGGTCCTTCGGGGGGAACAAGAATGTGACTACGCCCCACTACTACTACTACATGGACGTCTGG	CTTSLRSFGGNKNVTTPHYYYYMDVW	IGHV3-15	IGHJ6
TGTGCGAGATTTGTAGTGGTGGTAGCTGCTACACATTCCGACTACTGG	CARFVVVVAATHSDYW	IGHV1-2	IGHJ4
TGTACCACAGCCGTAGCAGTGGCTGGTACACCGTGCGACTACTGG	CTTAVAVAGTPCDYW	IGHV3-15	IGHJ4
TGTTTCATTTCGGGATGGTTCGGGGAGTTATTCATTCAATGCAACTGGTTCGACCCCTGG	CFISGWFGELFIQCNWFDPW	IGHV3-49	IGHJ5
TGTGCGAGAGCCGGAGTTCGGTTTATGATAGTAGTGGTTATTACTTCCGGTGCACGAGACTACTGG	CARAGVRFMIVVVITSGARDYW	IGHV4-61	IGHJ4
TGTGCGAAAGATGAGGGAGCTACTACCCGCTTCTACCTGCAGGACTACTGG	CAKDEGATTRFYLQDYW	IGHV3-NL1	IGHJ4
TGTGCGAGACCCTCACCCACCGATAGTAGTGGTTATTACTACACCGCCTGGGAACCACACAACTGGTTCGACCCCTGG	CARPSPTDSSGYYYTAWEPHNWFDPW	IGHV4-59	IGHJ5
TGTGCGAGAACTGGCTCAACTGGAATTTTGAAACCCCTACGTGACTACTGG	CARTGSTGILKPLRDYW	IGHV5-10-1	IGHJ4
TGTGCGAAATCCGGATATTGTAGTAGTACCAGCTGCTATTTCCAGTCGAGGTTCGACCCCTGG	CAKSGYCSSTSCYFQSRFDPW	IGHV3-23	IGHJ5
TGTGTAAACAAGGCTTCGAGTATAGCAGCTCGCAGTAACGCCGGGTCTCGTCAGGGGGCACTCGCTCTGTGCTTTGACTACTGG	CVNKASSIAARSNAGSRQGALALCFDYW	IGHV3-64	IGHJ4
TGTGCGAGAGATCAGTATAGCAGCAGCTGGTACCCCCGTCGAGACTACTGG	CARDQYSSSWYPRRDYW	IGHV1-2	IGHJ4
TGTGCGAGAGATGGAACCTATATAGCAGTGGCTTACTTTGACTACTGG	CARDGTYIAVAYFDYW	IGHV4-59	IGHJ4
TGTGCGAGAGCTTGTCTCCACGGGGCCTATAACTCTACCTGCTATTACTATGATAGTAGTGGTTATGATAGGGGGTACTACTTTGACTACTGG	CARACLHGAYNSTCYYYDSSGYDRGYYFDYW	IGHV1-18	IGHJ4
TGTGCGAAAGATCAGTTGCTGAGGTCACGTATTACGATTTTTGGAGTTTATTACTACTACTACTACTACATGGACGTCTGG	CAKDQLLRSRITIFGVYYYYYYYMDVW	IGHV3-NL1	IGHJ6
TGTGCGAGAGGATCGGCTTACGATTTTTGGAGTGGTTATTATTTGATCATGGTGTACTACTTTGACTACTGG	CARGSAYDFWSGYYLIMVYYFDYW	IGHV4-38-2	IGHJ4
TGTGCGAGATTGACAGAGGCGATACTAGGGCGGGTACCAGCTGCTATGGGGTACTACTACTACTACATGGACGTCTGG	CARLTEAILGRVPAAMGYYYYYMDVW	IGHV1-18	IGHJ6
TGTGCGGAACACCCCTACTGG	CAEHPYW	IGHV4-34	IGHJ4
TGTGCGAGAACTTGGGAGATTGTAGGGAATTCACTATATTGTAGTGGTGGTAGCCTTTCACTCCCCTACTGG	CARTWEIVGNSLYCSGGSLSLPYW	IGHV1-69	IGHJ4
TGTGCGAAAGGCCTTAGTATTACGATTTTTGGAGTGGTTATCCACACGCGTTGGGTACCAATTGACTACTGG	CAKGLSITIFGVVIHTRWVPIDYW	IGHV3-NL1	IGHJ4
TGTGCGAGAGGGTCCAGGTGTGGTGGTGACTGCTATTCTTCCCAGGCTCTGTACTACTTTGACTACTGG	CARGSRCGGDCYSSQALYYFDYW	IGHV3-64	IGHJ4
TGTGCGAGTCCACCCCGCAACTATGATAGTAGTGGTTACCCTCTCGACTTTGACTACTGG	CASPPRNYDSSGYPLDFDYW	IGHV1-46	IGHJ4
TGTGCGAGCACCAACGCGGATATTGTAGTGGTGGTAGCTGCTACAAGGAGAGGCGGCGTATTTGACTACTGG	CASTNADIVVVVAATRRGGVFDYW	IGHV3-11	IGHJ4
TGTGCGAGAGCGGAGTGGCTGGTACATGTGAGACCCCCCTACTACTACTACTACATGGACGTCTGG	CARAEWLVHVRPPYYYYYMDVW	IGHV4-59	IGHJ6
TGTATGGCCCCCTTCTTACCGTATAGCAGCAGCTGGTGGTCGACCTACTGG	CMAPFLPYSSSWWSTYW	IGHV3-NL1	IGHJ4
TGTGCGAGAGATGTGCTTCTTTATAGCAGCAGCTCCAGCTACTGG	CARDVLLYSSSSSYW	IGHV3-48	IGHJ4
TGTGCGAGAGCCTCACCTGTACCCTTGGAGGGAGATATTTTGACTGGTCAATCCCAGTTTGACTACTGG	CARASPVPLEGDILTGQSQFDYW	IGHV3-7	IGHJ4
TGTGCGAAATATGGGGCCGGACGTATAGCAGTGGACCTATTTGACTACTGG	CAKYGAGRIAVDLFDYW	IGHV3-NL1	IGHJ4
TGTGCGAGAGTACCCCGGGATTTTTGGAGTGGAATTCCTGACTACTGG	CARVPRDFWSGIPDYW	IGHV4-4	IGHJ4
TGTGCGAAAGGAACCATTGGCAGTAGTACCAGCTGCTATGCTGGGCTAGCACTATGG	CAKGTIGSSTSCYAGLALW	IGHV3-23	IGHJ5
TGTGCGAAAGATCACGGGGGCCAGGCCGTATTACGATTTTTGGAGTGGTTATTATACAGCTTCGCCCACGATTATTACTACTACTACTACTACATGGACGTCTGG	CAKDHGGQAVLRFLEWLLYSFAHDYYYYYYYMDVW	IGHV3-23	IGHJ6
TGTGCGAGAGATGGTTTATTGTACTGGTGGTGTATGCTATTGTACTACTTTGACTACTGG	CARDGLLYWWCMLLYYFDYW	IGHV4-4	IGHJ4
TGTGCACACAGACTCCGAAGGAGGTGCGAAACCGGTACCCAGCAGCTCGTCTCAGAGCGAGGTAACTACTACTACTACATGGACGTCTGG	CAHRLRRRCETGTQQLVSERGNYYYYMDVW	IGHV2-5	IGHJ6
TGTGCGGGGCCAAAATGTAGTAGTACCAGCTGCAGTTGGTTCGACCCCTGG	CAGPKCSSTSCSWFDPW	IGHV3-7	IGHJ5
TGTGCGAGACGGGGTCCAGGACATACCTACGGTGACTACGTGCCTCGAGGGCATCCCTACTGG	CARRGPGHTYGDYVPRGHPYW	IGHV5-51	IGHJ4
TGTGCGAGAGAAATCATTTTAGTAGTACCAGCTGCTATGCCCGATACCAAGTGCTGG	CAREIILVVPAAMPDTKCW	IGHV4-34	IGHJ5
TGTCCCCGACGAGGACCGTATGATAGTAGTGGTTTCCTAATAAGGGACTTCGTCACTGACTACTGG	CPRRGPYDSSGFLIRDFVTDYW	IGHV3-30-3	IGHJ4
TGTGCGAAAGAACTAGGTACGATTTTTGGAGTGGTTATTATAAAGGTTTTTAGTCCACAGTTTGACTACTGG	CAKELGTIFGVVIIKVFSPQFDYW	IGHV3-23	IGHJ4
TGTGCACGGCCGAATACCCCGGGTCGTTCACTCGCCCCTATACTTTGCTTTTACTACTACATGGACGTCTGG	CARPNTPGRSLAPILCFYYYMDVW	IGHV2-26	IGHJ6
TGTACTAGGGCCTGGATTACTATTACTATGATAGTAGTGGTTATTACTTGCGGGAAACCGGTTGACTACTGG	CTRAWITITMIVVVITCGKPVDYW	IGHV3-49	IGHJ4
TGTGCGAAAGGCGGCTTAGATTGTAGTAGTACCAGCTGCCCACTATTCTTTTTCTACTGG	CAKGGLDCSSTSCPLFFFYW	IGHV3-NL1	IGHJ4
TGTGCGAGAGATCTCCTTAGAGGATATTGTAGTGGTGGTAGCTGCTTAGGAAAACAAAGGCAAGACGGTACCCGGTTAACCGGCTACTGG	CARDLLRGYCSGGSCLGKQRQDGTRLTGYW	IGHV1-2	IGHJ4
TGTACCAGCGGGGAAAACGTATTACTATGGTTCGGGGGGAGATTCCGGTTGGCCTTTGACTACTGG	CTSGENVLLWFGGRFRLAFDYW	IGHV3-15	IGHJ4
TGTGCGAGAGGTAGCAGCAGCTGGTACAACCGGTTTGACTACTGG	CARGSSSWYNRFDYW	IGHV3-7	IGHJ4
TGTGCGAGAGAGAGGACTATGGTTCAGGGAGTTATTATAACGTGGTCTGATGATGCTTTTGATATCTGG	CARERTMVQGVIITWSDDAFDIW	IGHV1-2	IGHJ3
TGTGCACGGATGACATATTGTAGTGGTGGTAGCTGCTACTCGAGGAGCAATCATAGTGACTACTGG	CARMTYCSGGSCYSRSNHSDYW	IGHV2-70	IGHJ4
TGTGCGAGAGATCGTACAGTCATTATGATTACATTTGGGGGAGTTATCGGGGATTATTACTACTTTGACTACTGG	CARDRTVIMITFGGVIGDYYYFDYW	IGHV1-18	IGHJ4
TGTACCACAGATCGTCAGGATACTTCGAGTATAGCAGCTCGTCTGCGGGTTCACTGGTTCGACCCCTGG	CTTDRQDTSSIAARLRVHWFDPW	IGHV3-15	IGHJ5
TGTGCGAGACCCCGGAGAAATAGCAGTGGCTGCTGGGGGGAGGGGACCCAAAAGTTCTTAAGGTTTGGGTTGAGGAATGATGCTTTTGATATCTGG	CARPRRNSSGCWGEGTQKFLRFGLRNDAFDIW	IGHV7-4-1	IGHJ3
TGTGCAAGAGGGATGCAGGAGCAGCAGCATTACTACTACTACTACATGGACGTCTGG	CARGMQEQQHYYYYYMDVW	IGHV1-45	IGHJ6
TGTACGAACCGCTCTATTGTAGTAGTACCAGCTGCCCCTGACTACTGG	CTNRSIVVVPAAPDYW	IGHV3-49	IGHJ4
TGTGCGAGAGATCTGATTTTTGGAGTGGTCGGCTTTGACTACTGG	CARDLIFGVVGFDYW	IGHV3-21	IGHJ4
TGTGCGAGTATAGCAGCAGCTGGTACATTACGGACCTGG	CASIAAAGTLRTW	IGHV4-39	IGHJ4
TGTGCGAGAGGGGACCCTACCTTTGACTACTGG	CARGDPTFDYW	IGHV5-51	IGHJ4
TGTGCGAGGGGACAAAGCGGGTATAGCAGTGGCTGGTACTTCAATACGTTTCTCTACTGG	CARGQSGYSSGWYFNTFLYW	IGHV4-28	IGHJ4
TGTGCGAAAGGCACCGGGGATACAGCTATGGTTGCGCGACAATTTGACTACTGG	CAKGTGDTAMVARQFDYW	IGHV3-NL1	IGHJ4
TGTGCGAGAATGGAAGGCAAAGATAGCAGTGGCTGGTACAACTTTGACTACTGG	CARMEGKDSSGWYNFDYW	IGHV1-2	IGHJ4
TGTGCGAAAAAAGTACGCTTTAGTGTAAGGGCTCCCCGTGTTATTGTAGTAGTACCAGCTGCTATCAAGGTCTGGAACTGGTTCGACCCCTGG	CAKKVRFSVRAPRVIVVVPAAIKVWNWFDPW	IGHV3-23	IGHJ5
TGTGCGAGAGACCGGTCTTCCTGTTATTACTATGATAGTAGTGGTTCCAAAGGAGGCGCGAACTACTGG	CARDRSSCYYYDSSGSKGGANYW	IGHV3-7	IGHJ4
TGTGCACGGACGTCACACGCCGGAAGATGGAGACCCGGAGAGCAGTATAACTGGAACGACGACAACGCGCCGGGAGACTACTGG	CARTSHAGRWRPGEQYNWNDDNAPGDYW	IGHV2-70	IGHJ4
