TGTGCGAGAGCGGAAGTTTTGTGTAGTGGTGGTAGCTGCCGACGAACTTCACGGGGATCCTACTACTACTACTACATGGACGTCTGG	CARAEVLCSGGSCRRTSRGSYYYYYMDVW	IGHV3-53	IGHJ6
TGTGCGAGACCGCCCAAAAGGCGTATTACTATGGTTCGGGGAGTTATTATTAGTCAGCCCCGGTTCGACCCCTGG	CARPPKRRITMVRGVIISQPRFDPW	IGHV7-4-1	IGHJ5
TGTGCGAAAGATCCCAAATATCAGCGATTTTTGGAGTGGTTATTTGCACACTTTGACTACTGG	CAKDPKYQRFLEWLFAHFDYW	IGHV3-23	IGHJ4
TGTGCAACTCCTCGTCGCAGGTTGGGGGATGACGTGATTCCTCCCTGG	CATPRRRLGDDVIPPW	IGHV1-24	IGHJ4
TGTGCGAGAGATCTCTCTAACATTTACTATGATAGTAGTGGTTATCCATGTTTTGACTACTGG	CARDLSNIYYDSSGYPCFDYW	IGHV3-7	IGHJ4
TGTGCGAGAGGATATTGTAGTGGTGGTAGCTGCTCCCGCTGGTTCGACCCCTGG	CARGYCSGGSCSRWFDPW	IGHV3-53	IGHJ5
TGTGGGGCAGTGGCTGGTACCGTGGACTACTGG	CGAVAGTVDYW	IGHV1-8	IGHJ4
TGTGCGAAAGATCACCTATATTGTAGTGGTGGTTGGCCCAACCTACAGACGTTACCCGGCTGG	CAKDHLYCSGGWPNLQTLPGW	IGHV3-23	IGHJ5
TGTGCGAGTCTACCTAGCAGCTCGTCCTTCGTTACTAGGCCGTACTACTACTACTACATGGACGTCTGG	CASLPSSSSFVTRPYYYYYMDVW	IGHV1-18	IGHJ6
TGTGCGAAAGTCATTCCCTGTATAGCAGTGGCTGGTACGTACACTTGGGGCAACTGGTTCGACCCCTGG	CAKVIPCIAVAGTYTWGNWFDPW	IGHV3-23	IGHJ5
TGTGCGAGAGCGGATATTGTAGTGGTGGTAGCTGCTACTCAGGGATCCGATCACTACTACTACTACATGGACGTCTGG	CARADIVVVVAATQGSDHYYYYMDVW	IGHV4-4	IGHJ6
TGTGCGAAGTATTACGATTTTTGGAGAGACTACTACTACTACTACATGGACGTCTGG	CAKYYDFWRDYYYYYMDVW	IGHV3-20	IGHJ6
TGTGCAACAGAACGTATTACTATGGTTCGGGGAGTTATTATAAATCGGCTGGCGACCTGG	CATERITMVRGVIINRLATW	IGHV1-24	IGHJ4
TGTGCGAGACGTGGCCCCCGGCGATATTACTATGGTTCAGGGAGTTATTACGTACCGGCTCACATGGACGTCTGG	CARRGPRRYYYGSGSYYVPAHMDVW	IGHV4-61	IGHJ6
TGTGCAAGAGGGTGTTTTTACGATTTTTGGAGTGGGCCGATGGACGTCTGG	CARGCFYDFWSGPMDVW	IGHV3-74	IGHJ6
TGTGCGAGAGAAACTACTATTGTAGTAGTACCAGCTGCGGAGAACCCTTTCCGGTACTGCACTTCGTGTTACTACTACTACTACTACATGGACGTCTGG	CARETTIVVVPAAENPFRYCTSCYYYYYYMDVW	IGHV4-38-2	IGHJ6
TGTGCAACAGCGAAGCCGTATTACGATATTTTGACTGGTTATAACGTTGACTACTGG	CATAKPYYDILTGYNVDYW	IGHV1-24	IGHJ4
TGTGCGAGAGATGTTGGCATAAAACCGCGACGGCAGCAGTGGCTGGTACACTGG	CARDVGIKPRRQQWLVHW	IGHV1-2	IGHJ4
TGTGCGAGACGGGAACTGTTGCGATGCAATTTTATTGGAACTTCGTCGGATATTGTAGTAGTACCAGCTGCTATAGTCCCAATAAGGCTTGAGGTGCTCCCGCACAACTGGTTCGACCCCTGG	CARRELLRCNFIGTSSDIVVVPAAIVPIRLEVLPHNWFDPW	IGHV4-39	IGHJ5
TGTGCGAAATTTAGGAGAGGGTATTACGATTTTTGGAGTGGTTATTATAGAGCTCTTCACATGGACGTCTGG	CAKFRRGYYDFWSGYYRALHMDVW	IGHV3-NL1	IGHJ6
TGTGCAAGACCTAGTGGTATTATGATTACATTTGGGGGAGTTATCGTTCAAAGGTGGAATACACTCTTGTTCCACTGGTACTTCGATCTCTGG	CARPSGIMITFGGVIVQRWNTLLFHWYFDLW	IGHV3-13	IGHJ2
TGTGCGAGAGGCCATGGTAGCTGCTACATCAGCCTTTACTTTGACTACTGG	CARGHGSCYISLYFDYW	IGHV4-34	IGHJ4
TGTGCGAGCCCCAGTTGGAAGATAGTGGGAGCTACTACGTACCGGCCACCCGGCCCCTTCTGG	CASPSWKIVGATTYRPPGPFW	IGHV5-51	IGHJ3
TGTACCAGTGGGACTTTACGATATTTTGACTGGTTATTAACAACACTATCGGACTACTGG	CTSGTLRYFDWLLTTLSDYW	IGHV3-15	IGHJ4
TGTGCGAGAGACGGGGCTTTTGACTACTGG	CARDGAFDYW	IGHV4-59	IGHJ4
TGTGCGAGAGGGGGGAGGGAGATTTTTGGAGTGGTTATTATACCTCATGACTACTGG	CARGGREIFGVVIIPHDYW	IGHV1-8	IGHJ4
TGTGCGAGACAGACACGGGAGCTACTTCCCCCGCCGTACAACTGGTTCGACCCCTGG	CARQTRELLPPPYNWFDPW	IGHV5-51	IGHJ5
TGTGCGAGCGACCTAAGGCAGCTCGCAGACTACTGG	CASDLRQLADYW	IGHV3-48	IGHJ4
TGTGCGAAAGAGTATTGTACTGGTGGTAGAAGTCACTACTTTGACTACTGG	CAKEYCTGGRSHYFDYW	IGHV3-23	IGHJ4
TGTGCGAGAGGAGGATTGATTACATTTGGGGGAGTTATCGTTAGCTCCACCCGCCAGGTCCAGAACTACTGG	CARGGLITFGGVIVSSTRQVQNYW	IGHV4-4	IGHJ4
TGTGCACGGATTCCCCGGACAAGTGGCTACGATTCTCCCCGGGGAAGACACTACTACTACATGGACGTCTGG	CARIPRTSGYDSPRGRHYYYMDVW	IGHV2-70	IGHJ6
TGTGCGAGAGATGGGAAAGGGAGGGAGCTACGTATGGTTGACTACTGG	CARDGKGRELRMVDYW	IGHV3-7	IGHJ4
TGTGCAAGAGATAGTCCCCATTACTATGATAGTAGTGGTTCCGGTGGTGCTTTTGATATCTGG	CARDSPHYYDSSGSGGAFDIW	IGHV3-74	IGHJ3
TGTGCGAGAGCAGGATGGAAACAGCCACTAGGTGGAGGGGACTACTTTGACTACTGG	CARAGWKQPLGGGDYFDYW	IGHV1-3	IGHJ4
TGTGCACACAGACGGCCTTTTCTAGCAGTGGCTGGTACTGGCTTTGACTACTGG	CAHRRPFLAVAGTGFDYW	IGHV2-5	IGHJ4
TGTGCGAGAGATCACCTGGACGTTATTACGATTTTTGGAGTGTTTCCCTACTACATGGACGTCTGG	CARDHLDVITIFGVFPYYMDVW	IGHV3-66	IGHJ6
TGTGCGAGAGGCCAAACGGATATTGTACTAATGGTGTATGCGTTTTTGGACCACCCCGCCTTTGACTACTGG	CARGQTDIVLMVYAFLDHPAFDYW	IGHV4-34	IGHJ4
TGTGCGAGAGAGCGGCAGCAGCTGGTACGCCTGGAACCCTACTGG	CARERQQLVRLEPYW	IGHV3-11	IGHJ4
TGTGCGAAAGGTTCACTAAGGGGGTATTGTAGTAGTACCAGCTGCTATACGGGCAAATACTACTACTACATGGACGTCTGG	CAKGSLRGYCSSTSCYTGKYYYYMDVW	IGHV3-23	IGHJ6
TGTGCAAAAGATGTCATACGATTTTTGGAGTGGTTATTATATTTGTCCGTATACTACTACTACTACTACATGGACGTCTGG	CAKDVIRFLEWLLYLSVYYYYYYMDVW	IGHV3-43	IGHJ6
TGTGCAAAAGATTTACCATTTTCTATGGTTCAGGGAGTTATTTATTCGCTTCCAACTCGAGACTACTGG	CAKDLPFSMVQGVIYSLPTRDYW	IGHV3-43D	IGHJ4
TGTGCGAGAGATCGAGAGTTTTTTGGAACTTCTCGACACATAACCATAGCAGCATCGACCGAGCGCTACTGG	CARDREFFGTSRHITIAASTERYW	IGHV4-59	IGHJ4
TGTGCGAGAGAGGGGGGTACTATGATAGTAGTGGTTATTACTGGGGGGAAACACTTTGACTACTGG	CAREGGTMIVVVITGGKHFDYW	IGHV4-4	IGHJ4
TGTGCGAAAGATCGGATCATTTTAGCTCTCACCCAGGTGGGGAACGATTTTTGGCTCGATGACTACTGG	CAKDRIILALTQVGNDFWLDDYW	IGHV3-23	IGHJ4
TGTGCGAGGGGTTATTTACCCTACACCTCGATAGCAGTGGCTGGTACTTTCTGGTTCGACCCCTGG	CARGYLPYTSIAVAGTFWFDPW	IGHV4-39	IGHJ5
TGTGCGAGGGACGCGTCCAAGTATAGCAGTGGCTGGTACCCATGGAAAGGGTCGAGTGTCCTGTTATTACTGGCTTACTTTGACTACTGG	CARDASKYSSGWYPWKGSSVLLLLAYFDYW	IGHV1-3	IGHJ4
TGTGCGAGAGATGGGATAGGATCCTTACGACCGTATAGCAGTGGCTGGTACCGAACCTACTTTGACTACTGG	CARDGIGSLRPYSSGWYRTYFDYW	IGHV3-21	IGHJ4
TGTGCGAAAGGTTCTCGTATAGCAGCAGCTGGTACGAGAGGGGTTCGGTACTACTTTGACTACTGG	CAKGSRIAAAGTRGVRYYFDYW	IGHV3-23	IGHJ4
TGTGCGAGACCGAGGGGAACGGTAGTACCAGCTGCTATCCACTACTACTACTACATGGACGTCTGG	CARPRGTVVPAAIHYYYYMDVW	IGHV5-10-1	IGHJ6
TGTGCGAATTGGGCACGCGGCGGCTCTTCCGATGCTTTTGATATCTGG	CANWARGGSSDAFDIW	IGHV4-4	IGHJ3
TGTGCGAGAGATTATAGGGGGGTGGCTGGGCGGGGGATTGACTACTGG	CARDYRGVAGRGIDYW	IGHV1-3	IGHJ4
TGTGCGAGAGTGTTTCAAACAGGTTTGGAGTGGTTATTTGGTTGGTCCTTTGACTACTGG	CARVFQTGLEWLFGWSFDYW	IGHV3-11	IGHJ4
TGTGCGAGAGGTCGCTATTGTGGTGGTGACTCTTCGGACTGCTACTGG	CARGRYCGGDSSDCYW	IGHV3-53	IGHJ4
TGTGCGAAAGATCATATAGCAGCAGCTGGTACCTTTGACTACTGG	CAKDHIAAAGTFDYW	IGHV3-NL1	IGHJ4
TGTGCGAAGGGGAAAAAGAGCAGTGGCTGGGACTACTGG	CAKGKKSSGWDYW	IGHV3-23	IGHJ4
TGTGCGAAAGATAGTTATATTACGATTTTTGGAGTGGTTACCCCCGATGCTCTGTACAACTGGTTCGACCCCTGG	CAKDSYITIFGVVTPDALYNWFDPW	IGHV3-NL1	IGHJ5
TGTGCGAGAGTCAGGCCCGAGGTGGTGCCCAGGACTCCCCCCCACTACTACTACTACTACATGGACGTCTGG	CARVRPEVVPRTPPHYYYYYMDVW	IGHV1-46	IGHJ6
TGTGCGAGAGATCCCAGCTCGCAGCCTCGGTGTGGCCTCCTTAGCTGCTACTTCCGCACTTGCGTCGGTAAGGCGAGTAACTGGTTCGACCCCTGG	CARDPSSQPRCGLLSCYFRTCVGKASNWFDPW	IGHV4-59	IGHJ5
TGTGCACCGGACCTAAACGCAGCAGCTGGTACGAGACAGGTTTACTACTTTGACTACTGG	CAPDLNAAAGTRQVYYFDYW	IGHV2-5	IGHJ4
TGTGCGAGAGATGGTCCGAGGCCCGGGAGCTACGATGCTTTTGATATCTGG	CARDGPRPGSYDAFDIW	IGHV3-11	IGHJ3
TGTGCGAAAGGTAACATTGCACGTGGATACAGCTATGGTTACGTCATTCTAACCATGTTTACTTCTGACTACTGG	CAKGNIARGYSYGYVILTMFTSDYW	IGHV3-23	IGHJ4
TGCGTCCTTTATAGCAGCCCCCGAGTAATACACTACTTTGACTACTGG	CVLYSSPRVIHYFDYW	IGHV3-74	IGHJ4
TGTGCGAAAGGGGGAGAGATTTTTGGAGTGGATGCGTGCCCCTGG	CAKGGEIFGVDACPW	IGHV3-NL1	IGHJ4
TGTGCGAGCCCCTGCCGGTATTACGATATTTTGACTGGTTATATACTTTACTTTGACTACTGG	CASPCRYYDILTGYILYFDYW	IGHV4-34	IGHJ4
TGTGCAAAAGATATGAGTTCCTTTTCCCATAGCAGCAGCTGGTCTGGTTCTTACTTTGACTACTGG	CAKDMSSFSHSSSWSGSYFDYW	IGHV3-43	IGHJ4
TGTGCAAATCACCGAATCCTCCCGGACTACTTTGACTACTGG	CANHRILPDYFDYW	IGHV3-43	IGHJ4
TGTGCGAAAGATCCCTGGGGTAGCTTTGACTACTGG	CAKDPWGSFDYW	IGHV3-NL1	IGHJ4
TGTGCGAGAGCCCTAGCAGTGGCTGGTACGTACCAACTCTCATTGGGGACGCATCCGTTTGACTACTGG	CARALAVAGTYQLSLGTHPFDYW	IGHV5-10-1	IGHJ4
TGTGCGAAAGATCAACGGGCAGATATTACTATGATAGGGTGCAACTGGTTCGACCCCTGG	CAKDQRADITMIGCNWFDPW	IGHV3-23	IGHJ5
TGTGCGAAAACGGTGGTCAGGTTCTTATGGTTCAGGGAGTTCTCTGACTACTGG	CAKTVVRFLWFREFSDYW	IGHV3-NL1	IGHJ4
TGTGCAAGACCGAATGCAGTGTACGGTGGTAACCCAAGAGGGTTCCGGGCTGCCCCTTCCCCCATCCTTGACTACTGG	CARPNAVYGGNPRGFRAAPSPILDYW	IGHV3-13	IGHJ4
TGTGCGAAAGTGTTCATTACTATGATAGTAGTGGTTGGGCTCTCATGGTTCGACCCCTGG	CAKVFITMIVVVGLSWFDPW	IGHV3-NL1	IGHJ5
TGTGCACGGATACCAAAGGGGGCAGTGGCTGGTACTGAAAATCCGTGCCCACAGGAACGGTTCCGGGACCCTGACTACTGG	CARIPKGAVAGTENPCPQERFRDPDYW	IGHV2-26	IGHJ4
TGTACTAGACGGCAAACGGGATATTGTAGTGGTGGTAGCTGCTACTCTGTGGAAAACGTCCGTCCCCGGGCTGACTACTGG	CTRRQTGYCSGGSCYSVENVRPRADYW	IGHV3-49	IGHJ4
TGTGCCCAGTCAGTCCCTGACTACTGG	CAQSVPDYW	IGHV3-30-3	IGHJ4
TGTGCGAGCCTCCGACCTATTGTAGTGGTGGTAGCTGCTACGTCGGTTAACTACTACTACTACATGGACGTCTGG	CASLRPIVVVVAATSVNYYYYMDVW	IGHV1-3	IGHJ6
TGTGCAAGAGATGCAGGACTCAACATAGTAGTACCAGCTGCTTCAGGGGTGGAGAATTACTACTACTACTACTACATGGACGTCTGG	CARDAGLNIVVPAASGVENYYYYYYMDVW	IGHV3-13	IGHJ6
TGTGCAAGGGTTCCTTACGCGGTTAATCTCCGGATTTGTAGTGGTGGTAGCTGCAGCTACCTAGGTGTTAAAAAGATCCAAGGGGTCCCATACTTCCAGCACTGG	CARVPYAVNLRICSGGSCSYLGVKKIQGVPYFQHW	IGHV3-13	IGHJ1
TGTGCGAAAGATGCTGCCAGACCCCCTCAATATTGTAGTGGTGGTAGCTGCTACTCAGATGGCCGTCCTAACAACTGG	CAKDAARPPQYCSGGSCYSDGRPNNW	IGHV3-23	IGHJ5
TGTGCGAGAGAGAGATGTATAGCAGTGGCTGGTACGAAGTTTGACTACTGG	CARERCIAVAGTKFDYW	IGHV7-4-1	IGHJ4
TGTGCGAGACTATCCCGACCTCCCTGCCAGGTTTTCTGGGTAACCGAAAAATGTACTCCTCACGTATTACTATGGTTCAGGGACTTTGACTACTGG	CARLSRPPCQVFWVTEKCTPHVLLWFRDFDYW	IGHV4-61	IGHJ4
TGTGCAAGAGCGTTCTCGGCGATATTACGATATTTTGACTGGTTATTTTTTACTCGGTCTGGTTGGAACTGGTTCGACCCCTGG	CARAFSAILRYFDWLFFTRSGWNWFDPW	IGHV3-74	IGHJ5
TGTGCGAGATGGACGTATTACGATTTTTGGAGTGGTTATTATAACTGGTACTTCGATCTCTGG	CARWTYYDFWSGYYNWYFDLW	IGHV1-18	IGHJ2
TGTGCACACAGACGTGTTTCCATTGAGCAGCAGCTGGACCTCCTTGACTACTGG	CAHRRVSIEQQLDLLDYW	IGHV2-5	IGHJ4
TGTGCGAAACGTCACTACCACGTGGATATAGTGGCTACGATCGCGCACCTCAGAGTACACTACTACTACTACATGGACGTCTGG	CAKRHYHVDIVATIAHLRVHYYYYMDVW	IGHV3-23	IGHJ6
TGTGCGAGAGATTCAATCACGCCGCCGTGCTACTGG	CARDSITPPCYW	IGHV3-11	IGHJ4
TGTGCGAAAGCTATGTGTAGTGGTGGTAGCCCCCTCCAGAACTGGTTCGACCCCTGG	CAKAMCSGGSPLQNWFDPW	IGHV3-23	IGHJ5
TGTGCGAAAGATATACGGCAGGAGGGCAGCAGCTGGTATAACAACTGGTTCGACCCCTGG	CAKDIRQEGSSWYNNWFDPW	IGHV3-23	IGHJ5
TGTGCAAGAGAGAAGTTACGATTTTTGGAGTGGTTATTCTACTACTACTACATGGACGTCTGG	CAREKLRFLEWLFYYYYMDVW	IGHV3-13	IGHJ6
TGTGCGAAAGGGTACCCGGGTATAGCAGCAGCTGGGGATTACTACTACTACTACTACATGGACGTCTGG	CAKGYPGIAAAGDYYYYYYMDVW	IGHV3-NL1	IGHJ6
TGTGCAAGAGGTAGCTTTAGTATTGTAGTGGTGGTAGCTGCTACTCAAAGCTTTGACTACTGG	CARGSFSIVVVVAATQSFDYW	IGHV1-45	IGHJ4
TGTGCGAGAGTAGGGCACCCCCCCAACTGGTTCGACCCCTGG	CARVGHPPNWFDPW	IGHV7-4-1	IGHJ5
TGTGCGAGACATACGATTTTTGGAGTGGTTATTACCCGCTGGTTCGACCCCTGG	CARHTIFGVVITRWFDPW	IGHV4-39	IGHJ5
TGTGCGAGACAACATAGCAGCAGCTGTCTCATGGGGGTCTCAACAAAACCCCGCAATGCTTTTGATATCTGG	CARQHSSSCLMGVSTKPRNAFDIW	IGHV5-51	IGHJ3
TGTGCCGCTGTCCCACGATTTTTGGAGTGGTTATTACCGGTTGACTACTGG	CAAVPRFLEWLLPVDYW	IGHV3-11	IGHJ4
TGTACCACAGTGGCTGATTCGCGAGGGAGGGATATTGTAGTGGTGGTAGCTGCTACTGGGGTGGCGGGTGGGACCTTAGGGGGTGTGGTTGACTGG	CTTVADSRGRDIVVVVAATGVAGGTLGGVVDW	IGHV3-15	IGHJ1
TGTGCACGGGGGTCTATTACTATGATAGTAGTGGTTACAACGGAGCTACCGGGCGGAGGGACAAAAGCGTCCAACTACTGGTACTTCGATCTCTGG	CARGSITMIVVVTTELPGGGTKASNYWYFDLW	IGHV2-26	IGHJ2
TGTGCGAGAGATCCCCGTAAGTCGCATTACATTTGGGGGCCAGCAATTGACTACTGG	CARDPRKSHYIWGPAIDYW	IGHV3-7	IGHJ4
TGTGCGGGGTACCACCTTTTCCGGACTACGGTGACTTTTGACTACTGG	CAGYHLFRTTVTFDYW	IGHV1-18	IGHJ4
TGTGCGAGCGGGGGAGGATATTGTACTGGTGGTGTATGCTATGATAAAGTTGGCTGGGTCCACTACTACTACTACATGGACGTCTGG	CASGGGYCTGGVCYDKVGWVHYYYYMDVW	IGHV3-11	IGHJ6
