TGTGCGAGGCCCGACCGAGTGGTTCATTGTAGTGGTGGTAGCTGCGGACTTCCTTGGTACAACTGGTTCGACCCCTGG	CARPDRVVHCSGGSCGLPWYNWFDPW	IGHV3-7	IGHJ5
TGTGCGAGAGATGAGGGGGCCCCAGCTGCTACCCCGCTATGG	CARDEGAPAATPLW	IGHV1-3	IGHJ5
TGTGCACACAGACAGATCACATTACGATTTTTGGAGTGGTTACCTCTTCTAGGCTACTACTACTACATGGACGTCTGG	CAHRQITLRFLEWLPLLGYYYYMDVW	IGHV2-5	IGHJ6
TGTGCAAGACTGAACATCATAGCAGCTCGTCACTGGTACTTCGATCTCTGG	CARLNIIAARHWYFDLW	IGHV1-45	IGHJ2
TGTGCACACAGACGCTCTATGATAGTAGTGGTTCCCTTTGACTACTGG	CAHRRSMIVVVPFDYW	IGHV2-5	IGHJ4
TGTGCGGGGGGCAGGGGATATTGTAGTAGTACCAGCTGCCGGCCATGGAACTGGTTCGACCCCTGG	CAGGRGYCSSTSCRPWNWFDPW	IGHV1-2	IGHJ5
TGTGCGACTGGGGGGCGATCCGCCATCCCGGATATTGTAGTAGTACCAGCTGCTATGGATGGGGAGTACTACTTTGACTACTGG	CATGGRSAIPDIVVVPAAMDGEYYFDYW	IGHV4-38-2	IGHJ4
TGTGCGAAAGTGTATTACTATGATAGTAGTGGTTATTCCTTTTTTGACTTTGACTACTGG	CAKVYYYDSSGYSFFDFDYW	IGHV3-23	IGHJ4
TGTGCAAGAGATCTGTGTCAGGGGAGTGGTTATTTTCTTTTTGACTACTGG	CARDLCQGSGYFLFDYW	IGHV3-74	IGHJ4
TGTGCAAGGACCTTCATGACCCGGTTTTTGGAGTGGTTACGACCCCTTGACTACTGG	CARTFMTRFLEWLRPLDYW	IGHV3-74	IGHJ4
TGTGCGAGGTTGGTATATAGTGACGCACGGGGAGTTATCGTTTACTACTACTACATGGACGTCTGG	CARLVYSDARGVIVYYYYMDVW	IGHV4-4	IGHJ6
TGTGCGAGAATTACGTTTGGGGGAGTTATCGTTGGGCACTTTGACTACTGG	CARITFGGVIVGHFDYW	IGHV4-4	IGHJ4
TGTGCGAGCCGGTATAGCAGTGGCTGGTACTCTCTCTTTGACTACTGG	CASRYSSGWYSLFDYW	IGHV1-69	IGHJ4
TGTGCAAGGGACGGAAGCTCGATTTTTGGAGTGGTTATTATGGAGGGAGACTACTGG	CARDGSSIFGVVIMEGDYW	IGHV6-1	IGHJ4
TGTGCGAGAGATAGACCAGAATCGCCTATTATGATTACATTTGGGGGAGTTATCGTCGACTACTGG	CARDRPESPIMITFGGVIVDYW	IGHV3-20	IGHJ4
TGTGCGAGGGGGAGCCCGGACCTTGTAGTAGTACCAGCTGGTTCGGGACCCCGTTACTTCCAGCACTGG	CARGSPDLVVVPAGSGPRYFQHW	IGHV3-7	IGHJ1
TGTGCGAGAGATCCCGGCTACGGTGACTACTCCTTCGACTTTGACTACTGG	CARDPGYGDYSFDFDYW	IGHV3-53	IGHJ4
TGTGCACACAGGTTGTCGGTAGGATATTGTAGTGGTGGTAGCTGCAGGGGCTACTTTGACTACTGG	CAHRLSVGYCSGGSCRGYFDYW	IGHV2-5	IGHJ4
TGTGCGAGAGCCCCCGGGTTTATTACTATGGTTCGGGGAGTTGTAGGGCCGGGCTTTGACTACTGG	CARAPGFITMVRGVVGPGFDYW	IGHV1-3	IGHJ4
TGTGCGAGAGTCCCGAGAGATATTGTACTAATGGTGTATGCTATAGGTAACTGGTTCGACCCCTGG	CARVPRDIVLMVYAIGNWFDPW	IGHV4-59	IGHJ5
TGTGCGAGAGCGGGAAGAGGATCCAACTACTGG	CARAGRGSNYW	IGHV4-38-2	IGHJ4
TGTGCGAAACCCCGGAAATATCTTATTGTAGTAGTACCAGCTGCTATACAACAGGGAATCCTCTGGTTCGACCCCTGG	CAKPRKYLIVVVPAAIQQGILWFDPW	IGHV3-NL1	IGHJ5
TGTGCACGGATACCGCAAACCCTTCATTTGGGGGAGTTATCAAGGGGGGTGGAGCATGATGCTTTTGATATCTGG	CARIPQTLHLGELSRGVEHDAFDIW	IGHV2-70	IGHJ3
TGTGCGAGAACTACGGTGGTAACTCAATGGGACCCAGTTTTTGACTACTGG	CARTTVVTQWDPVFDYW	IGHV4-38-2	IGHJ4
TGTGCGAGTTGTCGTTCAGCTCGCGATTTTTGGAGTGGTTACTTAACAGATGCTTTTGATATCTGG	CASCRSARDFWSGYLTDAFDIW	IGHV4-39	IGHJ3
TGTGCACGGATATGGGCGGCTTGTAGTGGTGGTAGCTGCTGGTCCTACCAAATACTCTGG	CARIWAACSGGSCWSYQILW	IGHV2-26	IGHJ4
TGTGCGAGACATACCCACCTCCATGTAGTAGTACCAGCTGCTATGGGCACGTATCGAAACTGGTTCGACCCCTGG	CARHTHLHVVVPAAMGTYRNWFDPW	IGHV5-51	IGHJ5
TGTACTGGGGGTATAGCAGTGGCTGGTACCTACTGG	CTGGIAVAGTYW	IGHV3-49	IGHJ4
TGTGCGAGTGAAAGTATTACGATTTTTGGAGTGGTTATTATACATTGG	CASESITIFGVVIIHW	IGHV4-34	IGHJ5
TGTGCAAGAGTCGATTTTTGGAGTGGTACGTATTACTACTACTACTACATGGACGTCTGG	CARVDFWSGTYYYYYYMDVW	IGHV3-74	IGHJ6
TGTGCGAGGTGTTGGAAGCGTTGGTTCGGGGAGGTTGACTACTGG	CARCWKRWFGEVDYW	IGHV3-21	IGHJ4
TGTACTAGAGATATTCAAGTCTATATTGTAGTGGTGGTAGCTGCTACTCGTGACTACTGG	CTRDIQVYIVVVVAATRDYW	IGHV3-49	IGHJ4
TGTGCACACAGAAAGAGTGGTGGTAGCTGCTACTCAGACGAGCCCTGGTTCGACCCCTGG	CAHRKSGGSCYSDEPWFDPW	IGHV2-5	IGHJ5
TGTGCGAGATTGGGGTCACGTATTACTATGGTTCAGGGAGTTTTACGCTACTACTACTACATGGACGTCTGG	CARLGSRITMVQGVLRYYYYMDVW	IGHV3-53	IGHJ6
TGTGCGAGACTTCTCTACTATGATAGTAGTGGTTATGACTACTGG	CARLLYYDSSGYDYW	IGHV5-51	IGHJ4
TGTGCGAGAGCGGTAGCAGCAGCTGAGAGCTACTACTTTGACTACTGG	CARAVAAAESYYFDYW	IGHV3-7	IGHJ4
TGTGCAAAAGATAGAAGGGAGCCGTCGATGCTATGCGACTACTGG	CAKDRREPSMLCDYW	IGHV3-43D	IGHJ4
TGTGCAGACACTCTCGGTGACTACGCGGAGTCTGCCGACCCATCAGTCTTTGACTACTGG	CADTLGDYAESADPSVFDYW	IGHV3-30	IGHJ4
TGTGCGAGCAGGTCCCGAGATAGTGGGAGCTCTAATTTTGACTACTGG	CASRSRDSGSSNFDYW	IGHV1-2	IGHJ4
TGTGCGAGACGCGTGCTGAGCCGTTCGATCGTCATTCGGGGAGTTATTATAAAGTCTCGTGACTACTGG	CARRVLSRSIVIRGVIIKSRDYW	IGHV5-51	IGHJ4
TGTGCGAGAGATTACACTATGATAGTAGTGGTTAAACATGATGCTTTTGATATCTGG	CARDYTMIVVVKHDAFDIW	IGHV1-18	IGHJ3
TGTGCGAGAGCCGCTCAAGCTGATGGGACGTATTACGATTTTTGGAGTGGTTATTATACCACTATATACTACTACTACTACTACATGGACGTCTGG	CARAAQADGTYYDFWSGYYTTIYYYYYYMDVW	IGHV3-7	IGHJ6
TGTGCGAGGACCGTAGGTTTCCCAATGGCCCACTTTGACTACTGG	CARTVGFPMAHFDYW	IGHV5-51	IGHJ4
TGTACCACAGTTAAACTAGCTACTTCTCCACCCTTTGACTACTGG	CTTVKLATSPPFDYW	IGHV3-15	IGHJ4
TGTGCACACAGACTAAGCGTTGTGGTGGTGATTGCTATCAACGGGGATGCTTTTGATATCTGG	CAHRLSVVVVIAINGDAFDIW	IGHV2-5	IGHJ3
TGTGCGAAAGATCTTTTTAATGGCTGGTCCACGGGCCGCTATTACTACTTTGACTACTGG	CAKDLFNGWSTGRYYYFDYW	IGHV3-23	IGHJ4
TGTGCGAGAGATGGTGAACCCCATTACTATGATAGTAGTGGTTATTCTGTAAGGGACTTTGACTACTGG	CARDGEPHYYDSSGYSVRDFDYW	IGHV1-3	IGHJ4
TGTGCGAAAGAGGAGACTAAGCCAAAGCCTATAGCAGCTCGTCGTAGTGGAGCTGCTTTTGATATCTGG	CAKEETKPKPIAARRSGAAFDIW	IGHV3-23	IGHJ3
TGTGCGAGATTTTACGATTTTTGGAGTGGTTATTCCTACTTTGACTACTGG	CARFYDFWSGYSYFDYW	IGHV7-4-1	IGHJ4
TGTGCGAGAGACCCGAAGGCCCGGGAGTTATGCCCCTTTGACTACTGG	CARDPKARELCPFDYW	IGHV3-66	IGHJ4
TGTGCAAGAGATAAGGCCCACGGGTGGTCGGAAAATTACTACTACTACTACTACATGGACGTCTGG	CARDKAHGWSENYYYYYYMDVW	IGHV3-13	IGHJ6
TGTGCGAGTGGTCATGCTGAACGGGCTCGAGTCCCCCTCCCCCGGGCATCCGGAGAGGGCCAGTATTACTATGATAGTAGTGGTTATTTACCCCTTGACTACTGG	CASGHAERARVPLPRASGEGQYYYDSSGYLPLDYW	IGHV3-7	IGHJ4
TGTGCAAGAGATCTATGGGACCCTAGAGCCTTAATTTACTACTTTGACTACTGG	CARDLWDPRALIYYFDYW	IGHV3-74	IGHJ4
TGTGCGAGAGGGGTAGTCGAGTTTAAAGTAGTACCAGCTGCTATCGCCTACTACTACTACTACATGGACGTCTGG	CARGVVEFKVVPAAIAYYYYYMDVW	IGHV4-34	IGHJ6
TGTACTAGAGGTATTGTAGTGGTGGTAGGGACCTGGTTCGACCCCTGG	CTRGIVVVVGTWFDPW	IGHV3-49	IGHJ5
TGTGCGAAACTCCTTCTTTTTCCAACCATGGTGGTAGCTGCTACCGCCCGGTACTACTACTACATGGACGTCTGG	CAKLLLFPTMVVAATARYYYYMDVW	IGHV3-23	IGHJ6
TGTACTAGGCTGAGTGGTGGTAGCTGCTACAAACATAACTGGTTCGACCCCTGG	CTRLSGGSCYKHNWFDPW	IGHV3-73	IGHJ5
TGTGCGAGACGCTACGGGCTGTCCCCTATTGTAGTGGTGGTAGCTGCTACGGTCGTCCCCAAAAACTGGTTCGACCCCTGG	CARRYGLSPIVVVVAATVVPKNWFDPW	IGHV1-46	IGHJ5
TGTGCGAGACGGGTGCATCACATCTTGATTTTTGGAGTGGTTATTAGTGCCTTTGACTACTGG	CARRVHHILIFGVVISAFDYW	IGHV1-3	IGHJ4
TGTGCAAGAGAAGACCCTAGACACGATTTTTGGAGTGGTTATTTTAACTACTACTACATGGACGTCTGG	CAREDPRHDFWSGYFNYYYMDVW	IGHV3-13	IGHJ6
TGTGCGAGAGATCGACGGAAGATTCACGTATTACGATTTTTGGAGTGGTTATTATACGGGATCTACTACTACTACTACTACATGGACGTCTGG	CARDRRKIHVLRFLEWLLYGIYYYYYYMDVW	IGHV3-48	IGHJ6
TGTGCGAGAACGGCCCGCCTCCGAGCAACATTGTATATTACGATTTATTGGGCGGCTAATGACTACTGG	CARTARLRATLYITIYWAANDYW	IGHV3-7	IGHJ4
TGTGCGAGAGGCCCCCCTTGGAGTGGTTATATGTACTGG	CARGPPWSGYMYW	IGHV5-10-1	IGHJ4
TGTGCGAGAGATCGGCTTACGCGAGATGTAGTGGCTACGGTAGGGGTAACCTCCGATGACTACTGG	CARDRLTRDVVATVGVTSDDYW	IGHV3-66	IGHJ4
TGTGCACCCCGGCCTGCGCTTGGGCCCAGGGTGGTGATTGCTATTCCGTCGGGAGGTTATTACTACTACTACTACTACATGGACGTCTGG	CAPRPALGPRVVIAIPSGGYYYYYYYMDVW	IGHV2-26	IGHJ6
TGTGCGAGTACGAAGCGTTCTACGGTGACTAGGGGGAAAACCAACCCCCGGGGGAAATCCAACTGGTTCGACCCCTGG	CASTKRSTVTRGKTNPRGKSNWFDPW	IGHV3-7	IGHJ5
TGTGCGAGACAAGTGAGAGGATATTGTAGTAGTACCAGCTGCAGGGGGTACAACTGGTTCGACCCCTGG	CARQVRGYCSSTSCRGYNWFDPW	IGHV1-69	IGHJ5
TGTGCGTGCCAAGGATTTTTGGAGTGGTTATTGTCGAAGCCGAACTTTGACTACTGG	CACQGFLEWLLSKPNFDYW	IGHV3-30-3	IGHJ4
TGTCTAGTCCAAGGCCCGTGGGAGCTACTGATCTACTGG	CLVQGPWELLIYW	IGHV3-30-3	IGHJ4
TGTGCGAGAGAGTTTACGGAGGATATTGTAGTGGTGGTAGCTGCTACCGCGGCCCTCAACCCGGGGCCGTACTACTACTACATGGACGTCTGG	CAREFTEDIVVVVAATAALNPGPYYYYMDVW	IGHV1-69	IGHJ6
TGTGCGAGAGAGGGATGTTATTGTAGTAGTACCAGCTGCTGGGGGCCTTACCCTTGGAACTGGTTCGACCCCTGG	CAREGCYCSSTSCWGPYPWNWFDPW	IGHV3-7	IGHJ5
TGTACCACAGGGGACTGGGAAGGATATTGTAGTGGTGGTAGAAATTGG	CTTGDWEGYCSGGRNW	IGHV3-15	IGHJ5
TGTGCGAGAGACCGGGCCACGGTGACTACGTATTACTACTACTACTACTACATGGACGTCTGG	CARDRATVTTYYYYYYYMDVW	IGHV4-61	IGHJ6
TGTGCGAGAGCCGGCTGGTGGAGCCTGGTGTTTCGTTTCCAGCGATATTGTACTGGTGGTGTATGCTCCCCGAATCCCGCATTTGGTGATGCTTTTGATATCTGG	CARAGWWSLVFRFQRYCTGGVCSPNPAFGDAFDIW	IGHV4-61	IGHJ3
TGTGCGAAAGCCCGACCCCCGCCTTACTACTTTGACTACTGG	CAKARPPPYYFDYW	IGHV3-NL1	IGHJ4
TGTGCGAAAGATGGGGTACGATTTTTGGAGTGGGGTGGATTCAGTGGTTACTACTACTACTACTACATGGACGTCTGG	CAKDGVRFLEWGGFSGYYYYYYMDVW	IGHV3-23	IGHJ6
TGTGCGAGAGGACGGGTTTGTTTAATCGGTTACGATTTTTGGAGTGGTGACTACTGG	CARGRVCLIGYDFWSGDYW	IGHV1-3	IGHJ4
TGTGCGAGAGATCGGTGGCTGGTACACTGGCCACTGTGCGACTACTGG	CARDRWLVHWPLCDYW	IGHV1-18	IGHJ4
TGTGCGAGATATACCCCAGTTGGATATTGTAGTGGTGGTAGCTGGAACTCAGCGCCCCCGGACCCTGATGCTTTTGATATCTGG	CARYTPVGYCSGGSWNSAPPDPDAFDIW	IGHV3-53	IGHJ3
TGTGCGAAACCTATCCTTAGCCTCTCCCGACCGTTCTACTACTACTACATGGACGTCTGG	CAKPILSLSRPFYYYYMDVW	IGHV3-NL1	IGHJ6
TGTGCTCCCCGCGGGCCCAGGAGATGGCTACAATTGCTGAGCCCCTACTTTGACTACTGG	CAPRGPRRWLQLLSPYFDYW	IGHV4-39	IGHJ4
TGTGCGAGAGCGGTGACTACGCTAAAGCGGTTACCCAACGCTGACTACTACATGGACGTCTGG	CARAVTTLKRLPNADYYMDVW	IGHV4-61	IGHJ6
TGTGCGAGAGATTCCCCGGTGACTGCCGAAAGGCTTGACTACTGG	CARDSPVTAERLDYW	IGHV3-53	IGHJ4
TGTGCGAGGTATAATTGTAGTAGTACCAGCTGCTATGTTTCTGACTGG	CARYNCSSTSCYVSDW	IGHV1-69	IGHJ5
TGTGCGAGAGAGGGTGCTGAGAGACCGGGCCTGACACTAGGATATTGTAGTGGTGGTAGCTGCTACTCAAATGCTTTTGATATCTGG	CAREGAERPGLTLGYCSGGSCYSNAFDIW	IGHV3-7	IGHJ3
TGTGCGAGAGTAAGACGAGACGGATACGATATTTTGACTGGTTCGGACGAACCCCCTAGGTCCCCCGGAAACGACTACTGG	CARVRRDGYDILTGSDEPPRSPGNDYW	IGHV4-38-2	IGHJ4
TGTACCACAGAGACCGGATTACTATGGTTCAGGGAGGCGGACATTTACTACTACTACTACTACATGGACGTCTGG	CTTETGLLWFREADIYYYYYYMDVW	IGHV3-15	IGHJ6
TGTGCGAGACTACGGGTGGTGGTGACTGCCAACTGGTTCGACCCCTGG	CARLRVVVTANWFDPW	IGHV5-51	IGHJ5
TGTGCGAGAATAGGAATTGTAGTGGTGGTAGCTGCTACCATCATCAATTGG	CARIGIVVVVAATIINW	IGHV3-20	IGHJ5
TGTGCAAGAGAAAATATTGTAGTGGTGGTAGCTGCAACCAGTTTCTGGTTCGACCCCTGG	CARENIVVVVAATSFWFDPW	IGHV3-74	IGHJ5
TGTTCCCCCCAATGGTGTATGTACCGATTTGACTACTGG	CSPQWCMYRFDYW	IGHV3-23	IGHJ4
TGTGCGAGCATCCTAGGTATAGCAGTGGCTGGTAAAGAATCCGGAAGGTACTACTTTGACTACTGG	CASILGIAVAGKESGRYYFDYW	IGHV1-18	IGHJ4
TGCCGACCCTCGTTTTTTGGAGTGGTTATTATACCGGTACCCACCCCTTTTGACTACTGG	CRPSFFGVVIIPVPTPFDYW	IGHV3-74	IGHJ4
TGTGCGAGAGATACCAAGGATATTGTAGTGGTGGTAGCTGCTAACTGCTCCCTTGACTACTGG	CARDTKDIVVVVAANCSLDYW	IGHV1-2	IGHJ4
TGTGCGAGAGAACCAGCTGCTATATACCCCTTTGACTACTGG	CAREPAAIYPFDYW	IGHV4-61	IGHJ4
TGTGCGAGAGTAAGTCTACGGGTGGGAGCTACTACTGGGAAAAAAGATGCTTTTGATATCTGG	CARVSLRVGATTGKKDAFDIW	IGHV3-7	IGHJ3
TGTGCGAGAGATCTCCGACCCACGGTGACTACGCCCCCCGTGGGCTACTTTGACTACTGG	CARDLRPTVTTPPVGYFDYW	IGHV3-64	IGHJ4
TGTACTAGACGCGGGTATAGCAGGGTTATCGGTTTTGACTACTGG	CTRRGYSRVIGFDYW	IGHV3-73	IGHJ4
TGTGCGAGAAGGTACTACAGTAACTACTGTGTGGGACCCCTTCATGACTACTGG	CARRYYSNYCVGPLHDYW	IGHV5-10-1	IGHJ4
TGTGCGAGAGCTCAAGTTGGGGATAGTGGCTACGATTCTAATTACTACTTTGACTACTGG	CARAQVGDSGYDSNYYFDYW	IGHV4-59	IGHJ4
