TGTGCAAGAATGGGAACAGGTGGATATAGTGGCTACGAACCCCTCTTTGACTACTGG	CARMGTGGYSGYEPLFDYW	IGHV1-45	IGHJ4
TGTGCGAGAATCATGTATTACGATTTTTGGAGTGGTTATTTCAATTACTACTACTACTACTACATGGACGTCTGG	CARIMYYDFWSGYFNYYYYYYMDVW	IGHV5-10-1	IGHJ6
TGTGCAAGCAAAGCAGTTGGCTTTGACTACTGG	CASKAVGFDYW	IGHV3-74	IGHJ4
TGTGCGAGAGAACTGTCCTACTTTGACTACTGG	CARELSYFDYW	IGHV4-59	IGHJ4
TGTGCGGTAAGCAGCAGCTGGAGCCCTGCTCCTTACGCCACAATTGACTACTGG	CAVSSSWSPAPYATIDYW	IGHV1-46	IGHJ4
TGTGCGAGAGACTACCAATGGAGTGGGGGGATATTGTACTGGTGGTGTATGCTATATTTCCTTTTTGACTACTGG	CARDYQWSGGILYWWCMLYFLFDYW	IGHV1-69	IGHJ4
TGTGCGAGACCATATAACTTTGACTACTGG	CARPYNFDYW	IGHV4-59	IGHJ4
TGTGCATTCCGGGTTACTATGGTTCAGGGAGTTATTCTCTCGCTTAACTTTGACTACTGG	CAFRVTMVQGVILSLNFDYW	IGHV3-23	IGHJ4
TGTGCGAAAGGTCCGGATATAGTGGCTACGATCTTATACCCAAACTTTGACTACTGG	CAKGPDIVATILYPNFDYW	IGHV3-23	IGHJ4
TGTGCAAGAGATGGGTTTTGGAGTGGTTATTATGGGAGAATAGGCCATGGAATTGACTACTGG	CARDGFWSGYYGRIGHGIDYW	IGHV3-74	IGHJ4
TGTGCGAGAGGCCGGGACCGGGGGTCTCAGCCTAGCAGTGGCTGGTACGTACGCCTTAATTACTACTACTACTACTACATGGACGTCTGG	CARGRDRGSQPSSGWYVRLNYYYYYYMDVW	IGHV3-21	IGHJ6
TGTGCGAGATACCCTCATTTGGGGGAGAATACCATATCGATCTACTACTACTACTACATGGACGTCTGG	CARYPHLGENTISIYYYYYMDVW	IGHV3-66	IGHJ6
TGTACTAGACGAGGTATAGCAGTGGCTGGTGTACAGGGGCCCTTTGACTACTGG	CTRRGIAVAGVQGPFDYW	IGHV3-73	IGHJ4
TGTGCGAGAGATATATACAAATGGACTCATTGTAGTAGTACCAGCTGCTATGTACGGGCGGGGTTGTGGTTCGACCCCTGG	CARDIYKWTHCSSTSCYVRAGLWFDPW	IGHV1-3	IGHJ5
TGTGCGAGACTTCCCGATGTCGAATTCGTCTGG	CARLPDVEFVW	IGHV7-4-1	IGHJ3
TGTGCGAGAGATATGCAGTACAGGCCAGTAGGGGGGGAGGACGGGTATATTGTAGTGGTGGTAGCTGCGGAAACCCCATGTGTTCATTACTACTACTACTACTACATGGACGTCTGG	CARDMQYRPVGGEDGYIVVVVAAETPCVHYYYYYYMDVW	IGHV3-48	IGHJ6
TGTGCGAAAGCACTGGCTTTTGATATCTGG	CAKALAFDIW	IGHV3-23	IGHJ3
TGTGCGAAAGATCCCTTACTTTATGGTTCAGGGAGGGGGGACTACTACTACTACATGGACGTCTGG	CAKDPLLYGSGRGDYYYYMDVW	IGHV3-NL1	IGHJ6
TGTGCGCCCGGCGGTATTACTATGATAGTAGTGGTTCTTCCCCAGCCCCTTGACTACTGG	CAPGGITMIVVVLPQPLDYW	IGHV4-39	IGHJ4
TGTGCGAGAGGGTATAGCAGTGGCTGGTACCGAGCCCCCGTTTGGCTAGTCTGG	CARGYSSGWYRAPVWLVW	IGHV3-11	IGHJ3
TGTGCGAGAGATGGCGATAGTAGTGGTTATTATTACGACTACTGG	CARDGDSSGYYYDYW	IGHV1-3	IGHJ4
TGTGCGAGAGATCATGGGGGCCTGTATAGCAGTGGCTGCCAGTACTACTTTGACTACTGG	CARDHGGLYSSGCQYYFDYW	IGHV4-59	IGHJ4
TGTGCGAGATCTATTACCCGAAGGCGTAGGACTTATAGATTGTACTGGTGGTGTATGCTATGTGCCCCCTACTACTACTACTACTACATGGACGTCTGG	CARSITRRRRTYRLYWWCMLCAPYYYYYYMDVW	IGHV1-3	IGHJ6
TGTGCGAGAGATGGGCCCGATTTTTGGAGTGGTGGTGTTGTAGGCTTTGACTACTGG	CARDGPDFWSGGVVGFDYW	IGHV1-2	IGHJ4
TGTACCACAAAAGTTGTAGTGGTGGTAGCTGCAGGGGAGAGGGTACAACATGCTTTTGATATCTGG	CTTKVVVVVAAGERVQHAFDIW	IGHV3-15	IGHJ3
TGTGCACGGATCTTGGACCGGTACATCCAGGGAGCAGTGGCTGGTACGTGGACCGACTACTGG	CARILDRYIQGAVAGTWTDYW	IGHV2-26	IGHJ4
TGTGCGAGAGGCACTGATAGCAGCAGCTGGTACGAGAGCACCTACATGGACGTCTGG	CARGTDSSSWYESTYMDVW	IGHV4-34	IGHJ6
TGTGCACACAGACAACGGGTGGTGTATGCTATAAAACATCTTGACTACTACATGGACGTCTGG	CAHRQRVVYAIKHLDYYMDVW	IGHV2-5	IGHJ6
TGTGCGAGACCGGTCGCAACACGTATTACGATTTTTGGAGTGGTTATTTTCCGGTACCGGTCTAACTGGTTCGACCCCTGG	CARPVATRITIFGVVIFRYRSNWFDPW	IGHV4-39	IGHJ5
TGTACTAGACAGGCTGGGGGGCCTATGAGTGGTAGCTGCTGCCAGGGGTACTTTGACTACTGG	CTRQAGGPMSGSCCQGYFDYW	IGHV3-73	IGHJ4
TGTGCGAGGGGGCCGATTTTTGGAGTGGTTATCCGCCGAACGAGAACCTACTACTACTACTACATGGACGTCTGG	CARGPIFGVVIRRTRTYYYYYMDVW	IGHV4-4	IGHJ6
TGTGCGAGACAGTGCTCCAATTACTATGGTTCGGGGAGTCCAATTGACTACTGG	CARQCSNYYGSGSPIDYW	IGHV4-59	IGHJ4
TGTGCGAGAGGCGCGGGACCCCAGCAGGAACCGGGTATAGCAGTGGCTGGTACGAATCTAACCGGAGCGAGTGACTACTGG	CARGAGPQQEPGIAVAGTNLTGASDYW	IGHV3-7	IGHJ4
TGTGCGAGACTACGAGGAAGGGCCGGGTGGTATCGGCATGATATTGTACTAATGGTGTATGCCTTCTGG	CARLRGRAGWYRHDIVLMVYAFW	IGHV4-39	IGHJ5
TGTGCGAGACGGACAGAGTATTGTAGTGGTGGTAGCTGCTGCTACTGG	CARRTEYCSGGSCCYW	IGHV5-51	IGHJ4
TGTGCGAGATGTTCGGCGCCAGTGGCTGGTAGACCGTACTACTGG	CARCSAPVAGRPYYW	IGHV5-10-1	IGHJ4
TGTGCGAGGCCCCGGTCGGTTCCCCAGGATATTGTAGTGGTGGTAGCTGCTAGCGCTCCGTTTTTGCATGCAAAGTCAGTTTCTAGATACTACTACTACTACTACATGGACGTCTGG	CARPRSVPQDIVVVVAASAPFLHAKSVSRYYYYYYMDVW	IGHV1-3	IGHJ6
TGTGCGCATAGGCCGGACTATTGTAGTGGTGGTAGCTGCTACTCCAATTCGGGGGAGGGCTACTGG	CAHRPDYCSGGSCYSNSGEGYW	IGHV1-3	IGHJ4
TGTACTAGTCGATCGCTTTACGATTTTTGGAGTGGTTTCTACCCCCTAACCTTTGACTACTGG	CTSRSLYDFWSGFYPLTFDYW	IGHV3-49	IGHJ4
TGTGCGAGAGTTTCCCACGGACCATATGGTTCGGGGAGTTATGAGGTCCCAATTTATCACCCGCCTCCGGCCCCAGTTGACTACTGG	CARVSHGPYGSGSYEVPIYHPPPAPVDYW	IGHV3-20	IGHJ4
TGTGCGAGACGACCTTCTTACATTTGGGGGAGTTATCGTTATGGCTTATTCTGCCGACCGGACTACTTTGACTACTGG	CARRPSYIWGSYRYGLFCRPDYFDYW	IGHV4-34	IGHJ4
TGTGCGAGAATTAAACTCGGCCCCAGATATTGTAGTAGTACCAGCTGCACCAAAACTTTTGATATCTGG	CARIKLGPRYCSSTSCTKTFDIW	IGHV7-4-1	IGHJ3
TGTGCGATGGTACGTTATTGTAGTGGTGGTAGCTGCTACTCGGATAATGTCTACTGG	CAMVRYCSGGSCYSDNVYW	IGHV3-23	IGHJ4
TGTACGGACGATAGCAGCAGCTGGCCGGTTGACTACTGG	CTDDSSSWPVDYW	IGHV3-49	IGHJ4
TGTGCGAGAGTGTCGGTACTGGTGGTGTATGCTGATACGCTTGATGCTTTTGATATCTGG	CARVSVLVVYADTLDAFDIW	IGHV1-8	IGHJ3
TGTGCGAGAGATAGCGACCATGTCGACCCCTGG	CARDSDHVDPW	IGHV1-2	IGHJ5
TGTGCGAGAGATTCGCCGTTCCGTAGTACCAGCTGCTATGTGGAATGCTACTACTACTACTACATGGACGTCTGG	CARDSPFRSTSCYVECYYYYYMDVW	IGHV4-59	IGHJ6
TGTGCGAAAGGGTATAGCAGCAGCTCCGACTGGTTCGACCCCTGG	CAKGYSSSSDWFDPW	IGHV3-NL1	IGHJ5
TGTGCGAAAGAGGAAAGCTTAAACTGGACGATCAGCGGAGGATATTGTAGTGGTGGTAGCTGGCGTCGCTGGTACTTCGATCTCTGG	CAKEESLNWTISGGYCSGGSWRRWYFDLW	IGHV3-NL1	IGHJ2
TGTGCGAGAATTCCCATTGTAGTAGTACCAGCTGCGGTGAACTACTACTACTACATGGACGTCTGG	CARIPIVVVPAAVNYYYYMDVW	IGHV7-4-1	IGHJ6
TGTGCACGGGGGCTAGGATATTGTAGTAGTACCAGCTGCGCAGCAACCGACTCTAGCTACTGG	CARGLGYCSSTSCAATDSSYW	IGHV2-70	IGHJ4
TGTGCGAAATATGGCACGGGTTACTATGGTTCAGGGAGTTATTATGGACGATTTGACTACTGG	CAKYGTGYYGSGSYYGRFDYW	IGHV3-23	IGHJ4
TGTGCGAGAGATGGGGCACGTGGATATAAACCCCGAATGGACGTCTGG	CARDGARGYKPRMDVW	IGHV3-21	IGHJ6
TGTGCGAGAGCGAGTTGGTGTATTACGATTTTTGGAGTGGTTAAGCGGCCTCCGCGGGGCAAGTGCCGCAGAGTTGACTACTGG	CARASWCITIFGVVKRPPRGKCRRVDYW	IGHV1-46	IGHJ4
TGTGCGAAAGATCGCAGAGCGAGTGTAGTAGTACCAGCTGCTATAATGTTTTCTTGGGGAATCGCGGGGCACGAATACTGG	CAKDRRASVVVPAAIMFSWGIAGHEYW	IGHV3-NL1	IGHJ4
TGTACTAGAGATCCCACATATTACGATTTTTGGAGTGGTTATACTGGGCCGCGGTACTACTACTACTACTACATGGACGTCTGG	CTRDPTYYDFWSGYTGPRYYYYYYMDVW	IGHV3-49	IGHJ6
TGTGCGAGGCTTGGTGGTGATTGCCTGGCGTTTGACTACTGG	CARLGGDCLAFDYW	IGHV3-21	IGHJ4
TGTGCGAGACCGACGAATTCCAATAGTGGTGGTAGCTGTGACTACTGG	CARPTNSNSGGSCDYW	IGHV4-39	IGHJ4
TGTGCGAGAGATCCGGGGAAACCGGGTATAGCAGTGGCTGGTACTCGGTCCTTTGACTACTGG	CARDPGKPGIAVAGTRSFDYW	IGHV3-7	IGHJ4
TGTACTAGAGGTAGGCTGGATATTGTACTGGTGGTGTATGCTATAGCTCCCCCACTCTCCTTTGACTACTGG	CTRGRLDIVLVVYAIAPPLSFDYW	IGHV3-49	IGHJ4
TGTGCGAGAGATATCGAGAGGGGGGTTGATACTATGGTTCGGGGAGTTATTATCGGGCCAGAGGTGTGCCAGGGGAACTACTTTGACTACTGG	CARDIERGVDTMVRGVIIGPEVCQGNYFDYW	IGHV3-48	IGHJ4
TGTGCGAGGTTGCCAAGGAACCCCGCTTGTAGTGGTGGTAGCTGCCGAAACTGGTACTTCGATCTCTGG	CARLPRNPACSGGSCRNWYFDLW	IGHV4-38-2	IGHJ2
TGTGCGAGCCCCAGATTAGGATATTGTAGTGGTGGTAGCTGCTACATATCACGTGATGCTTTTGATATCTGG	CASPRLGYCSGGSCYISRDAFDIW	IGHV7-4-1	IGHJ3
TGTGCGAGACGCCTTGCTGTAGTGGTGGTAGCTGCTATGGTGGGGGATGCCCCCATGCGACACCTTCAACTACCTATGAGGGCGCTAGAGGGAGCTGACTACTGG	CARRLAVVVVAAMVGDAPMRHLQLPMRALEGADYW	IGHV5-51	IGHJ4
TGTGCGAGAGGAACTGGAACTACGTTCCTCGACTACTGG	CARGTGTTFLDYW	IGHV4-34	IGHJ4
TGTGCGAGAGTTAATATTGTAGTGGTGGTAGCTGCTACGCAGAACTTTGACTACTGG	CARVNIVVVVAATQNFDYW	IGHV4-34	IGHJ4
TGTGCGAGAGAAACGCAGCTGGTACCTTGGAACTTTGACTACTGG	CARETQLVPWNFDYW	IGHV1-18	IGHJ4
TGTGCGAGAGATACCGTCCTTCCTCGACGTAGTGGTGGTAGCTGCTTCAGTATCTACTACTACTACTACATGGACGTCTGG	CARDTVLPRRSGGSCFSIYYYYYMDVW	IGHV4-4	IGHJ6
TGTGCGAGAGTAGGCCCGTCTACGGTGACTACGGACACGAGGCCGCGGTACTACTACTACTACATGGACGTCTGG	CARVGPSTVTTDTRPRYYYYYMDVW	IGHV3-66	IGHJ6
TGTGCGAGTGTCGCGGTAACACCGGAGGAATACTTCCAGCACTGG	CASVAVTPEEYFQHW	IGHV3-48	IGHJ1
TGTGCGAGGGAGCCCCGTCCGCAGTGGCTGGTACGTGCGAGTGTGGGGACCGCCTCAGTGTCTAGCCTCCTGCCCCTCTCACACTTTGACTACTGG	CAREPRPQWLVRASVGTASVSSLLPLSHFDYW	IGHV7-4-1	IGHJ4
TGTGCGAGAAAATATTGTACTGGGGCACCCTCCCCAAAATTTGACTACTGG	CARKYCTGAPSPKFDYW	IGHV7-4-1	IGHJ4
TGTGCGAGATCCACACCCTACAGTAACTACAGATATGACTACTGG	CARSTPYSNYRYDYW	IGHV5-10-1	IGHJ4
TGTGCGAAAGATCAAGATGGTGGAAGTGCCATAGCTTGGGAGATGGCTACAATTAACTCCTACTTTGACTACTGG	CAKDQDGGSAIAWEMATINSYFDYW	IGHV3-23	IGHJ4
TGTGCGAGAGATCGCATCTCGTATAGTAGTGGCAACGGACCCTGG	CARDRISYSSGNGPW	IGHV4-4	IGHJ4
TGTGCGAGAGGGTATCAGCCAAAAGGGCCTAGGTATTACGATATTTATGAGAGGGGAAATTACTACTACTACTACTACATGGACGTCTGG	CARGYQPKGPRYYDIYERGNYYYYYYMDVW	IGHV3-11	IGHJ6
TGTGCACACCAACTGATTACTATGATAGTAGTGGTTATCCCGGGGAATTACTACTTTGACTACTGG	CAHQLITMIVVVIPGNYYFDYW	IGHV2-5	IGHJ4
TGTGCGAGAGAGAATTGTAGTGGGACCTTTGACTACTGG	CARENCSGTFDYW	IGHV3-48	IGHJ4
TGTGCGAGATACAGACGATGGGCATTACATATTGTAGTGGTGGTAGCTGCACAATACTACTTTGACTACTGG	CARYRRWALHIVVVVAAQYYFDYW	IGHV5-10-1	IGHJ4
TGTGCGAAAGATGTCTCCCCGGATATTGTTTCCCTCCCCCTGCCGTTCCAGCACTGG	CAKDVSPDIVSLPLPFQHW	IGHV3-NL1	IGHJ1
TGTGCGAAAGAAGGGTACGGAAGAATGACTACGGTGACTAAGGTTCAGAAATACTACTTTGACTACTGG	CAKEGYGRMTTVTKVQKYYFDYW	IGHV3-23	IGHJ4
TGTACCACAGCGGAAGCCCGATATTGTACTAATGGTGTATGCTATATGGAGTCATACTACTTTGACTACTGG	CTTAEARYCTNGVCYMESYYFDYW	IGHV3-15	IGHJ4
TGTGCGAGAGATATAAAAGCCCCAGAGCCGAGGATCCCCGACTGGTTCGACCCCTGG	CARDIKAPEPRIPDWFDPW	IGHV3-7	IGHJ5
TGTGCGAGAGATAGCCCCATTCGTATTGTAGTGGTGGTAGCTGCTACGCCCAGAGATCGCTTTGACTACTGG	CARDSPIRIVVVVAATPRDRFDYW	IGHV1-18	IGHJ4
TGTGCGAGTCGATTTTATGGGCCGACCCCGCATATTGTAGTAGTACCAGCTGCTAGAGAAGAATTTGACTACTGG	CASRFYGPTPHIVVVPAAREEFDYW	IGHV4-61	IGHJ4
TGTGCGAAAGCTGGGCACGCACTTATAGCAGCTCGCCGCACTCTAGGGTACTACTTTGACTACTGG	CAKAGHALIAARRTLGYYFDYW	IGHV3-23	IGHJ4
TGTGCGAGTGTTTCACGGGGAGCGGTGGCGAGCAGTGGCTGGATTATCTACTACTACTACTACATGGACGTCTGG	CASVSRGAVASSGWIIYYYYYMDVW	IGHV3-53	IGHJ6
TGTGCGAGAGGGATGGCTACAATACGGATTCTCCGCTTTGACTACTGG	CARGMATIRILRFDYW	IGHV7-4-1	IGHJ4
TGTGCGAGAGATCCCTATGATAGTAGTGGTTATTCGCGGGTGGCGAGAAGGAACTGGTTCGACCCCTGG	CARDPYDSSGYSRVARRNWFDPW	IGHV4-34	IGHJ5
TGTGCGAGAGACAATCAGTGGAGCTACTACGAGGCCGACGCCGGGTACTGG	CARDNQWSYYEADAGYW	IGHV7-4-1	IGHJ4
TGTACTAGAGTTGAGGCTCTGGGTATTACGATTTTTGGAGTGGTTATTATTTACTTTGACTACTGG	CTRVEALGITIFGVVIIYFDYW	IGHV3-49	IGHJ4
TGTGCACACTGGAAATTACCGCCGTGG	CAHWKLPPW	IGHV2-5	IGHJ5
TGTGCGAGACCCCGGCCTTACATTTGGGGGAGTTATCGTTATACTCCCGGCTATGACTACTGG	CARPRPYIWGSYRYTPGYDYW	IGHV4-38-2	IGHJ4
TGTGCGAGAGGGGTCCCCATTGTAGTGGTGGTAGCTGCAAACCTCGTACACCAATACTTTGACTACTGG	CARGVPIVVVVAANLVHQYFDYW	IGHV3-7	IGHJ4
TGTGCGAGACGGGAAGGACTGCCCTACGTATTACGATTTTTGGAGTGGTTATTCTCTGCCTCCTACTACTACTACTACTACATGGACGTCTGG	CARREGLPYVLRFLEWLFSASYYYYYYMDVW	IGHV4-39	IGHJ6
TGTGCGAGAGATCGGGTACTACGATTTTTGGAGTGGTTATCGTCTAGCTTTGACTACTGG	CARDRVLRFLEWLSSSFDYW	IGHV1-69	IGHJ4
TGTGCGAGAGATTATTTGTCTCCTAAACGCCAGGTAGTGGTGGTAGCTGCTACTCCCTATTTCTACTACTTTGACTACTGG	CARDYLSPKRQVVVVAATPYFYYFDYW	IGHV3-11	IGHJ4
TGTGCGAGAGTTTGGGGTCTAGCAGTGGCTGGTACTACATTTGACTACTGG	CARVWGLAVAGTTFDYW	IGHV3-53	IGHJ4
TGTGCGAGATTGCCGGTCTGGGCGCTCTTAGGCCTTCCGGTTTATAAGATAGACTACGATTATGATTACGTTTGGGGGAGTTATCGTTACCTTTTGATTCCACCTGGATACTACTACATGGACGTCTGG	CARLPVWALLGLPVYKIDYDYDYVWGSYRYLLIPPGYYYMDVW	IGHV3-7	IGHJ6
TGTGCGAAAGATCGGTTGCAGCAGCTGGTAGCGCCCTTTGACTACTGG	CAKDRLQQLVAPFDYW	IGHV3-NL1	IGHJ4
