TGTGCGAGACCAGTAATGCAGCAGCTGGTACAGGAGCAGAGTTACTTTGACTACTGG	CARPVMQQLVQEQSYFDYW	IGHV5-51	IGHJ4
TGTGCGAGCAGGTTTCCTTTGGATATTGTACTGGTGGTGTATGCCAAGGAGGGGTGTACGGACTACTACTACTACTACATGGACGTCTGG	CASRFPLDIVLVVYAKEGCTDYYYYYMDVW	IGHV4-34	IGHJ6
TGTGCGAGAGAGTTAAGGATACAGCTATGGTTCTTCAGGACCACTAGGTACTTTGACTACTGG	CARELRIQLWFFRTTRYFDYW	IGHV4-61	IGHJ4
TGTGCGAGACCCGCTGAACATAAAAAGGACGGTTTTGACTACTGG	CARPAEHKKDGFDYW	IGHV5-51	IGHJ4
TGTGCACACAGACGAATCAGGGGTATAGCAGCAGCTGGTACTACTGGAAAACCACCCCACAACTGGTTCGACCCCTGG	CAHRRIRGIAAAGTTGKPPHNWFDPW	IGHV2-5	IGHJ5
TGTGCGAGAGCAGGGTGGACTACGGTGACTACCCTAGGGACGAGTTACTACTACTACTACTACATGGACGTCTGG	CARAGWTTVTTLGTSYYYYYYMDVW	IGHV1-46	IGHJ6
TGTGCGAGAGATGAATATATTACTATGATAGTAGTGGTTAAGGGTGTTGACTACTGG	CARDEYITMIVVVKGVDYW	IGHV1-18	IGHJ4
TGTGCGAAAGCTCCGGACGAAGGACACCGTCGGGGGGGCTTTGACTACTGG	CAKAPDEGHRRGGFDYW	IGHV3-NL1	IGHJ4
TGTGCGAAATTGGGTGTGGTGGTGACTGCTCCCGCTGAATACTTCCAGCACTGG	CAKLGVVVTAPAEYFQHW	IGHV3-23	IGHJ1
TGTGCGAGAGCACCCCCCCCACCCTGTATAGCAGCAGCTGGTAGGGACTGG	CARAPPPPCIAAAGRDW	IGHV4-34	IGHJ4
TGTGCGAAAGGGTCCGCGGGATATTGTAGTGGTGGTAGCTGCTTTGACTACTGG	CAKGSAGYCSGGSCFDYW	IGHV3-23	IGHJ4
TGTGCGAGAGTCCCCGTCCGGGGGGTATTACGATTTTTGGAGTGGTTAAACTCGTTGGGGGCATTAGGGGGTTCCTACTACTACTACTACATGGACGTCTGG	CARVPVRGVLRFLEWLNSLGALGGSYYYYYMDVW	IGHV3-53	IGHJ6
TGTACTAGCCGAGGATATTGTAGTAGTACCAGCTGCCGGTACTACTACTACATGGACGTCTGG	CTSRGYCSSTSCRYYYYMDVW	IGHV3-49	IGHJ6
TGTGCAAAAGAGATAAATTATGATTACATTTGGGGGAGTTATCGTTATACCACGGAGTATGATGCTTTTGATATCTGG	CAKEINYDYIWGSYRYTTEYDAFDIW	IGHV3-43D	IGHJ3
TGTGCGAGAGGAGTTTGTTACGATATTTTGACTGGATTAAACTATTACTACTACTACTACTACATGGACGTCTGG	CARGVCYDILTGLNYYYYYYYMDVW	IGHV1-3	IGHJ6
TGTGCGAGAGATCAGGCCAACTGGTTCGACCCCTGG	CARDQANWFDPW	IGHV1-69	IGHJ5
TGTGGGCGGGACTACGGTGACTACGCCGACTACTGG	CGRDYGDYADYW	IGHV3-30-3	IGHJ4
TGTGCGAGAATCCTGGTGCGTGAGTCGCCCAACTGGTTCGACCCCTGG	CARILVRESPNWFDPW	IGHV4-38-2	IGHJ5
TGTGCGAAATTCGAACGATTACATTTGGGGGAGTTATCGTTACAGGCTTTTGATATCTGG	CAKFERLHLGELSLQAFDIW	IGHV3-23	IGHJ3
TGTGCGAGAGGGGGACCCCGTGGCATTGTAGTAGTACCAGCTGCTATGTATCCCAAGAAATACTACTACTACTACTACATGGACGTCTGG	CARGGPRGIVVVPAAMYPKKYYYYYYMDVW	IGHV4-38-2	IGHJ6
TGTGCGAAAGATGAAATGGTTGTAGTGGTGGTAGCTGCTACTACCGTTGACTACTGG	CAKDEMVVVVVAATTVDYW	IGHV3-NL1	IGHJ4
TGTGCGAGAGACCTGACCCGCACCGTAGCAGCAGCTGGTACGTGTTTATCTGGGGTTCTTTTGCAATGCCCTTTCTTTGACTACTGG	CARDLTRTVAAAGTCLSGVLLQCPFFDYW	IGHV4-34	IGHJ4
TGTGCACGGAGCCTTTCGACCCTAGCAGCAGCTGGTGCCATGACCTACTACTACTACTACATGGACGTCTGG	CARSLSTLAAAGAMTYYYYYMDVW	IGHV2-26	IGHJ6
TGTGCGAGAAATCTACTATGGTTCAGGGACCCTTGCGTTGACTACTGG	CARNLLWFRDPCVDYW	IGHV1-18	IGHJ4
TGTGCGAGAGGGACGGATATTGTAGTAGTACCAGCTGCTATAAGCGCTTCGGAACGTCCGGCACCGGCAGAGTCGGTGCGGAAGTGCAACTGGTTCGACCCCTGG	CARGTDIVVVPAAISASERPAPAESVRKCNWFDPW	IGHV1-3	IGHJ5
TGTGCGAGTTGGGTGACCAGTACTATGATAGTAGTGGTTATGTCTCCGAGCGACTACTGG	CASWVTSTMIVVVMSPSDYW	IGHV3-53	IGHJ4
TGTGCGAGCGAGTTGGGCCCCTATGGATATTGTAGTGGTGGTAGCTGCTACGGTGCTTTTGATATCTGG	CASELGPYGYCSGGSCYGAFDIW	IGHV4-59	IGHJ3
TGTGCGAGAGAGACGGGAGAGATCCCCGATTACTATGATAGTAGTGGTTTCTTGTGGTTCGACCCCTGG	CARETGEIPDYYDSSGFLWFDPW	IGHV4-34	IGHJ5
TGTGCGAAAATGGGAAATGGTTCAGGGACCGTTATTACGCCCTTTGACTACTGG	CAKMGNGSGTVITPFDYW	IGHV3-23	IGHJ4
TGTGCGAGACGGCATTGTAGTGGTGGTAGCTGG	CARRHCSGGSW	IGHV5-51	IGHJ4
TGTGCGAATAGAAACCCCAACTACGGTGACTTTTCCTACTACTACTACTACATGGACGTCTGG	CANRNPNYGDFSYYYYYMDVW	IGHV3-23	IGHJ6
TGTGCACGGATACCTTGCGGGTATAGCAGTGGCTGGGCCGGCTTTGACTACTGG	CARIPCGYSSGWAGFDYW	IGHV2-26	IGHJ4
TGTGCACGGAAGCGGTTGCCGAGTATAGTGGGAGCTACTAAATTTCGGGACTACTGG	CARKRLPSIVGATKFRDYW	IGHV2-70	IGHJ4
TGTGCGAGAATGTACAGATTTTTGGAGTGGTTATTACCCTATTTTGACTACTGG	CARMYRFLEWLLPYFDYW	IGHV3-66	IGHJ4
TGTGCGAAAGTGATCAGTCATCCTTCTGACTACTGG	CAKVISHPSDYW	IGHV3-23	IGHJ4
TGTGCACGGGAGCTTATGATTACATTTGGGGGAGTTATCGTTAGGCAAACTGACTACTGG	CARELMITFGGVIVRQTDYW	IGHV2-70	IGHJ4
TGTGCGAGAGATCCCATTACAGTAACTACGTGGTTCGACCCCTGG	CARDPITVTTWFDPW	IGHV3-11	IGHJ5
TGTGCGAGAGAACAGCAGTGGCCATCCATCCCACGCCACAACTGGTTCGACCCCTGG	CAREQQWPSIPRHNWFDPW	IGHV1-2	IGHJ5
TGTGCGAGAGATCAGGTGTATTGTAGTAGTACCAGCTGCTATTTCAATGGGCTTGACTACTGG	CARDQVYCSSTSCYFNGLDYW	IGHV3-53	IGHJ4
TGTGCGAGACGTCGTTGGTCCTTGGGTGATGACTACTACATGGACGTCTGG	CARRRWSLGDDYYMDVW	IGHV4-39	IGHJ6
TGTGCAAGAGATTCCATTTGTAGTAGTACCAGCTGCTGGCCCGCAACAGTTGACTACTGG	CARDSICSSTSCWPATVDYW	IGHV3-74	IGHJ4
TGTGCAAAAGATATTCCCTATTGTAGTAGTACCAGCTGCTATGGGGCGGGGGACTACTGG	CAKDIPYCSSTSCYGAGDYW	IGHV3-43D	IGHJ4
TGTGCAAAAAATAAATGGTTTTGGAAAGGTACTTCGCGGAACGGAGGAGTGCAGCAGCTGTTTCTCGTTAAATCTCCCAGCTACTACTACTACATGGACGTCTGG	CAKNKWFWKGTSRNGGVQQLFLVKSPSYYYYMDVW	IGHV6-1	IGHJ6
TGTGCAAGTATGGGTATAGCAGCATGCGTGTACTACTTTGACTACTGG	CASMGIAACVYYFDYW	IGHV3-74	IGHJ4
TGTGCGAGAGGGGATATTGTAGTAGTACCAGCTGCTATTCGCGGGCTTCACCCCGATGCTTTTGATATCTGG	CARGDIVVVPAAIRGLHPDAFDIW	IGHV4-34	IGHJ3
TGTGCGAGAGTCCCTAATAGCAGCCCTCGAACGGTTTCGGGGCGTTTTCCTGACTACTTTGACTACTGG	CARVPNSSPRTVSGRFPDYFDYW	IGHV1-2	IGHJ4
TGTGCGAGAAAATGGCTTTGTAGTGGTGGTAGCTGCTACGGGCACAACTGGTTCGACCCCTGG	CARKWLCSGGSCYGHNWFDPW	IGHV4-38-2	IGHJ5
TGTGCGAGAACCTACACGGTGGCTACAATTGCAACCTTTGACTACTGG	CARTYTVATIATFDYW	IGHV7-4-1	IGHJ4
TGTGCGAGAGCCCCGGGAAGTGGCTGGATTTGG	CARAPGSGWIW	IGHV4-34	IGHJ4
TGTGCGAGAGTAGTTTCCTTCATTACTATGATAGTAGTGGTTCTTTTGGCCGCCATGAGCGCTTTTGATATCTGG	CARVVSFITMIVVVLLAAMSAFDIW	IGHV1-2	IGHJ3
TGTGCGAGAGATGACTACAACTACTTTGACTACTGG	CARDDYNYFDYW	IGHV3-30	IGHJ4
TGTGCAACAGATCGAGGGTTGATGCGTATTACTATGGTTCAGGGAGTTATTATAGCCTGTACTGGGCATCACTACTACTACATGGACGTCTGG	CATDRGLMRITMVQGVIIACTGHHYYYMDVW	IGHV1-24	IGHJ6
TGTGCGAGAGATCGTCAGACTTTTGGGGGAGTTATCGCCTGCTTTGACTACTGG	CARDRQTFGGVIACFDYW	IGHV3-53	IGHJ4
TGTGCGAGAGATCAGTTGGTCATAACTGGAACGCTCATAGACTGG	CARDQLVITGTLIDW	IGHV3-53	IGHJ5
TGTGCGAAAGATAACGAGTATTATGATTACATTTGGGGGAGTTATCGTTATGGAAAGGGGTGCTTTGACTACTGG	CAKDNEYYDYIWGSYRYGKGCFDYW	IGHV3-NL1	IGHJ4
TGTACCACGGACGTTAATGACTACGGTGACTACAAAGATGACCACTACTACTACTACTACTACATGGACGTCTGG	CTTDVNDYGDYKDDHYYYYYYMDVW	IGHV3-15	IGHJ6
TGTGCGAGCCGAGATCCAGCACTCAAGGTATTACGATATTTTGACTGGTTAAGGTCCGTAGTTCGGAGAGCCGGGGGCTATCCTTTTAATTACTACTACTACATGGACGTCTGG	CASRDPALKVLRYFDWLRSVVRRAGGYPFNYYYYMDVW	IGHV3-21	IGHJ6
TGTGCGAGAGATTTCATCAAAGACGTATTACTATGGTTCAGGGAGTTATTATGCTGCGAATTGCCCCCGAACTTTGACTACTGG	CARDFIKDVLLWFRELLCCELPPNFDYW	IGHV3-7	IGHJ4
TGTGCCGGAGGTGGTAGCTGCTACTGCTGGAAACGGGACTGGTTCGACCCCTGG	CAGGGSCYCWKRDWFDPW	IGHV3-30	IGHJ5
TGTTTGGTAGTATTGGGGTTGGACTACTGG	CLVVLGLDYW	IGHV3-49	IGHJ4
TGTGCGAGAGATGGGTCTATTTACTATGATAGTAGTGGTTATTACGGCAGAATCATACCCTGGGATGCTTTTGATATCTGG	CARDGSIYYDSSGYYGRIIPWDAFDIW	IGHV3-48	IGHJ3
TGTGCGAGAGATCTATGCCCCCTGGGAGAGGATGCAGCAGCTGGGTTTTTGCTGACGCGTCCAGACTACTGG	CARDLCPLGEDAAAGFLLTRPDYW	IGHV3-53	IGHJ4
TGTGCGAAAGAGGCGTACAGGGAGTTATTAGTTGACTACTGG	CAKEAYRELLVDYW	IGHV3-23	IGHJ4
TGTGCGAGAGGCGGGTCGGGTAATATTGTAGTAGTACCAGCTGCTATACTACCTCCTGTGAAACCCGGAAACTTTGACTACTGG	CARGGSGNIVVVPAAILPPVKPGNFDYW	IGHV4-34	IGHJ4
TGTGCGAGAGTCTCCTCACGGCGGGATTACTATGATAGTAGTGGTTATCCAAACTGGTTCGACCCCTGG	CARVSSRRDYYDSSGYPNWFDPW	IGHV1-46	IGHJ5
TGTGCGAGACATTGCTACTATGATAGTAGTGGTTATTACTCGAAATGGGATTCAAGGGGGCTCCGGCCGTGTACGGTGTATCCTGACTACTGG	CARHCYYDSSGYYSKWDSRGLRPCTVYPDYW	IGHV5-10-1	IGHJ4
TGTGCACGACGAAGTACCAGCTGCTACTTGTGGATCGGCGATGACTACTGG	CARRSTSCYLWIGDDYW	IGHV2-26	IGHJ4
TGTGCACTTCCTGCCATCAATGGGGGTACCCTCTACTGG	CALPAINGGTLYW	IGHV1-2	IGHJ4
TGTGCGAAAGATCAGGAAGAGTATGATTACATTTGGGGGAATCCGGACTACTGG	CAKDQEEYDYIWGNPDYW	IGHV3-NL1	IGHJ4
TGTGCGAGACACCCAGCATTTTGTGACTACTGG	CARHPAFCDYW	IGHV5-51	IGHJ4
TGTGCGAGAATTTTTGGAGTGGGGACGGGCGTAGGGATCTACTACTACTACATGGACGTCTGG	CARIFGVGTGVGIYYYYMDVW	IGHV5-10-1	IGHJ6
TGTACCACAGATCCCAAGTATTGTAGTGGTGGTAGCTGCTACTTT	CTTDPKYCSGGSCYF	IGHV3-15	IGHJ4
TGTGCAAGATCGGGGTCTGTGGGCCCGCATATTGTAGTGGTGGTAGCTGCTATTTATTACTACTACTACTACTACATGGACGTCTGG	CARSGSVGPHIVVVVAAIYYYYYYYMDVW	IGHV1-45	IGHJ6
TGTGCAAAAGATATAAGTGGTGGTGTATGCTATCGTGACTACTTTGACTACTGG	CAKDISGGVCYRDYFDYW	IGHV3-43	IGHJ4
TGTGCGAAAGTCAAAGTGATAACGGTACATAGCAGCTCGTCCCAGGTAAGACACTGG	CAKVKVITVHSSSSQVRHW	IGHV3-23	IGHJ4
TGTGCGAGAGTCGGTCTAGGATATTGTACTAATGGTATCTGCTACTGG	CARVGLGYCTNGICYW	IGHV7-4-1	IGHJ4
TGTGCGAGACCGATCGGTCTATTGTACTGGTGGTGTATGGACCACCAACCCTTTGACTACTGG	CARPIGLLYWWCMDHQPFDYW	IGHV1-2	IGHJ4
TGTGCGAGAGATCTGGCTGTTCCTGTGTTCGAGTATAGCAGCTCGTCGTTTGACTACTGG	CARDLAVPVFEYSSSSFDYW	IGHV1-18	IGHJ4
TGTGCGCGGACGTATAGCAGCTCGTACTTTGACTACTGG	CARTYSSSYFDYW	IGHV1-2	IGHJ4
TGTGCGAGAGAAGATATTGTAGTAGTACCAGCTGCTATGAGGCAACGCTACTACTACTACATGGACGTCTGG	CAREDIVVVPAAMRQRYYYYMDVW	IGHV1-2	IGHJ6
TGTGCGAGAGGGGGGGAGCTTCGTTGTTGGTTCGACCCCTGG	CARGGELRCWFDPW	IGHV4-59	IGHJ5
TGTGCGAGAGTCCTCAGCCCCTATATTACTATGATAGTAGTGGTTATTACTACCGGGTCCGGCCTCCGGGCGGGAGGTTCCCGGGTTGACTACTGG	CARVLSPYITMIVVVITTGSGLRAGGSRVDYW	IGHV3-21	IGHJ4
TGTGCGAAAGATAGGGTAGACCAGTGGCTGGTAGTCTACTGG	CAKDRVDQWLVVYW	IGHV3-23	IGHJ4
TGTGCAAGAGACCGGATTTATAGCAGTGGCTGGTACGGGAACTACTACTACTACATGGACGTCTGG	CARDRIYSSGWYGNYYYYMDVW	IGHV3-13	IGHJ6
TGTGCAAGCCCCTCTGGGGTATCCTCGAGTATAGCAGCTTCTGACTACTGG	CASPSGVSSSIAASDYW	IGHV3-74	IGHJ4
TGTGCGAAAGAGACTAAGCAGTGGCTGGAATGCTACTGG	CAKETKQWLECYW	IGHV3-23	IGHJ4
TGTGCGATCTCCTCTACGTTTGACCTGCCGCCAATGTCGCACCATATTTGGTTTGGGTTAACTTACTGGTTCGACCCCTGG	CAISSTFDLPPMSHHIWFGLTYWFDPW	IGHV3-23	IGHJ5
TGTGCGAGAGGGATGATTACTATGGTTCAGGGAGTTATTATAAGCCCGAATTTAATTTACGGTGACTACTGG	CARGMITMVQGVIISPNLIYGDYW	IGHV1-2	IGHJ4
TGTGCAAGAGATTGTCCCCGTGTTACAAAGTATAGCAGCTCGTCTAAAGTCAAGTACCGTGACTACTGG	CARDCPRVTKYSSSSKVKYRDYW	IGHV1-45	IGHJ4
TGTAGCCCCTCTCATGGATTTGAGAAGGTCCGGACGGAGGGGATCGCCGGTCACCTTGTAGTGGTGGTAGCTGCTAGGGGGTCTGCTTTTGATATCTGG	CSPSHGFEKVRTEGIAGHLVVVVAARGSAFDIW	IGHV3-23	IGHJ3
TGTGCGAGAGGGCTAGGGATAGTAGTGCCCTTTGACTACTGG	CARGLGIVVPFDYW	IGHV4-59	IGHJ4
TGTACCTCGTACTATGGTTCGGGGAGCTGGGGTCTCGACCCCTGG	CTSYYGSGSWGLDPW	IGHV3-15	IGHJ5
TGTGCACACAACGGCAGGGGATATTGTAGTAGTACCAGCTGCTATCTCGACCCGGTGTCCACCCCGAGAAGGCGGTTTATACACTGG	CAHNGRGYCSSTSCYLDPVSTPRRRFIHW	IGHV2-5	IGHJ5
TGTGCGAGAGATCGGCGAGTCTGGTGGTGTATGCTATTGGGAGGGGACGCCCTCAAAGAATTTCCTAGCAACTGGTTCGACCCCTGG	CARDRRVWWCMLLGGDALKEFPSNWFDPW	IGHV1-46	IGHJ5
TGTGCGAAAGATTCACCCACTGATTCTATTGTGGTGGTGACTGCTAAAAGGTGCCTACCCTGGTTCGACCCCTGG	CAKDSPTDSIVVVTAKRCLPWFDPW	IGHV3-NL1	IGHJ5
TGTGCGAAAGGTATAGCAGTGGCTGACCCCGATCTTGACTACTGG	CAKGIAVADPDLDYW	IGHV3-NL1	IGHJ4
TGTGCGAGAGGTTTTCGTAGTACCAGCTGCTATTCTTTCCGTGGGCCTTCCTACTGG	CARGFRSTSCYSFRGPSYW	IGHV3-53	IGHJ4
TGTGCACACAGACCGGAATCCCTTCGGCCAAGGAAACGCTCCCATAACATACTACGGCAAAATGATGCTTTTGATATCTGG	CAHRPESLRPRKRSHNILRQNDAFDIW	IGHV2-5	IGHJ3
TGTGCACACAGGTTCGGCGCGAGGATATTGTACTGGTGGTGTATTTCAGCTGTTTACTACTACTACTACTACATGGACGTCTGG	CAHRFGARILYWWCISAVYYYYYYMDVW	IGHV2-5	IGHJ6
TGTACCACGATCCGCACTACCAAGATACAGGATTACTATGGTTCGGGGAGTTATTATAACGTTACCTACTGG	CTTIRTTKIQDYYGSGSYYNVTYW	IGHV3-15	IGHJ4
