TGTGCGAGAGATATTACTATGGTTCGGGGAGTTATTGTAAGGATTATTAACTGG	CARDITMVRGVIVRIINW	IGHV1-2	IGHJ4
TGTGCGAGAGCAAGCTACTACTACTACTACATGGACGTCTGG	CARASYYYYYMDVW	IGHV3-7	IGHJ6
TGTGCGAGGAACTTACTTAGTCGTCCTATTGTGGTGGTGACTGCTAGGCCAGACTATTTTGACTACTGG	CARNLLSRPIVVVTARPDYFDYW	IGHV3-NL1	IGHJ4
TGTGCAAGAGATCGAGGTAGTGGGATGCGCGACTACTGG	CARDRGSGMRDYW	IGHV3-74	IGHJ4
TGTGCAAAAGACTGGATATTGTACTGGTGGTGTATGCTGCCGTGGACGGGCTGGTTCGACCCCTGG	CAKDWILYWWCMLPWTGWFDPW	IGHV3-43D	IGHJ5
TGTGCAAGAATGCACTATAGGGACTACTGG	CARMHYRDYW	IGHV3-74	IGHJ4
TGTGCGAGAGGAGCGGTGGTAGCTGCTACTAGTCCCCAAGGATACTTTGACTACTGG	CARGAVVAATSPQGYFDYW	IGHV3-11	IGHJ4
TGTGCGAAAGCGCCAAACACCTTTGACTACTGG	CAKAPNTFDYW	IGHV3-23	IGHJ4
TGTGCGAGAGATGGCCTTAACAGGGCAGCTCGTCCCAACAGAGTGTTTCCGTGGTTCGACCCCTGG	CARDGLNRAARPNRVFPWFDPW	IGHV1-3	IGHJ5
TGTGCGAGAGACGTTTTACGTATAGCAGCAGCTGGTACTGTATATCCTCCTCCAGATGCTTTTGATATCTGG	CARDVLRIAAAGTVYPPPDAFDIW	IGHV1-3	IGHJ3
TGTGCAAGAGATTTTTGGAGTGGTTATTCTGGGATCGCAGGGGCCAGCGAACCAGACAAGCTGAAGCCCTACTACTTTGACTACTGG	CARDFWSGYSGIAGASEPDKLKPYYFDYW	IGHV3-13	IGHJ4
TGTACTAGCAGATATTGTAGTGGTGGTAGCTGCTACTGCTTTGACTACTGG	CTSRYCSGGSCYCFDYW	IGHV3-49	IGHJ4
TGTGCGAGCCGATACTATGATAGTAGTGGTTATATCCGATCCTACTTTGACTACTGG	CASRYYDSSGYIRSYFDYW	IGHV3-53	IGHJ4
TGTGCGAGACCCCTGCCCAGATGTATTACTATGATAGTAGTGGTTATTAGAATATGG	CARPLPRCITMIVVVIRIW	IGHV1-3	IGHJ5
TGTGCGAAAGATCCCGCATTACTATGGTTCGGGGAGTTATTATACGGCACCTACTACTTTGACTACTGG	CAKDPALLWFGELLYGTYYFDYW	IGHV3-23	IGHJ4
TGTGCACGGACCGTGGATATTGTAGTGGTGGTAGCTGCTAGCCATGTTGACTACTGG	CARTVDIVVVVAASHVDYW	IGHV2-70	IGHJ4
TGTGCGAAACAATTTATAGCAGTGGCTGGTACACTAGTGGGGCTCTCCAACTGGTTCGACCCCTGG	CAKQFIAVAGTLVGLSNWFDPW	IGHV3-23	IGHJ5
TGTACCACGGTATCCGGAAAATGGAGCCCTGACTACTGG	CTTVSGKWSPDYW	IGHV3-15	IGHJ4
TGTGCGAGTATTGTACTGGTGGTGTATGCCCACTACTACTACTACATGGACGTCTGG	CASIVLVVYAHYYYYMDVW	IGHV7-4-1	IGHJ6
TGTGCGAGAGGGTGTGCCAAAAGCAGTGGCTTTGGAATACACTACTGG	CARGCAKSSGFGIHYW	IGHV1-2	IGHJ4
TGTACCACCCGATTTTCCCGTACGGGGTCGGTAGTACCAGCTGCGAATGACTGGTTCGACCCCTGG	CTTRFSRTGSVVPAANDWFDPW	IGHV3-15	IGHJ5
TGTGCGAGCCCAGGGGTTCGTATTACGATTTTTGGAGTGGTTATTCCCGGCTCGGCGGTTGACTACTGG	CASPGVRITIFGVVIPGSAVDYW	IGHV1-46	IGHJ4
TGTGCGAGAGATCATGACTACGGTGACTACGCTCCGGTAGATCCCCCAGACTGG	CARDHDYGDYAPVDPPDW	IGHV4-59	IGHJ4
TGTGCGAGAGATCGCAGTATAGCAGTGGACTACTTTGACTACTGG	CARDRSIAVDYFDYW	IGHV3-53	IGHJ4
TGTGCGAGAGATCACTCGTATAACTGGAACTACGCTCAGGCATTGAAGGACTACTGG	CARDHSYNWNYAQALKDYW	IGHV1-46	IGHJ4
TGTGCGAGAGCCGTTACTATGGTTCAGGGAGTTAGGGTAGGGAGGAAATCTGACTACTGG	CARAVTMVQGVRVGRKSDYW	IGHV3-11	IGHJ4
TGTGCGAGAAATTTGGGGGAGTTATCGTTCCGCCATGCTTTTGATATCTGG	CARNLGELSFRHAFDIW	IGHV4-28	IGHJ3
TGTGCGAGAGTTAGGTTCTACGGTGCTTCGACGAGAGCCTTTGACTACTGG	CARVRFYGASTRAFDYW	IGHV1-3	IGHJ4
TGTGCAAGAGCCCGCCTATTACGATTTTTGGAGTGGTTAGGCTACTACTACTACTACATGGACGTCTGG	CARARLLRFLEWLGYYYYYMDVW	IGHV6-1	IGHJ6
TGTGGGCCTGGATACAGCTATGGGACCAGCCTAGTGGCCTACTGGTACTTCGATCTCTGG	CGPGYSYGTSLVAYWYFDLW	IGHV3-30-3	IGHJ2
TGTGCAAGAGATATTATACGATTTTTGGAGTGGTTATCCGCGGTGTATTACTACTACTACTACTACATGGACGTCTGG	CARDIIRFLEWLSAVYYYYYYYMDVW	IGHV3-74	IGHJ6
TGTGCGAAAGGATATTGTACTAATGGTGGAATCGTAGACTGGTTCGACCCCTGG	CAKGYCTNGGIVDWFDPW	IGHV3-NL1	IGHJ5
TGTGCGCCGTTGTGGGAGCCCATAGTGGCTACGATAGACGGACGGGATAGCCTTGACTACTGG	CAPLWEPIVATIDGRDSLDYW	IGHV1-3	IGHJ4
TGTGCGAGAGAGAAGCAGCAGCTGGTACCGGGTAGTGACCCCTTCGGTGACTACTGG	CAREKQQLVPGSDPFGDYW	IGHV1-69	IGHJ4
TGTGCACGGATCTTTACGATTTTTGGAGTGGTTCACTCTGGCTACATGGACGTCTGG	CARIFTIFGVVHSGYMDVW	IGHV2-26	IGHJ6
TGTGCAAGAGGGACGAGGTATAGCAGTGGCTGGTACAACCGGTATGGCACGGTTCGGTACTTTGACTACTGG	CARGTRYSSGWYNRYGTVRYFDYW	IGHV3-13	IGHJ4
TGTGCGAGAGCTGTGATAAGCTCGGATATTGTAGTAGTACCAGCTGCTATAATTCGAGCTCACTGG	CARAVISSDIVVVPAAIIRAHW	IGHV3-21	IGHJ4
TGTGCGAGACTCGTGTATTACTATGATAGTAGTGGTTATTACTACGTCACTAAAGACTACTGG	CARLVYYYDSSGYYYVTKDYW	IGHV5-51	IGHJ4
TGTGCGAAAGATCTTTCGATACCGCACCGATACAGCTATGGTTATAGCTCCGGTTACTTTGACTACTGG	CAKDLSIPHRYSYGYSSGYFDYW	IGHV3-23	IGHJ4
TGTGCGAAAGCGCCTGATATAGTGGCTACGATTAGGGCAGAAGTAAACCGGGGAGTCCTCAGTGACTGGTTCGACCCCTGG	CAKAPDIVATIRAEVNRGVLSDWFDPW	IGHV3-NL1	IGHJ5
TGTGCGAGAGATCGCGCGTATTACGATTTTTGGAGTGGTTATACTGACTTTGACTACTGG	CARDRAYYDFWSGYTDFDYW	IGHV3-53	IGHJ4
TGTACCACCCACGCTAAAAGTGGCTGTGCCGTTGACTACTGG	CTTHAKSGCAVDYW	IGHV3-15	IGHJ4
TGTGCGAGAACTACTAATACCCTGTCTAGGTATAGCAGCAGCTGGACTGCTTTTGATATCTGG	CARTTNTLSRYSSSWTAFDIW	IGHV3-21	IGHJ3
TGTGCGAGAGGGTTCGATATTGTACTGGTGGTGTATGCTATTGTCTACTGG	CARGFDIVLVVYAIVYW	IGHV3-20	IGHJ4
TGTGCGAAAGGCGTCATAACGCCCCGGGTAACGGTTTCTCGCGACTACTGG	CAKGVITPRVTVSRDYW	IGHV3-23	IGHJ4
TGTACCACAGTCCGCAATTGCAGCTCGAGCTTAATGGGGAGCGTTGACTACTGG	CTTVRNCSSSLMGSVDYW	IGHV3-15	IGHJ4
TGTGCAAGGAAGGTCAGGCTATGGTTACCCCTCTTCATATCGCATTACCCTTCAGGCTACTGG	CARKVRLWLPLFISHYPSGYW	IGHV1-45	IGHJ4
TGTGCGAGAGTTAGGAGAGTGATTGTAGTGGTGGTAGCTGCTGAGGGTCAGAACTACTACTACTACATGGACGTCTGG	CARVRRVIVVVVAAEGQNYYYYMDVW	IGHV4-59	IGHJ6
TGTGCAAGAGCCCATAGGCCCACTGGTGATGCAGAGCTGCTATCCTCGCGGCAATACTACTACTACATGGACGTCTGG	CARAHRPTGDAELLSSRQYYYYMDVW	IGHV1-45	IGHJ6
TGTGCGAAAGGAGCCACGGTGCCGATCCCTGGTCGGAGGGGTCTACTGTGGTTTGTAGTACCAGCTGCTAATTATTACTACTACTACTACTACATGGACGTCTGG	CAKGATVPIPGRRGLLWFVVPAANYYYYYYYMDVW	IGHV3-23	IGHJ6
TGTGCGAGCGACTCGTTACGATATTTTGACTGGTTGTTCCAGCACTGG	CASDSLRYFDWLFQHW	IGHV1-2	IGHJ1
TGTGCGATCGCTCACCGTATTACGATTTTTGGAGTGGTTATTATTGAGGGAAGCTACTGG	CAIAHRITIFGVVIIEGSYW	IGHV1-2	IGHJ4
TGTGCGAAAGGACTGACTCCACGATTTTTGGAGTGGTTATTGAGAATCAATCTTGACTACTGG	CAKGLTPRFLEWLLRINLDYW	IGHV3-23	IGHJ4
TGTGCGAGACCCGAGGGATGGCTACAATTACATGCACCTTTAAGCTACTGG	CARPEGWLQLHAPLSYW	IGHV1-2	IGHJ4
TGTGCGAGCTCCCAGTACCAGCTGCTATATTGCTTTGACTACTGG	CASSQYQLLYCFDYW	IGHV1-18	IGHJ4
TGTGGCCAACGGGGAGTGGCAGTGGCTGGTAACCTTGGTCTAAAACGCTACTTTGACTACTGG	CGQRGVAVAGNLGLKRYFDYW	IGHV3-30	IGHJ4
TGTACCACCTGGGTTCGGGGAGTTATTACGTATGACCGCTTGGGGGGAAGGGGAAACTGGTTCGACCCCTGG	CTTWVRGVITYDRLGGRGNWFDPW	IGHV3-15	IGHJ5
TGTCGGTTCTGCGTGACTACGGTGACCCTTGTGATGGAGGTTGGCACGGACTACTGG	CRFCVTTVTLVMEVGTDYW	IGHV6-1	IGHJ4
TGTGCGAGACGAATCCGTACAGTAACTGACTACTGG	CARRIRTVTDYW	IGHV4-39	IGHJ4
TGTGCGAGACTTGAGCGTGAGGTAAAATATTGTAGTAGTACCAGCTGCTATGGGGGGATTGACTACTGG	CARLEREVKYCSSTSCYGGIDYW	IGHV1-2	IGHJ4
TGTGCGAAATTACCCCACCGTGTTAGGCCCCGGTTGCTATTGGGTGATGCTTTTGATATCTGG	CAKLPHRVRPRLLLGDAFDIW	IGHV3-23	IGHJ3
TGTGCGAGTAGTCCCATAGTACCAGCTGCTATCCGCAACTGGTTCGACCCCTGG	CASSPIVPAAIRNWFDPW	IGHV4-59	IGHJ5
TGTGCGAGAGTGGGTGGATATAGTGGCTACGATCTGACGGACTACTACTACTACTACATGGACGTCTGG	CARVGGYSGYDLTDYYYYYMDVW	IGHV3-53	IGHJ6
TGTGCGAGACATTATCGCTTTCGATATTGTACTAATGGTGTATGCTATATGTGCTCGGTGGAATTTGACTACTGG	CARHYRFRYCTNGVCYMCSVEFDYW	IGHV4-39	IGHJ4
TGTGCGAGAGATCTGGAGAGGGATATTGTAGTAGTACCAGCTGCTTTCTACTACTACTACTACATGGACGTCTGG	CARDLERDIVVVPAAFYYYYYMDVW	IGHV1-69	IGHJ6
TGTGCGAAAGATCTTGGTCGTTACTATGATAGTAGTGGTTATTACAATGGCCCATACTTTGACTACTGG	CAKDLGRYYDSSGYYNGPYFDYW	IGHV3-NL1	IGHJ4
TGTGCGAGAGATGAGGAGAAATGGGCCATTCCTTACTGG	CARDEEKWAIPYW	IGHV3-11	IGHJ4
TGTGCGAAAGATGTACCCGACAATCGGTTCGACCCCTGG	CAKDVPDNRFDPW	IGHV3-23	IGHJ5
TGTGCGAGTCGATTTTTGGAGTGGTTATTATTCATGACGACGACCCCCTGG	CASRFLEWLLFMTTTPW	IGHV4-34	IGHJ5
TGTGCGACCAACATTGTAGTAGTACCAGCTGCTATGTTGTTCGACCCCTGG	CATNIVVVPAAMLFDPW	IGHV3-NL1	IGHJ5
TGTGCGAAAGATGCCCGGGCCCGGCCGTTAATCGGTGGAGTACGATTTTTGGAGTGGTTATTAAGAGCCGGGGACTACTACTACTACATGGACGTCTGG	CAKDARARPLIGGVRFLEWLLRAGDYYYYMDVW	IGHV3-NL1	IGHJ6
TGTGCAAGAACAGATATAGCAGCAGCTCACAGCGCCCTCTACTGG	CARTDIAAAHSALYW	IGHV3-13	IGHJ4
TGTGCGAGAGTATATAGTGGCTACGAAGCGGGATTTGACTACTGG	CARVYSGYEAGFDYW	IGHV4-34	IGHJ4
TGTGCGAGCGGGGGGAGTATTACTATGGTTCGGGGAGTTGTTGGCTACTGG	CASGGSITMVRGVVGYW	IGHV4-34	IGHJ4
TGTGCGAGAGTGACTTACTATGGTTCAGGGAGTTATTATAACACAGGTCCCGGCCCCTGG	CARVTYYGSGSYYNTGPGPW	IGHV1-2	IGHJ4
TGTGCGAGAGATCAAAAGATTACTATGATAGTAGTGGTTAGAAAAGGGGAGGCCTACTGG	CARDQKITMIVVVRKGEAYW	IGHV3-48	IGHJ4
TGCCGAAGTAAGGTTGGGGGGGAGACTGGGGACTGGTTCGACCCCTGG	CRSKVGGETGDWFDPW	IGHV4-39	IGHJ5
TGTGCGAGAGTTGTCCGAGCTATTGTACTGGTGGTGTATGCACTTGATTACTACTACTACTACTACATGGACGTCTGG	CARVVRAIVLVVYALDYYYYYYMDVW	IGHV4-4	IGHJ6
TGTGCGAGAGGGAGCCGGCTCCCAAATAGCAGTGGCTGGGACTGG	CARGSRLPNSSGWDW	IGHV4-34	IGHJ4
TGTGCGAGTAGTGACATCGTAGATTACTATGGTTCAGGGAGTTATCCTGGCCACCGCTACTACATGGACGTCTGG	CASSDIVDYYGSGSYPGHRYYMDVW	IGHV1-46	IGHJ6
TGTGCGAGAGATCGCCCCTTTCGGGCCGCGTGGCTACGCCCGTTGGAATACTTCCAGCACTGG	CARDRPFRAAWLRPLEYFQHW	IGHV1-18	IGHJ1
TGTGCGAGAGATATTACGATTTTTGGAGTGGTTAGTGTTAGACACTACATGGACGTCTGG	CARDITIFGVVSVRHYMDVW	IGHV3-7	IGHJ6
TGTGCAAGGGCGGGTTATGGTTCAGGGAGTTATTATAACGTTTCGAGCTACTGGTACTTCGATCTCTGG	CARAGYGSGSYYNVSSYWYFDLW	IGHV3-74	IGHJ2
TGTGCGAGTCGTAGTACCAGCTGCGGCGGCTGCTACTACTACTACTACATGGACGTCTGG	CASRSTSCGGCYYYYYMDVW	IGHV1-69	IGHJ6
TGTGCGAGAAATGCCCACCTTGGGGTGGTGGTAGCTGCTACCCCGACAGTGACCTACTTTGACTACTGG	CARNAHLGVVVAATPTVTYFDYW	IGHV3-21	IGHJ4
TGTGCGAGATGCCTTCTCCCTCGTGGGAGCTACTACGTGAATATCTGG	CARCLLPRGSYYVNIW	IGHV7-4-1	IGHJ5
TGTGCGAGAGATAGAACCAGGTATAACTGGAACTACGGATACTACATGGACGTCTGG	CARDRTRYNWNYGYYMDVW	IGHV3-30	IGHJ6
TGTGCGAGAGGGCCACATGGTTATAGCAGTGGCGGGGGTACACACTACTTTGACTACTGG	CARGPHGYSSGGGTHYFDYW	IGHV4-34	IGHJ4
TGTGCGAGAGTTACTATGATAGTAGTGGTTATTAAGGGCGACTACTGG	CARVTMIVVVIKGDYW	IGHV4-59	IGHJ4
TGTGCGAGAGATAAAAAGGGTAGTGGCTACGATTCGGTGATCGAGTACTACTACTACTACTACATGGACGTCTGG	CARDKKGSGYDSVIEYYYYYYMDVW	IGHV1-3	IGHJ6
TGTGCACGGATACGCATAGCAGTGGCTGGGGCTTTTGATATCTGG	CARIRIAVAGAFDIW	IGHV2-26	IGHJ3
TGTGCGAGAGATTTCAGGTGTAGTGGTGGTAGCTGCTACTCCTTAGGGACTGATGCTTTTGATATCTGG	CARDFRCSGGSCYSLGTDAFDIW	IGHV4-59	IGHJ3
TGTGCACGGATATCGGGGAGTGGGAGCTACTTGGGTGACTACTGG	CARISGSGSYLGDYW	IGHV2-70	IGHJ4
TGTGCGAGAGATGGAGTACCAGCTGCTATCCTGGGTGTTGGCGGGGTTGTGATTTTCCGACTTAATGCTTTTGATATCTGG	CARDGVPAAILGVGGVVIFRLNAFDIW	IGHV4-59	IGHJ3
TGTGCGAGAGAAGAGCCCCGGATTGTAGTAGTACCAGCTGCTATTAGGGGGACCTGG	CAREEPRIVVVPAAIRGTW	IGHV4-59	IGHJ4
TGTGCGAAAGATCAGATGGAGTGGTTCGGGGACTACTGG	CAKDQMEWFGDYW	IGHV3-23	IGHJ4
TGTGCGAGAGATGCACATGTAGTAGTACCAGCTGCCCGCGAAGTCTGG	CARDAHVVVPAAREVW	IGHV3-21	IGHJ4
TGTGCAAGAGTCAGACTTATGGTAGTAGTACCAGCTGCAGGGGGGGACTACTGG	CARVRLMVVVPAAGGDYW	IGHV3-74	IGHJ4
TGTGCGAGAAAGACTCCTGCCCGACGCTCGCTCCCCATAGTGGCTACGATTCACTTTGACTACTGG	CARKTPARRSLPIVATIHFDYW	IGHV4-38-2	IGHJ4
TGTACCACGCCGCCGGCCTACGGTGACTATCCGGTCGGCAACCCCAGCTTTGACTACTGG	CTTPPAYGDYPVGNPSFDYW	IGHV3-15	IGHJ4
