TGTGCGAAAGGCCCGGAGTTCAATTGGGGTGGATATAGTGGCTACGATTCCACATTTGACTACTGG	CAKGPEFNWGGYSGYDSTFDYW	IGHV3-NL1	IGHJ4
TGTGCGAAACCCGGTCAGATTAATCGTGGACACTCCGTTAATTACTACTACTACTACTACATGGACGTCTGG	CAKPGQINRGHSVNYYYYYYMDVW	IGHV3-23	IGHJ6
TGTGCAAGAGATGGCCGTACTGGTGGTGTATGCTTGGACGCTAGGGTCGGGGCATACTACTACTACTACATGGACGTCTGG	CARDGRTGGVCLDARVGAYYYYYMDVW	IGHV3-74	IGHJ6
TGTGCGAGTCCACAGTGGCTGGTAATTTGGCGCCGGTTCGACCCCTGG	CASPQWLVIWRRFDPW	IGHV4-59	IGHJ5
TGTGCACGGGGTCATTACTATGATAGTAGTGGTTATTCCACCTTTGACTACTGG	CARGHYYDSSGYSTFDYW	IGHV2-70	IGHJ4
TGTGCGAGGGGTGCGGCACCGGAAAAACATTACTATGATAGTAGTGGTTATTTAAATGCGGACACTGCTTTTGATATCTGG	CARGAAPEKHYYDSSGYLNADTAFDIW	IGHV1-46	IGHJ3
TGTGCGAGGCCCCACCGGTGGCTACGAACGTTCCTGGTCTACTGG	CARPHRWLRTFLVYW	IGHV3-7	IGHJ4
TGTGCAAAAGACCACATGATGGCGATCCGATCGGACTACTGG	CAKDHMMAIRSDYW	IGHV3-43	IGHJ4
TGTGCGAGACACCGTGGGTTTATCTTACTATGGTTCGGGAAACCCTACGTTGACTACTGG	CARHRGFILLWFGKPYVDYW	IGHV5-51	IGHJ4
TGTGCGCCGGGCGTGGTAGCTGCTACGGTACGTCCCTGGTTCGACCCCTGG	CAPGVVAATVRPWFDPW	IGHV3-NL1	IGHJ5
TGTGCAAGAGATGTTCGGGGTATTGTAGTAGTACCAGCTGCTAATTTCCGACGATACTACTACTACATGGACGTCTGG	CARDVRGIVVVPAANFRRYYYYMDVW	IGHV3-74	IGHJ6
TGTGCAAGATTTGGAAATTCGGATATTGTAGTAGTACCAGCTGCTATCGGGTTCAGGGCCACGGCTACTGACTACTGG	CARFGNSDIVVVPAAIGFRATATDYW	IGHV3-13	IGHJ4
TGTGCGAGAGGCCGGCCCTACGGATTACGATATTTTGACTGGGACGGCACCTGGATGTACTACTACTACATGGACGTCTGG	CARGRPYGLRYFDWDGTWMYYYYMDVW	IGHV4-34	IGHJ6
TGTGCGAGAGATTGTAGTAGTACCAGCTGCTATGTAGTCTACTACTACTACTACATGGACGTCTGG	CARDCSSTSCYVVYYYYYMDVW	IGHV7-4-1	IGHJ6
TGTGCGAAAGATCGGACGCGAGGACAAGATTACTATGATAGTAGTGGTTATTCTCGGCGCTTGGCCTCGCATGGGGTTTATAGGCCCGTTGCTACCCCTGACTACTGG	CAKDRTRGQDYYDSSGYSRRLASHGVYRPVATPDYW	IGHV3-23	IGHJ4
TGTACTAGAGGGAGCAGCTCGTTACAGCACTTTGACTACTGG	CTRGSSSLQHFDYW	IGHV3-49	IGHJ4
TGTACTAGACGCGGGGGGATTACGATTTTGGGTGCGGGGGCTGACTACTACTACTACTACATGGACGTCTGG	CTRRGGITILGAGADYYYYYMDVW	IGHV3-73	IGHJ6
TGTGCGAGGAGTATAGCAGCTCGTCCCGGTGACTACTGG	CARSIAARPGDYW	IGHV1-3	IGHJ4
TGTCTCGTGGGCCTATTACGATTTTTGGAGTGGAACTCCCGCCGGAACTACTACTACTACTACATGGACGTCTGG	CLVGLLRFLEWNSRRNYYYYYMDVW	IGHV3-30-3	IGHJ6
TGTGCGACCCTATTACGATATTTTGACTGGTTATTATCCCGAGGGACAAAGTACTACTTTGACTACTGG	CATLLRYFDWLLSRGTKYYFDYW	IGHV3-23	IGHJ4
TGTACTAGAGCTCATCTATGGTTCGGGGAGTTATGGATATTTGACTACTGG	CTRAHLWFGELWIFDYW	IGHV3-49	IGHJ4
TGTGCGAGAGGGATCTTGGCCCAACGTATTACTATGGTTCGGGGAGTTACGACAACTAGCCCCTTTCCTTACTACTGG	CARGILAQRITMVRGVTTTSPFPYYW	IGHV3-7	IGHJ4
TGTGCGAGAGATCACCCCGGGCTGGATATTGTAGTGGTGGTAGCTGCTACCACACGGGGGAGGTACAACTGGTTCGACCCCTGG	CARDHPGLDIVVVVAATTRGRYNWFDPW	IGHV3-21	IGHJ5
TGTGCAAGAGATTATAGCAGTGGCTGGTACTTTGACTACTGG	CARDYSSGWYFDYW	IGHV3-74	IGHJ4
TGTGCAAGAATTCCCGATATTGTAGTGGTGGTAGCTGCTACTTTGCACAGTCCATACTACTACTACTACTACATGGACGTCTGG	CARIPDIVVVVAATLHSPYYYYYYMDVW	IGHV6-1	IGHJ6
TGTGCGAGAGACCTCGATTTATTGTCTACGGTGACTACTCGAGTAGCTTTTGATATCTGG	CARDLDLLSTVTTRVAFDIW	IGHV3-30	IGHJ3
TGTGCGAGAAGCGATCGGAACTCCACCTGTTTTCCCTACTTTGACTACTGG	CARSDRNSTCFPYFDYW	IGHV7-4-1	IGHJ4
TGTCCGTACCGGGATTCATATATTATGATTACATTTGGGGGAGTTATCGTTCCACACTACTACTACTACTACATGGACGTCTGG	CPYRDSYIMITFGGVIVPHYYYYYMDVW	IGHV3-30-3	IGHJ6
TGTGCGAGAGCCACGTTGTACGATTTTTGGAGTGGTTATTATGACTACTACTACTACTACATGGACGTCTGG	CARATLYDFWSGYYDYYYYYMDVW	IGHV4-38-2	IGHJ6
TGTGCAAGAGATCATAGCAGTGGCTGGACTTGCCGAACCTACTACTTTGACTACTGG	CARDHSSGWTCRTYYFDYW	IGHV1-45	IGHJ4
TGTGCGAGATGTGTAAGAACTAAGCAGCAGCTGGTACACCCTAATTTTGACTACTGG	CARCVRTKQQLVHPNFDYW	IGHV1-69	IGHJ4
TGTGCACGGATAGACTCTTTCGGGGCCTATATTGTACTGGTGGTGTATGCTATTATCCGGTCGCCACATCTTGACTACTGG	CARIDSFGAYIVLVVYAIIRSPHLDYW	IGHV2-70	IGHJ4
TGTGCGAGGGTTTATAGCAGTGGCTGGTACACCTCGCCGGAGCAAGGCTACTGG	CARVYSSGWYTSPEQGYW	IGHV7-4-1	IGHJ4
TGTGCGAGCGCACCAGCTATCCACCCCCGGGAGATGGCTACAATTAGCGTTGACTACTGG	CASAPAIHPREMATISVDYW	IGHV5-51	IGHJ4
TGTGCGAGAGTAGGAGATATTGTAGTAGTACCAGCTGCTCCGAACTACATGGACGTCTGG	CARVGDIVVVPAAPNYMDVW	IGHV7-4-1	IGHJ6
TGTGCGAGAGATGTCCCGGTGGTAGCTGCTACTCGAGGCTTTGACTACTGG	CARDVPVVAATRGFDYW	IGHV4-59	IGHJ4
TGTGCGAGATGGCATCGATCATCGGTAGGGGCTGCAGTGGCTGGTACACCCTACTGGTTCGACCCCTGG	CARWHRSSVGAAVAGTPYWFDPW	IGHV4-38-2	IGHJ5
TGTGCGAGGATGTCAACCCATTGTGATGCTTTTGATATCTGG	CARMSTHCDAFDIW	IGHV5-51	IGHJ3
TGTGCGAGTCCTGTAGGGGGGAGCTACTTCTTTGACTACTGG	CASPVGGSYFFDYW	IGHV4-34	IGHJ4
TGTGCGAGACAACAGACCATCGAGAGAACTGATATTGTAGTAGTACCAGCTGCTATGTACAACTGGTTCGACCCCTGG	CARQQTIERTDIVVVPAAMYNWFDPW	IGHV1-18	IGHJ5
TGTGCGAGACATGCCGGGGGTGGTGACTGCTCGGGGAGGGAAAACCTTTTTGGGTCTACGTACTTTGACTACTGG	CARHAGGGDCSGRENLFGSTYFDYW	IGHV5-51	IGHJ4
TGTGCGAGAGATAGAGGTGAGAATTACGATTTTTGGAGTGGTTATCACTCGAGTAACTACTACTACTACTACATGGACGTCTGG	CARDRGENYDFWSGYHSSNYYYYYMDVW	IGHV1-46	IGHJ6
TGTGCGAGAGATCCGATAGTGGCTACGATTCTTACCTTTGACTACTGG	CARDPIVATILTFDYW	IGHV3-7	IGHJ4
TGTACCTTGCGTATTACGATTTTTGGAGTGGTCCGGAGGAGCGTTGATGCGCGAAATCGCTACTACTACATGGACGTCTGG	CTLRITIFGVVRRSVDARNRYYYMDVW	IGHV3-15	IGHJ6
TGTGCGAGAGATTCCGGCATTGTAGTAGTACCAGCTGCAGGCTTTGACTACTGG	CARDSGIVVVPAAGFDYW	IGHV1-18	IGHJ4
TGTGCGAGACTCCGTTATGACTACAGTAACTGTGAGTACTACTACTACTACATGGACGTCTGG	CARLRYDYSNCEYYYYYMDVW	IGHV1-2	IGHJ6
TGTGCGAGGATAGGAAAGGGTACGATAGTATTACGATATTTTGACTGGTTATTGTCTGGTTGCTTTGACTACTGG	CARIGKGTIVLRYFDWLLSGCFDYW	IGHV1-2	IGHJ4
TGTGCGAGACCAAATGTAGTTAGTGGTGGTAGCTGCTACTCCGTGACTGAATACTTCCAGCACTGG	CARPNVVSGGSCYSVTEYFQHW	IGHV7-4-1	IGHJ1
TGTGCGAGTGAACAAATTACTATGAGCTTTGACTACTGG	CASEQITMSFDYW	IGHV5-10-1	IGHJ4
TGTGCAAAAGATATGTCACGGTATTACGATTTTTGGAGTGGTTATTATATGTCATTTGACTACTGG	CAKDMSRYYDFWSGYYMSFDYW	IGHV3-43	IGHJ4
TGTACGGCTGCGATTACGATTTTTGGAGTGGTTATTACGGGTCCACGAATTGACTACTGG	CTAAITIFGVVITGPRIDYW	IGHV3-9	IGHJ4
TGTGCGAGACCGGGAGTAGTACCAGCTGCTATTTATTTCTACTACTACTACTACATGGACGTCTGG	CARPGVVPAAIYFYYYYYMDVW	IGHV7-4-1	IGHJ6
TGTGAGGGCCACCTTTATAGCAGTGGCTGGTGTTTAATCGGTTACTACTTTGACTACTGG	CEGHLYSSGWCLIGYYFDYW	IGHV3-30-3	IGHJ4
TGTGCGAGCCCGGACAGGCACGGTGGTGACTGTGATAGGAACTGGTTCGACCCCTGG	CASPDRHGGDCDRNWFDPW	IGHV3-7	IGHJ5
TGTGCGAGAGTCCATGATTTTAGCAGTGGCTGGTACTACAACTGGTTCGACCCCTGG	CARVHDFSSGWYYNWFDPW	IGHV4-34	IGHJ5
TGTGCGAGGAATAGTAGGTATAGCAGTGGCCCGTGGATTGTCAACTGGTTCGACCCCTGG	CARNSRYSSGPWIVNWFDPW	IGHV3-7	IGHJ5
TGTGCGAGAGTTCCCCGGGATATTGTAGTAGTACCAGCTGCTATCGGGAGGTACTACTACTACTACTACATGGACGTCTGG	CARVPRDIVVVPAAIGRYYYYYYMDVW	IGHV3-48	IGHJ6
TGTGCAAGAGATTTACCCCGTATTACTATGATAGTAGTGGAGTTGACGGGTGCCTACTTTGACTACTGG	CARDLPRITMIVVELTGAYFDYW	IGHV3-13	IGHJ4
TGTGCGAGAGATTATTTTGGAGTGGTTATTATGGTTACCCCGCCTAACTGGTTCGACCCCTGG	CARDYFGVVIMVTPPNWFDPW	IGHV4-59	IGHJ5
TGTGCACACAGAGACCAACCTCTACCCAGTGGTGGTAGCTGCTACGACTACTGG	CAHRDQPLPSGGSCYDYW	IGHV2-5	IGHJ4
TGTGCGAGAGAAAGGGGGGAAATTACTATGATAGTAGTGGTTAGTCCCTATGACTACTGG	CARERGEITMIVVVSPYDYW	IGHV3-66	IGHJ4
TGTGCGAGACGCGGGGGAGCCTTAGGAGAACCCCGGCTAAGGGAAGACTACTGG	CARRGGALGEPRLREDYW	IGHV5-51	IGHJ4
TGTGCGAGAGTCTTGACGTATTACTATGATAGTAGTGGTTCACTATACTGG	CARVLTYYYDSSGSLYW	IGHV4-61	IGHJ4
TGTGCGAAAATACTCGGGGAGTCGTGCTTTAATTACAACTGGTTCGACCCCTGG	CAKILGESCFNYNWFDPW	IGHV3-NL1	IGHJ5
TGTGCGAGAAGGGGGGCATACGAAGAGAGTTATTATAGGAAGTACTTTGACTACTGG	CARRGAYEESYYRKYFDYW	IGHV4-38-2	IGHJ4
TGTGAAAACTTTTCGAAGGTACTGCGTATAGCAGTGGCTGCCGTATGG	CENFSKVLRIAVAAVW	IGHV3-30	IGHJ4
TGTGCGAGAGATGGAGGGAACAGCTATGGAATTGACTACTGG	CARDGGNSYGIDYW	IGHV1-46	IGHJ4
TGTGCAAAAGATATGGGTATAGCAGTGGCTGGTACCCCACGCTGGTTCGACCCCTGG	CAKDMGIAVAGTPRWFDPW	IGHV3-43D	IGHJ5
TGTGCGAAAGATCGCCGACCCACTATGGTTCAGGGAGTTATTATCGATACCGCATACAACTGGTTCGACCCCTGG	CAKDRRPTMVQGVIIDTAYNWFDPW	IGHV3-23	IGHJ5
TGTGCGACCAAACCGTATTGTAGTAGTACCAGCTGCTATGGTGGCCCCTGCTACTGG	CATKPYCSSTSCYGGPCYW	IGHV1-69	IGHJ4
TGTGCGAGAGATATTCCACGTAGTGGTGGTAGCTGCTACGGGTCAGACTGGTTCGACCCCTGG	CARDIPRSGGSCYGSDWFDPW	IGHV4-61	IGHJ5
TGTGCGAGAGGCACACGTATTACTATGGGACTCTCCCTATGG	CARGTRITMGLSLW	IGHV4-34	IGHJ4
TGTGCGAGAGTTATAGCAGCAGCGCCCTACTTTGACTACTGG	CARVIAAAPYFDYW	IGHV3-21	IGHJ4
TGTGCACGGATAAGTAAGGTAGTGGTGGTAGCTGCCCAAGAGTCCTTTGACTACTGG	CARISKVVVVAAQESFDYW	IGHV2-26	IGHJ4
TGTGCGAGTCGAGGCGCAGCTATGGTTACATTTTACTGG	CASRGAAMVTFYW	IGHV4-38-2	IGHJ4
TGTGCGAGAGAAGCGGCCATGACTACGGTGACCTGTGACTACTGG	CAREAAMTTVTCDYW	IGHV4-34	IGHJ4
TGTGCGAGAAGGATATTGTACTGGTGGTGTATGTTCTTTGACTACTGG	CARRILYWWCMFFDYW	IGHV7-4-1	IGHJ4
TGTGCGAGTACCGGCGGTGACTACGTATACTGG	CASTGGDYVYW	IGHV3-11	IGHJ4
TGTGCGAGAGAAGGGATTAAACCCATTCTCAACGATTTTTGGAGTGCCTTTAACTGGTTCGACCCCTGG	CAREGIKPILNDFWSAFNWFDPW	IGHV1-69	IGHJ5
TGTGCGAAAGATAAGGCAGTGGCTGGGGTCAACTGGTTCGACCCCTGG	CAKDKAVAGVNWFDPW	IGHV3-23	IGHJ5
TGTGCGAGAGTTGATTCCTATAGCAGCTCGTCGCCCGCCCCCCTTGACTACTGG	CARVDSYSSSSPAPLDYW	IGHV3-30	IGHJ4
TGTGCAAGAAGACCCCACCTATGTGGTAACAGACCTTTACTATGGTTCTGTGTTTACATGGACGTCTGG	CARRPHLCGNRPLLWFCVYMDVW	IGHV3-74	IGHJ6
TGTGCACACACGTCTGGAACCAATCCGAGCTGG	CAHTSGTNPSW	IGHV2-5	IGHJ5
TGTGCGAGAGCTTATGTAGTGGTGGTAGCTGCTACTGGCTGCTTTGACTACTGG	CARAYVVVVAATGCFDYW	IGHV3-30	IGHJ4
TGTGCGAAAGAACCTGATACGATTTTTGGTCGGTGGTTCGACCCCTGG	CAKEPDTIFGRWFDPW	IGHV3-23	IGHJ5
TGTGCGAGAGATCTCTCTCGGTGGGAGCTAAAGGGGACATACTTTGACTACTGG	CARDLSRWELKGTYFDYW	IGHV3-64	IGHJ4
TGTGCGAAAGATGCTTCATTGTACTGGTGGTGTATGCATAGCGACTACTGG	CAKDASLYWWCMHSDYW	IGHV3-23	IGHJ4
TGTGCGAGAGAAAGCAGTGGCTGGTACTTTGCTTTTGATATCTGG	CARESSGWYFAFDIW	IGHV3-7	IGHJ3
TGTGCGACGATCCGTCGACTCGTGATTACATTTGGGGGAGTTATCGTCGGTGGGGTGTACTACTACTACATGGACGTCTGG	CATIRRLVITFGGVIVGGVYYYYMDVW	IGHV1-69	IGHJ6
TGTGCGAGAGCCGGAGGGTATAGCAGCAGCTGGAATTTTATGTGCTACTGG	CARAGGYSSSWNFMCYW	IGHV3-48	IGHJ4
TGTGCGAGAGGCCTTATTGTGGTGGTGATTGCTAGCTTTGACTACTGG	CARGLIVVVIASFDYW	IGHV4-34	IGHJ4
TGTGCGAGGGGCGTATTACTATGGTTCGGGGATTTACCGACGGGAAAGGGTTCCAAACGATTTGACTACTGG	CARGVLLWFGDLPTGKGSKRFDYW	IGHV3-23	IGHJ4
TGTACTAGAGGACTATGGTTCAGGGAGTTATGGACGTACTACTACTACTACTACATGGACGTCTGG	CTRGLWFRELWTYYYYYYMDVW	IGHV3-49	IGHJ6
TGTGCGAGACGAACTGGCGCGGCGGGCCCCGGAAACGCGCCCTCCGATAGCAGTGGCTGCGACCTCCTTGACTACTGG	CARRTGAAGPGNAPSDSSGCDLLDYW	IGHV5-51	IGHJ4
TGTGCGAGACCCCAGGTGGACTTACGATATTTTGACTGGTTACCGGGATGTCGCTTATACTACTTTGACTACTGG	CARPQVDLRYFDWLPGCRLYYFDYW	IGHV5-10-1	IGHJ4
TGTGCGAGACGGCCTTACGGAACCACGGATGCTGGTAGTCTTCACTACTACTACTACATGGACGTCTGG	CARRPYGTTDAGSLHYYYYMDVW	IGHV1-46	IGHJ6
TGTGCGAGAGATGTCTACGGTGACTACGTCTACTGG	CARDVYGDYVYW	IGHV1-18	IGHJ4
TGTGCGAAAGAGCCAGAGGGAGGCCCCAACTACGGTGACTACGGGTACTACTTTGACTACTGG	CAKEPEGGPNYGDYGYYFDYW	IGHV3-NL1	IGHJ4
TGTGCGAGAGATGCATGGTTCGGGGAGTTATTTTTGGCATACTTTGACTACTGG	CARDAWFGELFLAYFDYW	IGHV3-48	IGHJ4
TGTGCAAGTGAGTTCGGGATATTGTACTGGTGGTGTATGCTTCCCCAATACTACTACTACTACTACATGGACGTCTGG	CASEFGILYWWCMLPQYYYYYYMDVW	IGHV3-74	IGHJ6
