TGTGCGAAAGATCAGAGAAAGTGCCTGCTTATCCCGGCTGTAGTGGTGGTAGCTGCTACTCTGCAGCAAGGGGTCCACTTTGACTACTGG	CAKDQRKCLLIPAVVVVAATLQQGVHFDYW	IGHV3-NL1	IGHJ4
TGTGCGAGAATAGGCCAAATAGGATATTGTAGTAGTACCAGCTGCTATGACTATACTGACTACTGG	CARIGQIGYCSSTSCYDYTDYW	IGHV7-4-1	IGHJ4
TGTGCGAGAGACAGCAGCAGCTGGTTCACCGGGGACTTTGACTACTGG	CARDSSSWFTGDFDYW	IGHV4-61	IGHJ4
TGTGCGAGAGATTGGGTTACGATTTTTGGAGTGGTTATTAGCTGTTTGCTACAAAACTGG	CARDWVTIFGVVISCLLQNW	IGHV1-46	IGHJ4
TGTGCGAGAGACAGTTTACGATTTTTGGAGTGGTTATTCGTCTACTACTACTACATGGACGTCTGG	CARDSLRFLEWLFVYYYYMDVW	IGHV1-18	IGHJ6
TGTGCACGGATTCCCGATACTGCTTTTGATATCTGG	CARIPDTAFDIW	IGHV2-26	IGHJ3
TGTGCGAAAAAGACCACGTATTACGATTTTTGGAGTGGTTACAATCAGGTCTACTACTTTGACTACTGG	CAKKTTYYDFWSGYNQVYYFDYW	IGHV3-23	IGHJ4
TGTGCGAGGCTGTCATTAGTGGTGGTAGCTGCCAGCTTCTACTGG	CARLSLVVVAASFYW	IGHV3-7	IGHJ4
TGTGCGAGAGACGGAATCCCGATGACTACGGTGACTACGTATGACTACTACTACTACTACATGGACGTCTGG	CARDGIPMTTVTTYDYYYYYMDVW	IGHV3-20	IGHJ6
TGTGCGAGACCGGATAGCAGTGGCTGTTTTACCTTGAATTCATACTTTGACTACTGG	CARPDSSGCFTLNSYFDYW	IGHV4-38-2	IGHJ4
TGTGCGAGAGATACCGGCAGTGGCTGGTACGCTTTTTGGGTTGACTACTGG	CARDTGSGWYAFWVDYW	IGHV3-20	IGHJ4
TGTGCGAGAGGTCCATTTAGTATAGCTCAACCCGGAAATTCCAACTGGTTCGACCCCTGG	CARGPFSIAQPGNSNWFDPW	IGHV1-2	IGHJ5
TGTGCGAGACGAAAGGGGGGACCGTCTGAAGTTGACTACTGG	CARRKGGPSEVDYW	IGHV7-4-1	IGHJ4
TGTGCGAATATGCCATTAGGATATTGTAGTAGTACCAGCTGCTACCCCGATGCTTTTGATATCTGG	CANMPLGYCSSTSCYPDAFDIW	IGHV3-NL1	IGHJ3
TGTGCAAGAATTTTGGATTGTAGTAGTACGCCCTGG	CARILDCSSTPW	IGHV1-45	IGHJ5
TGTGCGAGACCGCCTATAGCAGTGGCTGGTTACCTTTATGTAACCTTTGACTACTGG	CARPPIAVAGYLYVTFDYW	IGHV3-7	IGHJ4
TGTGCGAGAGATGGTACGCAGGTGGTTATTAACGCACTGTACTACTTTGACTACTGG	CARDGTQVVINALYYFDYW	IGHV3-21	IGHJ4
TGTGCGAGAGCCCCCTACGGTGAGGAGCCCGACTACTGG	CARAPYGEEPDYW	IGHV3-11	IGHJ4
TGTGCGAGAGGGCCCCATATTGTAGTAGTACCAGCTGCCCTGTACGACTACTACTACTACTACATGGACGTCTGG	CARGPHIVVVPAALYDYYYYYMDVW	IGHV1-18	IGHJ6
TGTGCGAGAGATCTCGCGGGCCCTAGTAGTACCAGCTGCTGCCGATTATGCAAAACTGATGCTTTTGATATCTGG	CARDLAGPSSTSCCRLCKTDAFDIW	IGHV3-30	IGHJ3
TGTGCGAGAGATTGCCCTGACTACGGTGACTATTCATATTACTACTACTACTACTACATGGACGTCTGG	CARDCPDYGDYSYYYYYYYMDVW	IGHV1-18	IGHJ6
TGTGCGAGAGATCCGGCTATTGTACTAATGGTGTATGCTATGGGCTGGTACTTCGATCTCTGG	CARDPAIVLMVYAMGWYFDLW	IGHV3-66	IGHJ2
TGTGCGAGAGACGCCCCGTATAGCAGTGGCTGGTACGTAAAAATCTTTGACTACTGG	CARDAPYSSGWYVKIFDYW	IGHV5-10-1	IGHJ4
TGTGCAAGCCCCTTACATTGTAGTGGTGGTAGCTGCTACCTCTACTGG	CASPLHCSGGSCYLYW	IGHV3-74	IGHJ4
TGTGCGAGAGGGAATTGTGGTGGTGACTGCTATTCTTACTTCCAGCACTGG	CARGNCGGDCYSYFQHW	IGHV5-10-1	IGHJ1
TGTGCGAAAGATCCCGATTCTTGGTATGTGGTGGTGACTGCTACCCCTCTAATGTTCTACTGG	CAKDPDSWYVVVTATPLMFYW	IGHV3-23	IGHJ4
TGTGCGAGAGCGTGCAATGGTCAGCTGGTAATTCTTGGCCTCTGCTGG	CARACNGQLVILGLCW	IGHV3-7	IGHJ4
TGTGCGAGAGATATAAACATGCAGTGGGAGCTACTACCATTGGGTATCCCACCCCTACATTTGCGGTTTCGGGGTGACTACTGG	CARDINMQWELLPLGIPPLHLRFRGDYW	IGHV4-59	IGHJ4
TGTGCGAGAGGCTCCTTTATAGCAGTGGCCTTTTACGATAACCCTTGGAACCTTGACTACTGG	CARGSFIAVAFYDNPWNLDYW	IGHV4-34	IGHJ4
TGTGCAAAAGATATTTGTAGTGGTGGTAGCTGCTACTCCCTAAACCACAACTGGTTCGACCCCTGG	CAKDICSGGSCYSLNHNWFDPW	IGHV3-43	IGHJ5
TGTGCGAGAGATGAAGCCCGGATTGTAGTAGTACCAGCTGCTATAAAATGGGGCTCACTTTATGACTACTGG	CARDEARIVVVPAAIKWGSLYDYW	IGHV3-53	IGHJ4
TGTGCAAGAAGTGCTACCGGATGCAACTGGTTCGACCCCTGG	CARSATGCNWFDPW	IGHV3-74	IGHJ5
TGTGCGAGAGATATGGCAAGCCTAGTTGACTACTGG	CARDMASLVDYW	IGHV1-2	IGHJ4
TGTGCGTTGGCTTACAAAGATATTGTAGTGGTGGTAGCTGCTACCTACTACTACTACTACTACATGGACGTCTGG	CALAYKDIVVVVAATYYYYYYMDVW	IGHV3-23	IGHJ6
TGTGCGAGAGATGAGGGTGACTGCAGCTGGTACAGGGCCGGGGTGGGGGACCTCTACTTTGACTACTGG	CARDEGDCSWYRAGVGDLYFDYW	IGHV3-21	IGHJ4
TGTGTTCGTGTGTATAGTGGCTACGACCCCTCGTTTGACTACTGG	CVRVYSGYDPSFDYW	IGHV3-30-3	IGHJ4
TGTGCGAGAGCTTATGTAGCAGCAGCTCAGGGGAAGGACTACTGG	CARAYVAAAQGKDYW	IGHV1-3	IGHJ4
TGTGCGAGAGATGAGGAACCTTTTTCCAATTGTAGTAGTACCAGCTGCTATAAGGAGCCGGGGTCCATTTTGTTTGACTACTGG	CARDEEPFSNCSSTSCYKEPGSILFDYW	IGHV1-46	IGHJ4
TGTGCGAGAGACCACGAAATCGGCGCTCTACGATTTTTGGAGTGGTTATTATCTAACTGGTTCGACCCCTGG	CARDHEIGALRFLEWLLSNWFDPW	IGHV4-59	IGHJ5
TGTGCGAGTACCGCTTTTGTCTGGTTTTTTGAATATTGTGGTGGTGACTGCTATTGCGCCATTGACTACTGG	CASTAFVWFFEYCGGDCYCAIDYW	IGHV4-61	IGHJ4
TGTGCGAGAGTCTTCGGAGATATAGTGGCTACGATTGGCCGGCTCCCGGACTACTGG	CARVFGDIVATIGRLPDYW	IGHV7-4-1	IGHJ4
TGTGCGAAAGATAAGGAGACTTTAAAGGTTTCGGGGAGTTATTATAACCTCCCAGACTACTGG	CAKDKETLKVSGSYYNLPDYW	IGHV3-NL1	IGHJ4
TGTGCGAGGCCATCAGAGGGTCCAATTTGTAGTGGTGGTAGCTGCTTTCGCTACTGG	CARPSEGPICSGGSCFRYW	IGHV3-66	IGHJ4
TGTGCGAGAGCAATATGGAGTAGTGGTTATTGCGGACTCCTGAAGTACTACTTTGACTACTGG	CARAIWSSGYCGLLKYYFDYW	IGHV4-4	IGHJ4
TGTGCGAGACATCTGCCGGGGCACTTTGTGCGTGTGCTTCTTTCTATAGTGGGTCAGGGCCAGTTTGACTACTGG	CARHLPGHFVRVLLSIVGQGQFDYW	IGHV4-39	IGHJ4
TGTGCGAGACTGCATAGCAGTGGCTGGTACCCGGACTACTGG	CARLHSSGWYPDYW	IGHV4-59	IGHJ4
TGTGCGAGAAATGGTTATCGTTTGGCCTACTACTTTGACTACTGG	CARNGYRLAYYFDYW	IGHV3-53	IGHJ4
TGTGCGAGAGATATTGTCGAGGAACGGATATTTTTGGAGTGGTTATTCACCTACTACTACTACTACATGGACGTCTGG	CARDIVEERIFLEWLFTYYYYYMDVW	IGHV3-21	IGHJ6
TGTGCGAAAAGGGGGGGCCAGCAGCTCGTCCCGGAAGGGGGGGGCCGCTACTACATGGACGTCTGG	CAKRGGQQLVPEGGGRYYMDVW	IGHV3-23	IGHJ6
TGTCTTGTCCCCAGGAGCAGCAGCTGGACCTCACGAGGATGGTTCGACCCCTGG	CLVPRSSSWTSRGWFDPW	IGHV1-69	IGHJ5
TGTGCGAAAGATCATCTACCTGGGTATAGCAGTGGCTGGTGGGCCCGCGGGATCTACTACTTTGACTACTGG	CAKDHLPGYSSGWWARGIYYFDYW	IGHV3-23	IGHJ4
TGTGCGAGACCTACTAGGGCCCTGGACGGGAGGGCCCCTGTTTCTGGGGAGGTCGATTTTTGGAGTGGTTATCCCCCTCGGGTACACTACTACTACTACATGGACGTCTGG	CARPTRALDGRAPVSGEVDFWSGYPPRVHYYYYMDVW	IGHV5-51	IGHJ6
TGTGCGAGAGATAAATCCCCGGCACCATCTATTGTAGTAGTACCAGCTGCTACGACGAAACATGACTACTACTACTACTACATGGACGTCTGG	CARDKSPAPSIVVVPAATTKHDYYYYYMDVW	IGHV3-7	IGHJ6
TGTGCGAAAGATCGGCCAAATGGCTACGAGAACCTCTTGGGGTACTACTTTGACTACTGG	CAKDRPNGYENLLGYYFDYW	IGHV3-NL1	IGHJ4
TGTGCGAGAGATATCCTAGTGGTGGTAGCTGCAGTGGTTGGCTTTGACTACTGG	CARDILVVVAAVVGFDYW	IGHV3-7	IGHJ4
TGTGCGAGACTCCCCGACGCCATAGAGATGGCTACAATTAACGACGGCACGGAATACTACTTTGACTACTGG	CARLPDAIEMATINDGTEYYFDYW	IGHV4-4	IGHJ4
TGTGCGAAATACCGTGCAGTGGCTGGTACTGGGGTGAGACTTGACTACTGG	CAKYRAVAGTGVRLDYW	IGHV3-23	IGHJ4
TGTGCGAAAGTAGGATATTGTAGTAGTACCACCCACTACATGGACGTCTGG	CAKVGYCSSTTHYMDVW	IGHV3-NL1	IGHJ6
TGTGCGAGAGATAGCAGCAGGGGGTACCAGAAAGGGCGTATTACTATGATAACCGTTGACTACTGG	CARDSSRGYQKGRITMITVDYW	IGHV3-53	IGHJ4
TGTGCGAAAGATGGACCGTTACGATTGTCGGTCCTGGGGAACCCTCCCCCCAATGGCCATGACTACTACATGGACGTCTGG	CAKDGPLRLSVLGNPPPNGHDYYMDVW	IGHV3-NL1	IGHJ6
TGTGCAAGAGCGATTATATATTGTAGTAGTACCAGCTGCCCTTACTACTACTACTACATGGACGTCTGG	CARAIIYCSSTSCPYYYYYMDVW	IGHV3-13	IGHJ6
TGTGCGAGAGATCTCTTTAGAAATTCTTTGGACTATGGTTCAGGGAGTTATTATAACGCCGGAAACTGGTTCGACCCCTGG	CARDLFRNSLDYGSGSYYNAGNWFDPW	IGHV4-59	IGHJ5
TGTGCGAGATCTATAGTGGCTACGTATGTTCTTCTTGACTACTGG	CARSIVATYVLLDYW	IGHV5-10-1	IGHJ4
TGTGAGACCCGTTACTATGGTTCGGGGTTCCCGTGCTGGTTCGACCCCTGG	CETRYYGSGFPCWFDPW	IGHV1-3	IGHJ5
TGTGCGAAAGAGAAATACTATGATAGTAGTGGTTATTATTGCCGCCCGTACCTATGGGTTGACTACTGG	CAKEKYYDSSGYYCRPYLWVDYW	IGHV3-NL1	IGHJ4
TGTGCAAAAGACTGGGGGTATTGTAGTAGTACCAGCTGCTATACTAACTACTACTACTACTACATGGACGTCTGG	CAKDWGYCSSTSCYTNYYYYYMDVW	IGHV3-43	IGHJ6
TGTGCACGGATACGACCCAGGGCGTTCCCCTGCTGTGTATACCGAGTTGATGCTTTTGATATCTGG	CARIRPRAFPCCVYRVDAFDIW	IGHV2-26	IGHJ3
TGTGCGAGAACACCGGATTACGATATTTTGACTGGTTATTATAACGTTACTTTTGAGGACTACTACTACTACTACATGGACGTCTGG	CARTPDYDILTGYYNVTFEDYYYYYMDVW	IGHV7-4-1	IGHJ6
TGTGCGAGAGATACTATTGTACTAATGGTGTATGCTCTTTGTTGGACGTACTACTTTGACTACTGG	CARDTIVLMVYALCWTYYFDYW	IGHV3-21	IGHJ4
TGTGCGAGACATCAATCGACAGTGGTGGTAGCTGCTACTCCGGAGTACCTAGGGTTTGACTACTGG	CARHQSTVVVAATPEYLGFDYW	IGHV4-39	IGHJ4
TGTGCAAGAGAACGTATTACTATGATAGTAGTGGTTATACGATACTACTACTACTACATGGACGTCTGG	CARERITMIVVVIRYYYYYMDVW	IGHV3-13	IGHJ6
TGTGCGAAGGTTGTGAGTGATGCTTTTGATATCTGG	CAKVVSDAFDIW	IGHV3-NL1	IGHJ3
TGTGCGAGAGTCACAAGTAGTACCAGCTGCTATGGCTGGGGGATTATATACTACTACTACTACTACATGGACGTCTGG	CARVTSSTSCYGWGIIYYYYYYMDVW	IGHV4-61	IGHJ6
TGTGCTAGAGATGTGAACAGGTGTCCGGTGGGTGGTAGCTGCTACGAGTACTACTTTGACTACTGG	CARDVNRCPVGGSCYEYYFDYW	IGHV3-72	IGHJ4
TGTACCACCAGTAACGTGGAACTGGAACTACCGACGCCGTTTGACTACTGG	CTTSNVELELPTPFDYW	IGHV3-15	IGHJ4
TGTGCGAGAGTCATTCCCAATATTGTAGTAGTACCAGCTGCTATGGGTCCCGGGCATTACTACTACTACTACTACATGGACGTCTGG	CARVIPNIVVVPAAMGPGHYYYYYYMDVW	IGHV4-61	IGHJ6
TGTGCGAAAGAAAAGTGTATAGCAGTGGCCTACTGG	CAKEKCIAVAYW	IGHV3-23	IGHJ4
TGTGCGAGAGATGTCAAGCAGCTCGTTGTGCCTATGGACTACTGG	CARDVKQLVVPMDYW	IGHV3-11	IGHJ4
TGTGCGAGAGGCGATATTGTAGTGGTGGTAGCTGCTACTCCGGATGTGGGTGATGCTTTTGATATCTGG	CARGDIVVVVAATPDVGDAFDIW	IGHV4-34	IGHJ3
TGTGCGAACGTTGTTAAGGGACCCGTATTACGATATTTTGACTGGTTATTCGACATCGACCCCTGG	CANVVKGPVLRYFDWLFDIDPW	IGHV3-23	IGHJ5
TGTGCGAGGGAGAGATGGCAGCAGTGGCTGGATGGTGACTACTGG	CARERWQQWLDGDYW	IGHV4-59	IGHJ4
TGTGCGAAAAATCCCGTGGATATTGTAGTGGTGGTAGCTGCTACTAGTCGGGGTGATGCTTTTGATATCTGG	CAKNPVDIVVVVAATSRGDAFDIW	IGHV3-23	IGHJ3
TGTACATATAGCAGTGGCTGGTACTTTCATTTAAGCTGCTACTGG	CTYSSGWYFHLSCYW	IGHV3-49	IGHJ4
TGTGCGAGAGCGAGACGGGATTGGGATATTGTACTGGTGGTGTATGCTATAGACCCCGTTCTCCGTTTGTTCGACCCCTGG	CARARRDWDIVLVVYAIDPVLRLFDPW	IGHV3-21	IGHJ5
TGTGCGAGAGGGCTGCGGCACTACTTTGACTACTGG	CARGLRHYFDYW	IGHV4-38-2	IGHJ4
TGTGCCCGACCTCACCCATATTGTAGTGGTGGTAGCTGCTATTGTGGGAATAGATTGGAGGGCCGCAACTGGTTCGACCCCTGG	CARPHPYCSGGSCYCGNRLEGRNWFDPW	IGHV1-45	IGHJ5
TGTACCACGGGATACGGTGATGAGGTTGACTACTGG	CTTGYGDEVDYW	IGHV3-15	IGHJ4
TGTGCGAGATATCGGCAGGCCGATGGTTCAGGGAGTTATTTATGTTTGGCTAGAGGTCTCCTCTACTACTACTACATGGACGTCTGG	CARYRQADGSGSYLCLARGLLYYYYMDVW	IGHV7-4-1	IGHJ6
TGTGCGAGGTTTACAATATTGTACTGGTGGTGTATGCTATACCGGGCCGACTACTACTACATGGACGTCTGG	CARFTILYWWCMLYRADYYYMDVW	IGHV4-39	IGHJ6
TGTGCGAGAGATGAAGTATTACTATGGTTCAGGGACGTGGAAAACTGGTTCGACCCCTGG	CARDEVLLWFRDVENWFDPW	IGHV3-21	IGHJ5
TGTGCGAGAGATGGCGCCGGGTGCAGCAGCTGGCACACCGACTACTGG	CARDGAGCSSWHTDYW	IGHV4-4	IGHJ4
TGTGCAAGAGATCAAACTGCCTGGTCTGGACGGGACTACTACTACTACATGGACGTCTGG	CARDQTAWSGRDYYYYMDVW	IGHV3-13	IGHJ6
TGTGCAACAGAGAACCGATTTTTGGAGTGGTTATTATCCAGGAACTGGTTCGACCCCTGG	CATENRFLEWLLSRNWFDPW	IGHV1-69-2	IGHJ5
TGTCGAAAGCAGTGGCTGGTACCCCATGATGCTTTTGATATCTGG	CRKQWLVPHDAFDIW	IGHV3-30-3	IGHJ3
TGTGCGAAAGATACTCATGGACGTATTACGATTTTTGGAGTGGTTATAGACTACTACTACTACTACATGGACGTCTGG	CAKDTHGRITIFGVVIDYYYYYMDVW	IGHV3-NL1	IGHJ6
TGTGCACGGATACGTATTACTATGATAGTAGTGGTTATTGGAATCGTTGACTACTGG	CARIRITMIVVVIGIVDYW	IGHV2-70	IGHJ4
TGTGCGAGAGATGGTTTACCGATGATTAACGCACTCGGGTATCAATACTACTACTACTACATGGACGTCTGG	CARDGLPMINALGYQYYYYYMDVW	IGHV3-66	IGHJ6
TGTGCGAGAGATCATACTATGATAGTAGTGGTTATTATAATTACCGACTACTTTGACTACTGG	CARDHTMIVVVIIITDYFDYW	IGHV3-7	IGHJ4
TGTGCACGGATGGATAGCAGCTCGTCGTGTATCAGGGGATTTGACTACTGG	CARMDSSSSCIRGFDYW	IGHV2-70	IGHJ4
TGTGCGAGAATGGAACCATTGGTTGTAGTGGTGGTAGCTGCTACTCCGCAACCGGCCCTTGAAACCCGACGGGTTTGGGCGCACGACTACTACTACTACTACATGGACGTCTGG	CARMEPLVVVVVAATPQPALETRRVWAHDYYYYYMDVW	IGHV4-4	IGHJ6
