TGTGCGAGACACCTTATTACTATGGTTCGGGGAGTTATTAGGGTGGATTACTTTGACTACTGG	CARHLITMVRGVIRVDYFDYW	IGHV1-2	IGHJ4
TGTACTCCCTATTCAGGTGTCCGGGTGGTGCTCGATGGTTCAGGGAGTTATTATGGGTATACGTACTACTACTACATGGACGTCTGG	CTPYSGVRVVLDGSGSYYGYTYYYYMDVW	IGHV3-9	IGHJ6
TGTGCGAGAGATCCGGTGAGATCGTGGTTCGACCCCTGG	CARDPVRSWFDPW	IGHV3-21	IGHJ5
TGTGCGAGAGATGGGAGTAAGACTCTTTTGGAGCAAGCATTACCTTACTACTACTACATGGACGTCTGG	CARDGSKTLLEQALPYYYYMDVW	IGHV3-30	IGHJ6
TGTGCGAGAGGGGACCAATGTCGGGATATTGTAGTGGTGGTAGCTGCTACGAAAGACTACTACTACTACTACATGGACGTCTGG	CARGDQCRDIVVVVAATKDYYYYYMDVW	IGHV5-10-1	IGHJ6
TGTGCGAGAGAGTATAGTCCTCGGCGGGCTGGGGTGGTGGTGATTGCTATACAACGGGAACCTGGCTTTGACTACTGG	CAREYSPRRAGVVVIAIQREPGFDYW	IGHV3-53	IGHJ4
TGTGCGAGACTCTCCGCTTGCCTGGAGGTCGGAAACTACTACTACTACATGGACGTCTGG	CARLSACLEVGNYYYYMDVW	IGHV5-51	IGHJ6
TGTGCGAGAGACTCGCGTTACGTGGATACAGCTATGGTTAGGATCATCCATGACTACTGG	CARDSRYVDTAMVRIIHDYW	IGHV4-34	IGHJ4
TGTGCAAGAGATCTATTCCCCCTTTTTGACTACTGG	CARDLFPLFDYW	IGHV3-13	IGHJ4
TGTGCGAGAGATGACCCAACGCTTACGGTGACTACTGGGACGTACTACTACTACTACTACATGGACGTCTGG	CARDDPTLTVTTGTYYYYYYMDVW	IGHV3-7	IGHJ6
TGTGCGAAAGCAAGTATTACTATGATAGTAGTGGTTATTTCCTGCTTTGACTACTGG	CAKASITMIVVVISCFDYW	IGHV3-23	IGHJ4
TGTGCGAGTCTAGGATATTGTAGTGGTGGTAGCTGCTACAGATGTGATTGCCCAAGGATCTCCTGCTGG	CASLGYCSGGSCYRCDCPRISCW	IGHV1-3	IGHJ4
TGTGCGAGAGCCCCCCGGTGTATAGCAGTGGCGTGGGCGGCCCCCCCGCACGGACCCGGGGACTACTGG	CARAPRCIAVAWAAPPHGPGDYW	IGHV3-20	IGHJ4
TGTGCGAGCTCCAGCTTTGACTACTGG	CASSSFDYW	IGHV4-4	IGHJ4
TGTGCGAGAGCTTGTATTACTATGATAGTAGTGGTTGGTGACTACTGG	CARACITMIVVVGDYW	IGHV5-10-1	IGHJ4
TGTGCGAGAGTTTTTACGTTTGGGGGAGTTATCGTGGAACCCGATGTCGATGCTTTTGATATCTGG	CARVFTFGGVIVEPDVDAFDIW	IGHV3-11	IGHJ3
TGTGCGACGTATTACGATTTTTGGAGTGGTTATTATACCAATCGTGCGTGCTACTGG	CATYYDFWSGYYTNRACYW	IGHV3-23	IGHJ4
TGTGCAAGAGATGTGTCTAGAGACGAACGATTTTTGGAGTGGGACAACTTTGACTACTGG	CARDVSRDERFLEWDNFDYW	IGHV6-1	IGHJ4
TGTGCGAGAGACCCCCCGTCCGAGTGGCTGGTATGCGCTGAATACTTCCAGCACTGG	CARDPPSEWLVCAEYFQHW	IGHV3-7	IGHJ1
TGTGCGAGGATTCGGGGAGGCTTACGGCAACCGGGCCGGAGATCCGCCTACTACTTTGACTACTGG	CARIRGGLRQPGRRSAYYFDYW	IGHV1-2	IGHJ4
TGTGCGAGACCCACCGGAAACCCGCATAGCAGTGGCTGGTACAACGCCTTCCTCCAGGCCTACTGG	CARPTGNPHSSGWYNAFLQAYW	IGHV3-7	IGHJ4
TGTGCGAACCCTAGCAGTGGCTGGGGACCTTACTGG	CANPSSGWGPYW	IGHV3-23	IGHJ4
TGTGCGAGAGATCGGGATTCAGTAACTACCGACCCCTGG	CARDRDSVTTDPW	IGHV3-53	IGHJ5
TGTGCGAGAGCCCTTTTGGTCGCCGCTGGGAACCTTGACTACTGG	CARALLVAAGNLDYW	IGHV7-4-1	IGHJ4
TGTGCGAAAGGTAACCTCTCTGCGCCTCATGCGGGTGGGAGGTCCAGCCAGTACTGG	CAKGNLSAPHAGGRSSQYW	IGHV3-NL1	IGHJ4
TGTGCGAAAGATAAGGACACTGATAGCAGTGGCTGGTACAGCATTGACTACTGG	CAKDKDTDSSGWYSIDYW	IGHV3-23	IGHJ4
TGTGCGAGAGGCTGTCGGCCTCCCTTAAGGATGGCTACAAACTGCCCGGTGCTTCCTACCTACTGG	CARGCRPPLRMATNCPVLPTYW	IGHV4-34	IGHJ4
TGTGCGAAAGGTAGGCGGCCATTTGGAGTGGTTATAAATGACTACTGG	CAKGRRPFGVVINDYW	IGHV3-NL1	IGHJ4
TGTATAGGCCTCATTCCTAAAACAATCGAGTATAGCAGCAGCTGGTACTCATATCCCTGGTTCGACCCCTGG	CIGLIPKTIEYSSSWYSYPWFDPW	IGHV1-46	IGHJ5
TGTGCGAGAAACCGTGTAAGGACTCTCGCCGGCTTTGACTACTGG	CARNRVRTLAGFDYW	IGHV5-10-1	IGHJ4
TGTGCGAGAGTGTCGCGTCCCTACTACTACTACTACATGGACGTCTGG	CARVSRPYYYYYMDVW	IGHV1-2	IGHJ6
TGTGCAAGAGGACCTTACGCAGCAGCTGGTACGAGGGTCGACCCCTGG	CARGPYAAAGTRVDPW	IGHV3-74	IGHJ5
TGTGCGACGGTCAGTTGGATGGACAACTACTACTACTACTACATGGACGTCTGG	CATVSWMDNYYYYYMDVW	IGHV3-21	IGHJ6
TGTGCGAGATGCCACCTAGCCACCCTGTATAGCAGCAGCTGGTACGGGGAATGG	CARCHLATLYSSSWYGEW	IGHV1-2	IGHJ5
TGTGCGAGAGATATTGATGGGCTACTAGTAGTGGGGTACTGG	CARDIDGLLVVGYW	IGHV1-69	IGHJ4
TGTGCCCAAGTGGTGGTAGCTGCTAGACCAACGGGCCGGAGTACCTTTGACTACTGG	CAQVVVAARPTGRSTFDYW	IGHV3-30-3	IGHJ4
TGTGCGAGAGAGAGGGGACCGTACGGGTACCAGCTGTCATACTACTACTACATGGACGTCTGG	CARERGPYGYQLSYYYYMDVW	IGHV1-69	IGHJ6
TGTGCGAGAGATCCGGTGATTGTAGTAGTACCAGCTGCCTTACCTCGTTACTACTACTACTACTACATGGACGTCTGG	CARDPVIVVVPAALPRYYYYYYMDVW	IGHV3-30	IGHJ6
TGCCCCCCACCAGTTGATTGTAGTAGTACCAGCTGCTCTGACTACTGG	CPPPVDCSSTSCSDYW	IGHV4-34	IGHJ4
TGTGCGAGCGGGGGTCATTTCTATAGCTATAGCAGCTCGCCCTGGTTCGACCCCTGG	CASGGHFYSYSSSPWFDPW	IGHV1-69	IGHJ5
TGTGCGAGTGGTGGGGGTATTATGATTACATTTGGGGTCTTTACGCACTACTGG	CASGGGIMITFGVFTHYW	IGHV5-10-1	IGHJ4
TGTGCACACACTAAGACGTGGTTGATAGTAGTGGTTATTACCGCGACGAGGGAATACTTCCAGCACTGG	CAHTKTWLIVVVITATREYFQHW	IGHV2-5	IGHJ1
TGTGCGAGAGCCCCAACGTCTTTTGATATTGTAGTAGTACCAGCTGCTATGTCCTACTACTACTACATGGACGTCTGG	CARAPTSFDIVVVPAAMSYYYYMDVW	IGHV4-4	IGHJ6
TGTGCGAGAGACTGCACTTACGATATTTTGACTGGTTATTATTATGCTTACTACTACTACTACTACATGGACGTCTGG	CARDCTYDILTGYYYAYYYYYYMDVW	IGHV1-46	IGHJ6
TGTGCACGGCCGATTGTAGTGGTGGTAGCTGGCCATATATCCCACTGGTACTTCGATCTCTGG	CARPIVVVVAGHISHWYFDLW	IGHV2-26	IGHJ2
TGTGCGAAAGACCCGCACCCTATAGCAGTGGCTGGCAGCCCGCGCCAACACAACTTTGACTACTGG	CAKDPHPIAVAGSPRQHNFDYW	IGHV3-NL1	IGHJ4
TGTGCGAGAAAGCTAATTTGTGGTGGTGACTGCTATTTTGACTACTGG	CARKLICGGDCYFDYW	IGHV5-10-1	IGHJ4
TGTGCGAAAGATGGATCGAGGCTTTCTTTTGACTACTGG	CAKDGSRLSFDYW	IGHV3-23	IGHJ4
TGTGCGAGACAGGCTACATCTTCCCCGACCTGGGCTACGGTGACTGGATGGAATTATCAAAAAGTGGGGGGTGAGGTTGACTACTGG	CARQATSSPTWATVTGWNYQKVGGEVDYW	IGHV5-51	IGHJ4
TGTGCGAAAGAAGGGGAAATTGTAGTGGTGGTAGCTGCACTAGGCAAGACCGACAAGACCATTAGTTGGAGATGGTTGAACATCTACTTTGACTACTGG	CAKEGEIVVVVAALGKTDKTISWRWLNIYFDYW	IGHV3-23	IGHJ4
TGTGCGAGAGATCCTGAGGTAGGAGAATACTTTGACTACTGG	CARDPEVGEYFDYW	IGHV1-2	IGHJ4
TGTGCTGTAGTACCAGCTGCTATATGTGACTACTGG	CAVVPAAICDYW	IGHV4-34	IGHJ4
TGTGCTCGGGGGGGGTCGCGCTATAGCAGTGGCGTCAACTGGTTCGACCCCTGG	CARGGSRYSSGVNWFDPW	IGHV2-70	IGHJ5
TGTGCACGGATCGTCCGGGCCGAGTCGGGGAATCTTGACTACTGG	CARIVRAESGNLDYW	IGHV2-70	IGHJ4
TGTGCGAGAAGTTCCCATAGCAGCAGCTGGGGAAACGATCGTGCCGATGACTACTGG	CARSSHSSSWGNDRADDYW	IGHV3-11	IGHJ4
TGTGCGAGAGATCTCCCTGTAGTAGTACCAGCTGCTATAGTGAGGGGGGTAGAGTGG	CARDLPVVVPAAIVRGVEW	IGHV3-11	IGHJ4
TGTGCGAGAGAAATGGGCGCGTGCCGGTATTACGATTTTTGGAGTGGTTATTATAGCGTGGGAGGTCGAAGTCTCAACTTTGACTACTGG	CAREMGACRYYDFWSGYYSVGGRSLNFDYW	IGHV1-2	IGHJ4
TGTGCGAGACATGTCGCAGCAGCTGGTACCCCTACTTGTGCTTTTGATATCTGG	CARHVAAAGTPTCAFDIW	IGHV4-39	IGHJ3
TGTGCGACCAGTATAGCAGTGGCTGGTACCCTGGGGGGCTTCCTTGACTACTGG	CATSIAVAGTLGGFLDYW	IGHV1-46	IGHJ4
TGTGCGAAAGGGCCCTTTACGATTTTTGGAGTGGTTATAGACCCCGTTGACTACTGG	CAKGPFTIFGVVIDPVDYW	IGHV3-NL1	IGHJ4
TGTGCGAGAGTATTGGGGGGTAATGGACCTCGACGAACGGGCCCGTGGGGGGCAGCAGCGATGGCTTACTGG	CARVLGGNGPRRTGPWGAAAMAYW	IGHV1-69	IGHJ4
TGTGCGAAAGGGGTGGTTCCAGACTACTGG	CAKGVVPDYW	IGHV3-NL1	IGHJ4
TGTGCGAGGGGGTTCCCAAGTAGCAGCTCGTCCGCTGGGGGAGACTTTGACTACTGG	CARGFPSSSSSAGGDFDYW	IGHV5-51	IGHJ4
TGTGCGAGGGGAGGGATGGATTACTATGATAGTAGTGGTTATTACGGGGACTACTGG	CARGGMDYYDSSGYYGDYW	IGHV3-48	IGHJ4
TGTGCAAGAAACCTGGTGTACAGCTATATAATTGACTACTGG	CARNLVYSYIIDYW	IGHV6-1	IGHJ4
TGTGCGAGAGGTGAAGTAGTGGCTGGCCCCAACAACTCTTTCTGGTTCGACCCCTGG	CARGEVVAGPNNSFWFDPW	IGHV3-53	IGHJ5
TGTGCGAGACCAACTACATTATGTTCGGGGCAAAGTAACCTAAATTTTGACTACTGG	CARPTTLCSGQSNLNFDYW	IGHV4-39	IGHJ4
TGTGCGAGTGTACCAGCTGCTATGTGTTACTTTGACTACTGG	CASVPAAMCYFDYW	IGHV3-48	IGHJ4
TGTGCAAGAGAACAAGTTGCAGTGGCTGGGGCGTGCCGTGACTACTGG	CAREQVAVAGACRDYW	IGHV1-45	IGHJ4
TGTGCGAGAAGCTGTATAACTGGAACTACACGACTCGCAAAAAAATACTACTACTACTACATGGACGTCTGG	CARSCITGTTRLAKKYYYYYMDVW	IGHV1-69	IGHJ6
TGTGCGAGAGGACGTACTGGTGGTGTATGCTATCCAATTGACTACTGG	CARGRTGGVCYPIDYW	IGHV1-3	IGHJ4
TGTGCGAAAGATCCAACTTCCGACTACAGCTGTCGCTCAGGGTCCGTCGGATGTGACTACTGG	CAKDPTSDYSCRSGSVGCDYW	IGHV3-NL1	IGHJ4
TGTGCGAGAGGTGGGTATAGCAGTGGCTGGTACGAGGGCCGCGGAGGGGCCAACTACTGG	CARGGYSSGWYEGRGGANYW	IGHV4-39	IGHJ4
TGTACCACAGTCGAATTTATTATGATTACATTTGGGGGAGTTATCGGACTGGTGATAAGTCGCGGCACCCGGAAGCGTTACTACTACTACTACTACATGGACGTCTGG	CTTVEFIMITFGGVIGLVISRGTRKRYYYYYYMDVW	IGHV3-15	IGHJ6
TGTGCGACCGAAGCGGGATATTGTAGTGGTGGTAGCTGCTACTCCGGCACCGGAGGGTCCGTGGTCGTGTACTACTTTGACTACTGG	CATEAGYCSGGSCYSGTGGSVVVYYFDYW	IGHV3-NL1	IGHJ4
TGTGCGGGGGCTGCAGTGGCATTGGATGATGCTTTTGATATCTGG	CAGAAVALDDAFDIW	IGHV3-53	IGHJ3
TGTGCGAGAGATGCGAACGATATTGTAGTAGTACCAGCTGCTTGGGGCTGGTTCGACCCCTGG	CARDANDIVVVPAAWGWFDPW	IGHV4-4	IGHJ5
TGTGCGAAAGATATTAAGTCTCCTGCTATAATGGAAGTCAGGATACAGCTATGGGGGTATTCGTGGTTCGACCCCTGG	CAKDIKSPAIMEVRIQLWGYSWFDPW	IGHV3-NL1	IGHJ5
TGTGGCCCCGACCATAGCATAGTGGTGGTAGCTGCTACTGACGACCCTTACTACTACTACTACTACATGGACGTCTGG	CGPDHSIVVVAATDDPYYYYYYMDVW	IGHV3-11	IGHJ6
TGTGCGAGAGATCGCGGTATTACTATGATAGTAGTGGTTATTACTGAAAAGGCGGGGTCCCCACGTTTCCCTCGGAACTGGTTCGACCCCTGG	CARDRGITMIVVVITEKAGSPRFPRNWFDPW	IGHV3-7	IGHJ5
TGTGCGAAATTCGTTTTTCGAGTGGTTACTATGATAGTAGTGGTTATGCCCGTTGACTACTGG	CAKFVFRVVTMIVVVMPVDYW	IGHV3-NL1	IGHJ4
TGTGCGAGAGGTCGTATGGCGGTATTACGATTTTTGGAGTGGTTATTATACTACTGG	CARGRMAVLRFLEWLLYYW	IGHV3-11	IGHJ4
TGTGCGAGAGTACCCTATATAGCAGCAGCTGGTACAACCGAGGCGTTTGACTACTGG	CARVPYIAAAGTTEAFDYW	IGHV4-34	IGHJ4
TGTGCGAGAGTGCGGGCCCGGACATATGATTACATTTGGGGGAGAAAACGGGCGGGGGGCTGGGTTCCCATTGATCGAAAAGGGAACCCCAGGGCCCTTGACTACTGG	CARVRARTYDYIWGRKRAGGWVPIDRKGNPRALDYW	IGHV3-7	IGHJ4
TGTGCGAGAGCTCATAAGTTTTCAGCTTTTTCATATTGTAGTAGTACCAGCTGCTATGCCGGCATACTCAGGCGGCAGATATGTTGG	CARAHKFSAFSYCSSTSCYAGILRRQICW	IGHV4-59	IGHJ4
TGTACGAATATTGTAGTGGTGGTAGCTGCTAAAGTCAATGATGCTTTTGATATCTGG	CTNIVVVVAAKVNDAFDIW	IGHV3-30-3	IGHJ3
TGTGCGAAACATTGCGAGGTCGGACTACGGTGCTTTTCGTTCGACTTTGACTACTGG	CAKHCEVGLRCFSFDFDYW	IGHV3-NL1	IGHJ4
TGTACACCTTCGGGTATAGCAGCAGCTGGTGGACACTACTACATGGACGTCTGG	CTPSGIAAAGGHYYMDVW	IGHV3-9	IGHJ6
TGTGCGAAAGATTCGGGCGGGTTACGATTTTTGGAGTGGTTATTCCATTACTGGTTCGACCCCTGG	CAKDSGGLRFLEWLFHYWFDPW	IGHV3-NL1	IGHJ5
TGTACTAGACCCACACGTATTATGATTACATTTGGGGGAGTTATCGAGACCCCAGGGGAGTGGGAACACTGGTTCGACCCCTGG	CTRPTRIMITFGGVIETPGEWEHWFDPW	IGHV3-73	IGHJ5
TGTGCGAGAGATAGGGAATCGGATATTGTAGTAGTACCAGCCTACTACTACTACTACATGGACGTCTGG	CARDRESDIVVVPAYYYYYMDVW	IGHV3-11	IGHJ6
TGTGCACGGACCGGGTCTGGCACCTATTACGATTTTTGGAGTGGTTATTCCGCTTACTACTACTACTACATGGACGTCTGG	CARTGSGTYYDFWSGYSAYYYYYMDVW	IGHV2-26	IGHJ6
TGTGGGTTGGGGGGACGGGCGTATTACGATTTTTGGAGTGGTTATTGGGCTGTCGGATACTACTACTACTACATGGACGTCTGG	CGLGGRAYYDFWSGYWAVGYYYYYMDVW	IGHV1-69	IGHJ6
TGTACTAGACTGGACACGACTGGTTATTATATTGTACCCGATATCTACTACTACATGGACGTCTGG	CTRLDTTGYYIVPDIYYYMDVW	IGHV3-73	IGHJ6
TGTGCGACGCCGCCCCATGTTAGCTGCTACTTGTCATATTACTACTACTACTACTACATGGACGTCTGG	CATPPHVSCYLSYYYYYYYMDVW	IGHV1-3	IGHJ6
TGTGCACGGGGGATCGGGTATTACTATGGTTCAGGGAGTTACCTGGACCACTACTACTACTACTACATGGACGTCTGG	CARGIGYYYGSGSYLDHYYYYYMDVW	IGHV2-26	IGHJ6
TGTGCGAGAGATCCCGTCCGTCCAATTAATCGGAAAATTACTATGGTTCAGGGGAATATTAGCTACATGGACGTCTGG	CARDPVRPINRKITMVQGNISYMDVW	IGHV1-2	IGHJ6
TGTGCGAGAGATCCCCATGTACGATATTTTGACTGGTTATACTACTACTACATGGACGTCTGG	CARDPHVRYFDWLYYYYMDVW	IGHV1-69	IGHJ6
TGTGCGAGAGATGGTGGATATTGTAGTAGTACCAGCTGCCCCGTTGACTACTGG	CARDGGYCSSTSCPVDYW	IGHV3-66	IGHJ4
TGTGCGAAAGTTTGGCCCGCGGTGACTGTCCTCTTTGACTACTGG	CAKVWPAVTVLFDYW	IGHV3-23	IGHJ4
