TGTGCACACAGACATACTTCTCGTGGACACTATAGCAGCAGCTGGTACGCCAGCGCTTTTGATATCTGG	CAHRHTSRGHYSSSWYASAFDIW	IGHV2-5	IGHJ3
TGTGCGAAAGATCCCTGGTGGGAGACCTATTGTAGTGGTGGTAGCTGCTACACCTTAATCTACTACTTTGACTACTGG	CAKDPWWETYCSGGSCYTLIYYFDYW	IGHV3-23	IGHJ4
TGTGCGAAAGATTGGACGATGGATATTGTAGTAGTACCAGCTGCTATAAGACTACAGTTAGGCGCCAACTACTGG	CAKDWTMDIVVVPAAIRLQLGANYW	IGHV3-23	IGHJ4
TGTGCGAGACCGAGTATAGCAGCCCCTCTAAACAACTGGTTCGACCCCTGG	CARPSIAAPLNNWFDPW	IGHV3-66	IGHJ5
TGTGCGAAAGGTCAGGGTACTATGATAGTAGTGGTTATTTCAAACGTCTACTGG	CAKGQGTMIVVVISNVYW	IGHV3-NL1	IGHJ4
TGTGCGTTACGTATTATGATTACATTTGGGGGAGTTATCGCTTTTGACTACTGG	CALRIMITFGGVIAFDYW	IGHV1-3	IGHJ4
TGTGCACGGATAGAGCAGCCTAGGATACAGCTTGACTACTGG	CARIEQPRIQLDYW	IGHV2-70	IGHJ4
TGTGCATCCCCCCCCCCCCTTACTACGGTGACTACGCTGTACTACTTTGACTACTGG	CASPPPLTTVTTLYYFDYW	IGHV1-2	IGHJ4
TGTGCGAAAGATGCCCCTAGCAGCAGCTGGTACAAGGGGGGCCCCGGCTTTGACTACTGG	CAKDAPSSSWYKGGPGFDYW	IGHV3-NL1	IGHJ4
TGTGCGAGGGATTCGCTGATTCGTGGGTCTACGGTGTTCGTCGGCACCATTGCTTTTGATATCTGG	CARDSLIRGSTVFVGTIAFDIW	IGHV1-69	IGHJ3
TGTGCGAGAGGCCTTCCCGGTGGTAGCTGCTACCAGCCGAGATACCCCTTTGACTACTGG	CARGLPGGSCYQPRYPFDYW	IGHV4-34	IGHJ4
TGTGCACGCGACCTAGGAATTTTTCTAACCCTGGGACGTGCGATTGTACTGGTGGTGTATGCTATAATTAGACTGTTCTCGAAAGGGTTTCCCCAAAATAGTAAGTACCTCAACTGGTTCGACCCCTGG	CARDLGIFLTLGRAIVLVVYAIIRLFSKGFPQNSKYLNWFDPW	IGHV3-20	IGHJ5
TGTGCACTCGGCGAAGTGGGAGCTACTCGGGTGGATAAGGGGGATTCGTGCTTTGACTACTGG	CALGEVGATRVDKGDSCFDYW	IGHV2-5	IGHJ4
TGTGCGAGGTCCCTTATTGTAGTGGTGGTAGCTGCTACTCCCCTTGACTACTGG	CARSLIVVVVAATPLDYW	IGHV4-59	IGHJ4
TGTGCGAAAGGGGGCGGTTCGGCAGCAGCTGGTACTTCAATTTCGTACTGG	CAKGGGSAAAGTSISYW	IGHV3-NL1	IGHJ4
TGTGCGAGAGATCTTTTGGGCCCTGACTACAGATCCATCGGTGTTTTCAACTGGTTCGACCCCTGG	CARDLLGPDYRSIGVFNWFDPW	IGHV4-59	IGHJ5
TGTGCGAGCCTCACTATTGTAGTAGTACCAGCTGCACCTGCGACGGAATTTGACTACTGG	CASLTIVVVPAAPATEFDYW	IGHV3-7	IGHJ4
TGTGCGAGAGATCAGCCCAGACGATTTTTGGAGTGGTTACCCCAAGGAAGAGATAAGACCCTACTCTACTACTACTACTACATGGACGTCTGG	CARDQPRRFLEWLPQGRDKTLLYYYYYMDVW	IGHV1-46	IGHJ6
TGTGCGAAAGATCATGTACGGCCCCGCTACTGG	CAKDHVRPRYW	IGHV3-NL1	IGHJ4
TGTGCACGGATCGACGCTGCTATCACGGGGGCTGAATACTTCCAGCACTGG	CARIDAAITGAEYFQHW	IGHV2-26	IGHJ1
TGTGCGAGAATGCTATTACGACATTCGGCCCATTGGTACTACTACTACATGGACGTCTGG	CARMLLRHSAHWYYYYMDVW	IGHV3-21	IGHJ6
TGTGCGAGAGATCAGAACCCCCTTATGATTACATTTGGGGGAGTTATCGTTATACCACGTCCCTACTACTACTACTACATGGACGTCTGG	CARDQNPLMITFGGVIVIPRPYYYYYMDVW	IGHV3-53	IGHJ6
TGTGCGAGGAAACTCCCCCCGATAGCAGTGGCTGGTACTTACAAACGAAGGTGTTTTCCTTTTGACTACTGG	CARKLPPIAVAGTYKRRCFPFDYW	IGHV3-NL1	IGHJ4
TGTGCGAGAGTATCGGTAAGAAGGCGTCCCGCCTACAGCTGGTACCGATTTGCTTACTACTACTACTACTACATGGACGTCTGG	CARVSVRRRPAYSWYRFAYYYYYYMDVW	IGHV1-2	IGHJ6
TGTGCGAGTAATAACGCCATCGATGGCGTCGTATTACGATTTTTGGAGTGGTTATGGGACTACTACTACTACTACATGGACGTCTGG	CASNNAIDGVVLRFLEWLWDYYYYYMDVW	IGHV4-34	IGHJ6
TGTGCAAGCGAACCGAGGTGCAACGCTTCAGGTGCTCTGGCCCCGAGCAGTGGCTGGTACTCCTACTACTTTGACTACTGG	CASEPRCNASGALAPSSGWYSYYFDYW	IGHV3-74	IGHJ4
TGTGCGAGAGGCCTTAATATTGTAGTGGTGGTAGCTGCTACTCCGAATGACTACTGG	CARGLNIVVVVAATPNDYW	IGHV1-18	IGHJ4
TGTGACCGGTGCCTTGGATATAGTGGCTACGAGGTTGACTACTGG	CDRCLGYSGYEVDYW	IGHV1-3	IGHJ4
TGTGCGAGAGAGAGTGGTGGTAGCTGCTACAGGGCGGGTATAGGCTTTGACTACTGG	CARESGGSCYRAGIGFDYW	IGHV4-59	IGHJ4
TGTGGTCAGTATAGCAGCTCGTACAGGTGGTGTATGGGCGGTATACACTTTGACTACTGG	CGQYSSSYRWCMGGIHFDYW	IGHV3-30	IGHJ4
TGTGCGAGACCCCAAGGTAAGTATTACGATTTTTGGAGTGGTTCCCCGGGCAAAAAGAAGCTCGGGAGCTGG	CARPQGKYYDFWSGSPGKKKLGSW	IGHV4-59	IGHJ4
TGTGCGAAAGATCCCTGGACTACTATGATAGTAGTGGTTATTAGGACTACTTTGGCGCATCTTGACTACTGG	CAKDPWTTMIVVVIRTTLAHLDYW	IGHV3-23	IGHJ4
TGTGCGAGAGATTTGACCCCCCTGATAGTAGTACCAGCTGCGGGGTCGTTTGACTACTGG	CARDLTPLIVVPAAGSFDYW	IGHV3-21	IGHJ4
TGTGCGAACGAGGTGTATGGTTCGGGGAGTTACTGCTATTTTTATGCCCGACGCTGGTTCGACCCCTGG	CANEVYGSGSYCYFYARRWFDPW	IGHV3-NL1	IGHJ5
TGTGCAGAAAGCAGTGGCTGTGATGACTACTGG	CAESSGCDDYW	IGHV3-13	IGHJ4
TGTGCGAGACTAAGACAATGGTTCAGGGAGCTACAATGTTACTACTACTACATGGACGTCTGG	CARLRQWFRELQCYYYYMDVW	IGHV5-51	IGHJ6
TGTGCGAAAGACGGGCATATTGTGGTGGTGACTGCACCTGAGCGGAGCTTTGACTACTGG	CAKDGHIVVVTAPERSFDYW	IGHV3-NL1	IGHJ4
TGTACTAGAGACCCTTTGGAGGATGGCTACAAAACGGGCCCCGACTACTGG	CTRDPLEDGYKTGPDYW	IGHV3-49	IGHJ4
TGTGCGAGAGAAATGAGGGCCGGCCCGAATCGAGGTGCGCATATTGTGGTGGTGACTGGCCGGGGCATCAACTGGTTCGACCCCTGG	CAREMRAGPNRGAHIVVVTGRGINWFDPW	IGHV3-53	IGHJ5
TGTGCGAGATCGGCCTTACGATTTTTGGAGTGCATGGGTGCGTCTGCTTTTGATATCTGG	CARSALRFLECMGASAFDIW	IGHV3-7	IGHJ3
TGTGCAAGAGACAGGTGGTGGTTATTGCCCACAACCAACTTTGACTACTGG	CARDRWWLLPTTNFDYW	IGHV3-74	IGHJ4
TGTGCGAGAGACAAGACTACGGTGGTAACTATGCCTTCGGGGTTAAGGGAGGCGGCCCGGCACTTTGACTACTGG	CARDKTTVVTMPSGLREAARHFDYW	IGHV3-66	IGHJ4
TGTGCGAGAGCGACGGATTGTAGTAGTACCAGCTGCTATGGGGGGGTCTTTGACTACTGG	CARATDCSSTSCYGGVFDYW	IGHV4-34	IGHJ4
TGTGCGAGAGGGACCCTAGTGGTGGTAGCTGCTATATTCGTCTGG	CARGTLVVVAAIFVW	IGHV4-38-2	IGHJ5
TGTGCGAGAGCCTGCATGATCCGTAGTACCAGCTGCTACCTACACCCAGAACCATTCGACCCCTGG	CARACMIRSTSCYLHPEPFDPW	IGHV3-11	IGHJ5
TGTGCGAGAGCGGTTAGCGGGTTAGATTGTAGTGGTGGTAGCTGCTACGACTACTGG	CARAVSGLDCSGGSCYDYW	IGHV1-46	IGHJ4
TGTGCGAGAGATCCTTATATTGTAGTAGTACCAGCTGAGGATGAGGCTGGGAATGCGGACTACTGG	CARDPYIVVVPAEDEAGNADYW	IGHV4-59	IGHJ4
TGTGCGAGAGCTGCGAGAAGATATTGTAGTAGTACCAGCTGCTTCCACCACCGGCACTGGTTCGACCCCTGG	CARAARRYCSSTSCFHHRHWFDPW	IGHV3-53	IGHJ5
TGTGCGAGACCCTCAGTCGAGGGATATTGTAGTGGTGGTAGCTGCTACTCACGTTCCTTTGCCTTTGACTACTGG	CARPSVEGYCSGGSCYSRSFAFDYW	IGHV3-7	IGHJ4
TGTGCGAGAGGGGTCTATTGTAGTGGTGGTAGCTGTAGGGACAACTGGTTCGACCCCTGG	CARGVYCSGGSCRDNWFDPW	IGHV3-7	IGHJ5
TGTGGGAGTCCTATTTATGGTTCAGGGAGTTATTACTACTACTACTACATGGACGTCTGG	CGSPIYGSGSYYYYYYMDVW	IGHV3-30-3	IGHJ6
TGTGCAAGAGATGCCTCGGATATTGTAGTAGTACCAGCTGCTATGTTTTTTAACTGGTTCGACCCCTGG	CARDASDIVVVPAAMFFNWFDPW	IGHV3-74	IGHJ5
TGTGCGAGAGGTTATAGTCTGGCTATGTATTGTAGTAGTACCAGCTGCTATACACTTGCATACTGGTTCGACCCCTGG	CARGYSLAMYCSSTSCYTLAYWFDPW	IGHV1-3	IGHJ5
TGTGCGAGAGAGGATATTGTAGTGGTGGTAGCTGCTAACGTAGCTTTTGATATCTGG	CAREDIVVVVAANVAFDIW	IGHV1-46	IGHJ3
TGTGCGAGATGGATTATTTGGCCTATTACTATGGTTCAGGGAGTTATCTCCATGCGCTTTGACTACTGG	CARWIIWPITMVQGVISMRFDYW	IGHV5-10-1	IGHJ4
TGTACCACAGCGAACTTTTGTATATTCCCGGGATATTGTACTGGGCCCATTACCCTACCGGTTTTGACCGAAAATTACTACTACTACTACTACATGGACGTCTGG	CTTANFCIFPGYCTGPITLPVLTENYYYYYYMDVW	IGHV3-15	IGHJ6
TGTGCGAGAGATTACTTAGCAGTGGCTGGGATTGACTACTGG	CARDYLAVAGIDYW	IGHV3-20	IGHJ4
TGTGCAAGAGATCGATTCCTTAAGGGCGGCACAGTAGCCCCCAACCTTAGAGAAGTGGCTGGTATTCAACAGGACTTTGACTACTGG	CARDRFLKGGTVAPNLREVAGIQQDFDYW	IGHV3-13	IGHJ4
TGTGCGAGACATGGCCTTTTAGTACGATTTTTGGAGTGGTTAGCGGTTGACTACTGG	CARHGLLVRFLEWLAVDYW	IGHV4-39	IGHJ4
TGTGCGAGAGATTTCTTAACCGGGTGTGGTGGTGACTGCTGGTACTGGTACTTCGATCTCTGG	CARDFLTGCGGDCWYWYFDLW	IGHV3-11	IGHJ2
TGTGCGAGAGATGGAGCATCACATTACTACTACTACATGGACGTCTGG	CARDGASHYYYYMDVW	IGHV3-53	IGHJ6
TGTACCACAGATAGATATAGTGGCTACGATGGTATGGAGGCCCCTTCTGGGGACGCTGAATACTTCCAGCACTGG	CTTDRYSGYDGMEAPSGDAEYFQHW	IGHV3-15	IGHJ1
TGTACCACAGATCGGGGTGGCTACGATTGGCTTGCCTTTGACTACTGG	CTTDRGGYDWLAFDYW	IGHV3-15	IGHJ4
TGTGCGAACAAATGGTCCGTAGAACCGCATGACTACTGG	CANKWSVEPHDYW	IGHV3-7	IGHJ4
TGTACCACAGGGGAGGGACCGGTAGGGTATAGCAGCTCGTCCCTCAACTGGTTCGACCCCTGG	CTTGEGPVGYSSSSLNWFDPW	IGHV3-15	IGHJ5
TGTGCGAGAGTTTACAGTAACGACTTTGACTACTGG	CARVYSNDFDYW	IGHV1-69	IGHJ4
TGTGCGAAAGGCTGGGAAGGAAAAACAGCAGTGGCTGCTGACTACTGG	CAKGWEGKTAVAADYW	IGHV3-23	IGHJ4
TGTGCGAAAGATGCAACGGTGACTAAAAATTACTACTACTACTACTACATGGACGTCTGG	CAKDATVTKNYYYYYYMDVW	IGHV3-NL1	IGHJ6
TGTGCGAGCAGGAGTTACAGCAGCTCGTTACTCGGTTGTTTTGACTACTGG	CASRSYSSSLLGCFDYW	IGHV3-7	IGHJ4
TGTGCGAAATTACGAGAGGATATTGTAGTAGTACCAGCTGCTATGTCGTACTACTTTGACTACTGG	CAKLREDIVVVPAAMSYYFDYW	IGHV3-23	IGHJ4
TGTGCGAGAACAAAAAGGCGCCCTATTACGATTTTCGAATACTACTTTGACTACTGG	CARTKRRPITIFEYYFDYW	IGHV1-69	IGHJ4
TGTGCGAAAGATCTAAACGTGGTAAATAACTACTACTACTACTACATGGACGTCTGG	CAKDLNVVNNYYYYYMDVW	IGHV3-23	IGHJ6
TGTGCGAAAGATTCGGCACAAGCTTCCAACTTTGACTACTGG	CAKDSAQASNFDYW	IGHV3-NL1	IGHJ4
TGTGCGAAAGTACGATTTTTGGAGTGGTTATTATACGTTGACTACTGG	CAKVRFLEWLLYVDYW	IGHV3-NL1	IGHJ4
TGTGCGAGAGATAGATATAGTGGCTACGTCTACTACTACTACTACTACATGGACGTCTGG	CARDRYSGYVYYYYYYMDVW	IGHV1-3	IGHJ6
TGTGCGAGAGGACAAAGGTCAAGACAAAGAGATGGCTACAATTTAGAAAGAATTCTATCAGTGGGGGATGTGATCTGG	CARGQRSRQRDGYNLERILSVGDVIW	IGHV3-53	IGHJ3
TGTGCGAGAACCACGGTGACTACGACCGACTACTGG	CARTTVTTTDYW	IGHV4-38-2	IGHJ4
TGTGCGAGAATAATCGTGTTGGTATACGATTTTTGGAGTGGTTATACTCACGGCGAACGTGACTACTGG	CARIIVLVYDFWSGYTHGERDYW	IGHV3-7	IGHJ4
TGTGCGAAAGATTGTGATAGTGACTACGGTGAGGACTGGTTCGACCCCTGG	CAKDCDSDYGEDWFDPW	IGHV3-23	IGHJ5
TGTGCGAGAATAGGTCAGCAGTGGCTGGGGGCCACGCCGAGCTGGTTCGACCCCTGG	CARIGQQWLGATPSWFDPW	IGHV4-59	IGHJ5
TGTGCGAAGATGGGTCATAGCAGCTCGTCCCCTGACTACTACTACTACTACATGGACGTCTGG	CAKMGHSSSSPDYYYYYMDVW	IGHV3-23	IGHJ6
TGTGCGCTTTTAGTATTACGATTTTTGGAGTGGTTATTATATCAACTGTTTGGGTTGGACTACTGG	CALLVLRFLEWLLYQLFGLDYW	IGHV1-69	IGHJ4
TGTGCGAGAGATATAGACGGGCTTGACTACTGG	CARDIDGLDYW	IGHV3-20	IGHJ4
TGTGCGAGAGATCATGTGAAGGGGCCAGGGGGTTCGGGGAGTTATTATTGCCATGGGGCGATTTCTATGCGGACGAATTTTGACTACTGG	CARDHVKGPGGSGSYYCHGAISMRTNFDYW	IGHV3-11	IGHJ4
TGTGCGAGTAGGGGGAGGTGGCTACGCCGCGCTGAATACTTCCAGCACTGG	CASRGRWLRRAEYFQHW	IGHV3-48	IGHJ1
TGTGCGAGCCCGTGTCCTATTGTAGTAGTACCAGCTGCCCTTTTTTATCTCCGTAAAGACTACTGG	CASPCPIVVVPAALFYLRKDYW	IGHV1-18	IGHJ4
TGTGCGAGAACTCAGGCCGAGCTGGAGAACTTTGACTACTGG	CARTQAELENFDYW	IGHV7-4-1	IGHJ4
TGTGCGAAAGCTCCAGGGACCCTCCCGGCGGACAAATATTGTAGTGGTGGTAGCTGCTACTCGGCGTCGAGGTACGCGGACTACTGG	CAKAPGTLPADKYCSGGSCYSASRYADYW	IGHV3-23	IGHJ4
TGTGCGAGACTGGTTCTCGTATTGTACTGGTGGTGTATGCTATTAGGTATCGGGGTCCCCGTACCAACGTCACACTACTACTACATGGACGTCTGG	CARLVLVLYWWCMLLGIGVPVPTSHYYYMDVW	IGHV5-51	IGHJ6
TGTGCGAGAGAGGGGACTCCGGGTATAGCAGCAGCTGGTACGAAGAACCCTATCTTTGACTACTGG	CAREGTPGIAAAGTKNPIFDYW	IGHV3-30	IGHJ4
TGTGCGAGAGATACCCCCCCCAGCTTAGCAGCTCGTTTTGACTACTGG	CARDTPPSLAARFDYW	IGHV3-7	IGHJ4
TGTGCGAGAGATGGAGATTGTATAGCAGCAGCTGGTACGACCCCCCCTGATGCTTTTGATATCTGG	CARDGDCIAAAGTTPPDAFDIW	IGHV1-2	IGHJ3
TGTGCGAGAGAGACCCGATTATGGTTCGGGGAGTTATTATGGGCAGGGTCCCCACTGGGCCCCTGGTTCGACCCCTGG	CARETRLWFGELLWAGSPLGPWFDPW	IGHV3-11	IGHJ5
TGTGATTCGCCTGGAGGATATTGTAGTGGTGGTAGCTGCTGGCCCTATGGACTTTCCTCATATTACTACTACTACTACTACATGGACGTCTGG	CDSPGGYCSGGSCWPYGLSSYYYYYYYMDVW	IGHV3-30	IGHJ6
TGTGCGAGAGAGGCCCATGACTACAGTAACTACGGAACAACAACGACTAAGGGGGGGCGGGGGTACTACTACTACTACTACATGGACGTCTGG	CAREAHDYSNYGTTTTKGGRGYYYYYYMDVW	IGHV1-2	IGHJ6
TGTGCGAAAGCGGGGATTTTACGATATTTTGACTGGTTATTAGACTACTGG	CAKAGILRYFDWLLDYW	IGHV3-NL1	IGHJ4
TGTGCGAGAGGTCAGCTGTATTACTATGGTTCAGGGAGATGGGGTTACTGG	CARGQLYYYGSGRWGYW	IGHV4-28	IGHJ4
TGTGCGAGGATGGCGCCTATTGTAGTGGTGGTAGCTGCTACTGGTCAGTCTCACACATACGGATGG	CARMAPIVVVVAATGQSHTYGW	IGHV1-3	IGHJ5
TGTGCGAGATTTGACATACTACGCTGGAATTACTACTACTACTACTACATGGACGTCTGG	CARFDILRWNYYYYYYMDVW	IGHV1-69	IGHJ6
TGTGCGGCACCGGCCTGGTTCAGGGAGTGCTGG	CAAPAWFRECW	IGHV1-58	IGHJ4
