TGTGCGAGGCGTAACTGGTTCGACCCCTGG	CARRNWFDPW	IGHV1-2	IGHJ5
TGTACCACAGATCGGACACCTATAGGATATTGTACTGGTGGTGTATGCCCAGGGTACATGGACGTCTGG	CTTDRTPIGYCTGGVCPGYMDVW	IGHV3-15	IGHJ6
TGTACGTGTGTACTGGTGGTCCCGGGGACTTTTGATATCTGG	CTCVLVVPGTFDIW	IGHV3-9	IGHJ3
TGTGCGAATAGGGTTATTGTACTGGTGGTGTATGCGCCTCTTTGCAACTGGTTCGACCCCTGG	CANRVIVLVVYAPLCNWFDPW	IGHV3-NL1	IGHJ5
TGTGCACGGATACGGTTAGTTACGATTTTTGGAGTGGTTATCAACTACTGG	CARIRLVTIFGVVINYW	IGHV2-70	IGHJ4
TGTGCGAGAAGGGAGGGTGGTAGCTGCTACTCGGGGCTCTACTACTTTGACTACTGG	CARREGGSCYSGLYYFDYW	IGHV7-4-1	IGHJ4
TGTGCGAGAGAGAATGATTATTACTATGATAGTAGTGGTTATTACTGGGGGTGTGCGGCATCCAGCGTAAGAGGAAGCTATGACTACTGG	CARENDYYYDSSGYYWGCAASSVRGSYDYW	IGHV3-48	IGHJ4
TGTGCGAAAGCCAAAGTAGGGTCGGTATTACGATTTTTGGAGTGGTTATTATCCAACTGGTTCGACCCCTGG	CAKAKVGSVLRFLEWLLSNWFDPW	IGHV3-NL1	IGHJ5
TGTGCGAAAGGGACGATTTTTGGAGTGGTTAAAACCGGACCGGGGCCTGGATGTTGGTTCGACCCCTGG	CAKGTIFGVVKTGPGPGCWFDPW	IGHV3-23	IGHJ5
TGTGCGAGTAGCCTAGCAGCAGCTGGTACATTCTTTGCCTACTGG	CASSLAAAGTFFAYW	IGHV3-21	IGHJ4
TGTGCGAGACCTCGTAATGGGACTAACCCCCGGTGTATTACTATGGTTCAGGGAGTTATTATAACGGACTACTGG	CARPRNGTNPRCITMVQGVIITDYW	IGHV7-4-1	IGHJ4
TGTGCAAGAACCCGCCTACTAATGGTGTATGCTATGGGAACCCCTGACTACTGG	CARTRLLMVYAMGTPDYW	IGHV3-13	IGHJ4
TGTGCACGGATACACTCCAAGCCTATGGTTCGGGGAGTTATTAGGTACTGGTACTTCGATCTCTGG	CARIHSKPMVRGVIRYWYFDLW	IGHV2-70	IGHJ2
TGTGCGAACACCCTTGAGATTACTATGGTTCGGGGAGTTATTATATGTGGCGAATACTTCCAGCACTGG	CANTLEITMVRGVIICGEYFQHW	IGHV3-NL1	IGHJ1
TGTGCGAGAGAGAACCACAACTACTACTACTACTACTACATGGACGTCTGG	CARENHNYYYYYYMDVW	IGHV3-11	IGHJ6
TGTGCAAGATTACTTTGTAGGGGTATTACTATCGGAATTGACTACTGG	CARLLCRGITIGIDYW	IGHV6-1	IGHJ4
TGTGCGAAAGATCGGTCCATAGGTGCCAGGGGAACGGTTGTAGTAGTACCAGCTGCTATGACCTCTGATGCTTTTGATATCTGG	CAKDRSIGARGTVVVVPAAMTSDAFDIW	IGHV3-NL1	IGHJ3
TGTGCGAGAAAATTAGACACAACGATTACGATTTTTGGAGTGGTTATTCCATTTGACTACTGG	CARKLDTTITIFGVVIPFDYW	IGHV1-46	IGHJ4
TGTGCGAGAGAAGGTACGGATATTGTAGTAGTACCAGCTGCTATGTGCCCAAGCCGCGGGGACTACTGG	CAREGTDIVVVPAAMCPSRGDYW	IGHV3-7	IGHJ4
TGTGCGAGAGACTTGGAATTACGATTTTTGGAGTGGTTATTCCACTACTACTACTACATGGACGTCTGG	CARDLELRFLEWLFHYYYYMDVW	IGHV4-61	IGHJ6
TGTGCGAGTTTGATAGAACTTACGTACTACTTTGACTACTGG	CASLIELTYYFDYW	IGHV3-20	IGHJ4
TGTGCGAGATTACTATGGTTCAGGGAGTTGCCCGGACCTCTTGTTTCCTGGTTCGACCCCTGG	CARLLWFRELPGPLVSWFDPW	IGHV5-51	IGHJ5
TGTGCGAGAGCCGCCCTAGTAGTACCAGCTGCACCATACTACTACTACTACTACATGGACGTCTGG	CARAALVVPAAPYYYYYYMDVW	IGHV1-46	IGHJ6
TGTGCGAGAGTTTCCGCAGTGGCTGGTTGGGGGTTATTTGACTACTGG	CARVSAVAGWGLFDYW	IGHV3-7	IGHJ4
TGTGCGAAAGTAACCCTCCACCCAGTGGCTGGTACAACGTTTGCTTTTGATATCTGG	CAKVTLHPVAGTTFAFDIW	IGHV3-23	IGHJ3
TGTGCGAGGTCAGCAGCTGGTACTTTCTACTACTTTGACTACTGG	CARSAAGTFYYFDYW	IGHV5-51	IGHJ4
TGTGCGAGGGGTAGTACCAGCTGCGTAAGGGGTGGAGACTACTACTACTACTACATGGACGTCTGG	CARGSTSCVRGGDYYYYYMDVW	IGHV4-38-2	IGHJ6
TGTGCAAGAGATCTCACGAGGGATACTATGGTTCGGGGAGTTAAATACTACTTTGACTACTGG	CARDLTRDTMVRGVKYYFDYW	IGHV3-74	IGHJ4
TGTGCGAGAGAAGTCGGGAATATGGCAGTGGCTGGTCCCGGCTACTGG	CAREVGNMAVAGPGYW	IGHV3-21	IGHJ4
TGTGCGAGAGATGTCTGGTGTCTAATTGTAGTGGTGGTAGCTGCTACTCTAATCTCAGGTAACTGGTTCGACCCCTGG	CARDVWCLIVVVVAATLISGNWFDPW	IGHV4-61	IGHJ5
TGTGCGAGCGGCTTGGGTTCGGGGAGTTATGACTTGTTCCAGCACTGG	CASGLGSGSYDLFQHW	IGHV1-2	IGHJ1
TGTGCGAAAGGTCCCAAGACGCGGGAGTGGCTAGCCCGCGTCCGTTTCCCTGACTACTGG	CAKGPKTREWLARVRFPDYW	IGHV3-NL1	IGHJ4
TGTGCGAAAGCCTCCTACGATTTTTGGAGTGGTTATTATATTTTGTCCTACTACTACTACTACATGGACGTCTGG	CAKASYDFWSGYYILSYYYYYMDVW	IGHV3-NL1	IGHJ6
TGTACTAGAGTTCTACGATTTTTGGAGTGGGGTTTCGACCCCTGG	CTRVLRFLEWGFDPW	IGHV3-49	IGHJ5
TGTGCGAGAGCCCCGTCATATTTTGACTGGTTATTAGGTCTATTGGGTCAAGGGGATTCGTACTTTGACTACTGG	CARAPSYFDWLLGLLGQGDSYFDYW	IGHV3-53	IGHJ4
TGTGCGAGACGACAATTACGATTTTTGGAGTGGTTATTATGCAACTGGTTCGACCCCTGG	CARRQLRFLEWLLCNWFDPW	IGHV5-51	IGHJ5
TGTGCGAGAGACGGCGGGTATTACTATGATAGTAGTGGTTATTACGACTACTGG	CARDGGYYYDSSGYYDYW	IGHV1-46	IGHJ4
TGTGCGAGAGGGGCGCCAACTGACGTATTACGATTTTTGGAGTGGTTATTAGGGTACTACTACTACTACATGGACGTCTGG	CARGAPTDVLRFLEWLLGYYYYYMDVW	IGHV7-4-1	IGHJ6
TGTGCGACCGTTTTTTCCCGTCATCCTAGCGTGACGGTAGGATATTGTACTGGTGGTGTATGCTATTCCCATAACTACTACTACTACTACATGGACGTCTGG	CATVFSRHPSVTVGYCTGGVCYSHNYYYYYMDVW	IGHV3-21	IGHJ6
TGTGCGAAACCTGGGTATGATTACGTTTCTCGTTTAGCGCTGGGAGGCGACTACTGG	CAKPGYDYVSRLALGGDYW	IGHV3-23	IGHJ4
TGTGCGAGAAGGTCGAAGGAACAGAAAGCCTTCTTTGTTTCGGGGGGGTTTGACTACTGG	CARRSKEQKAFFVSGGFDYW	IGHV4-34	IGHJ4
TGTGCGAGAGATAGGGGCGTACTATGGTTCAGGGAGTTATTCCCTGACTACTGG	CARDRGVLWFRELFPDYW	IGHV3-53	IGHJ4
TGTGCGAAAGCCCCCTTCCTTAATGAATCCGAGACAGGGGGACCGCTTATTACTATGGTTCAGGGAGTTATCCTCGGTTCCCTAGGATACCTTGACTACTGG	CAKAPFLNESETGGPLITMVQGVILGSLGYLDYW	IGHV3-NL1	IGHJ4
TGTGTATCTATTACGATTTTTGGAGTGGTTATTATACCCCACTTTGACTACTGG	CVSITIFGVVIIPHFDYW	IGHV3-30	IGHJ4
TGTGCGAGACATTTACCAAGCCGGGATATTGTAGTAGTACCAGCTGCTAGGGGCTACATGGACGTCTGG	CARHLPSRDIVVVPAARGYMDVW	IGHV5-51	IGHJ6
TGTGCGAGGGTACGAAGCATTATAAGGGGGTGCCGTAACCGCGCCTACCCTTCGGATTATGATTACATTTGGGGGAGTTATCGCTTTTTCGACTACTGG	CARVRSIIRGCRNRAYPSDYDYIWGSYRFFDYW	IGHV3-NL1	IGHJ4
TGTGCGAGTAGTTATAGCAGTGGCTATTCCTGG	CASSYSSGYSW	IGHV1-18	IGHJ4
TGTGCGGCTACGAGGCATCCGACAGCTATGGTTACCTACTACTTTGACTACTGG	CAATRHPTAMVTYYFDYW	IGHV3-66	IGHJ4
TGTACCACAGAGCCCAATATTGTAGTGGTGGTAGCTGCTACCGTGGGAGGGGACTACTGG	CTTEPNIVVVVAATVGGDYW	IGHV3-15	IGHJ4
TGTGCGAGAGAACTCCTTATCCCCGGGTATAGCAGTGGCTGGTACGCCCGGGCGGACTACTGG	CARELLIPGYSSGWYARADYW	IGHV4-61	IGHJ4
TGTGCGAGAGGCCCCTCCCACTCTGGCTGTAGTGGTGGTAGCTGCTACGTTGACTACTGG	CARGPSHSGCSGGSCYVDYW	IGHV4-34	IGHJ4
TGTGCGAGAGATGGTAATACCGGGTATAAAATTGTACTAATGGTGTATGCGCACTACTGG	CARDGNTGYKIVLMVYAHYW	IGHV3-64	IGHJ4
TGTGCGAGAAAAGGATATTGTAGTAGTACCAGCTGCTCTTTATCCGGAGTATTTGACTACTGG	CARKGYCSSTSCSLSGVFDYW	IGHV7-4-1	IGHJ4
TGTGCGGCAGGGGTAACTTATCCCTGGTTCGACCCCTGG	CAAGVTYPWFDPW	IGHV1-58	IGHJ5
TGTGCGAGAGGCCGATCCGATCCTTGTAGTAGTACCAGCTGCTATGCCCCCTACTACTACTACTACATGGACGTCTGG	CARGRSDPCSSTSCYAPYYYYYMDVW	IGHV3-21	IGHJ6
TGTGCGACCCTCTACGCAGGGAACTGGTTCGACCCCTGG	CATLYAGNWFDPW	IGHV3-NL1	IGHJ5
TGTGCGAGGGGCCTATTACGATATTCTCTGGTTTACGGTGTGTTCGTAGACTACTGG	CARGLLRYSLVYGVFVDYW	IGHV4-4	IGHJ4
TGTGCGAGAGTGCCCACCCGGAGTTACTATGATAGTAGTGGTTATGCGTTTGACTACTGG	CARVPTRSYYDSSGYAFDYW	IGHV3-11	IGHJ4
TGTGCGAAAGTGATGGGCCAGACTACGGTGACTACGTCCTCCGACTACTGG	CAKVMGQTTVTTSSDYW	IGHV3-23	IGHJ4
TGTGCGAGAGGCGGGAAGTCTACTATGAGACGAGGACCTTGTTATGACTACTGG	CARGGKSTMRRGPCYDYW	IGHV4-34	IGHJ4
TGTGCGATCGTATTACGATTTTTGGAGTGGTTGGCCTACTTTGACTACTGG	CAIVLRFLEWLAYFDYW	IGHV3-11	IGHJ4
TGTGCGCGTGGCCGAGCCGTTATTGTAGTGGTGGTAGCTGCATACTACTACTACATGGACGTCTGG	CARGRAVIVVVVAAYYYYMDVW	IGHV1-69	IGHJ6
TGTGCGAGAGACTGGGGGCTGAGATGGCTACAATTACGTAGCGTAAACCATGTCTCTGAATACTTCCAGCACTGG	CARDWGLRWLQLRSVNHVSEYFQHW	IGHV1-3	IGHJ1
TGTGCGAGACAGCTTAAATTAGGATATTGTAGTAGTACCAGCTGGAGGAAATTTGACTACTGG	CARQLKLGYCSSTSWRKFDYW	IGHV5-51	IGHJ4
TGTGCGAGAGAGGGCGACTATTGTAGTAGTACCAGCACTACGAGGCCCTACTTTGACTACTGG	CAREGDYCSSTSTTRPYFDYW	IGHV1-69	IGHJ4
TGTGCGAGCAGGATATTACTATGGTTCGGGGAGCGTCCTGACTACTGG	CASRILLWFGERPDYW	IGHV3-11	IGHJ4
TGTGCGAGAGGATCCTTTAACATGTCTTCTAGTATAACTGGAAAGGAGTGGACATCCCAAAATGATGCTTTTGATATCTGG	CARGSFNMSSSITGKEWTSQNDAFDIW	IGHV3-53	IGHJ3
TGTGCGAAAGATTTATACATAGCAGCAGCTGGTAGGCCACTGATTGACTACTGG	CAKDLYIAAAGRPLIDYW	IGHV3-NL1	IGHJ4
TGTGCGAGAGAAGGGGACGGTAGTACCCTTTGGTTCGACCCCTGG	CAREGDGSTLWFDPW	IGHV3-20	IGHJ5
TGTGCCGGGGGTACAGTAACTACGATCAACTGGTTCGACCCCTGG	CAGGTVTTINWFDPW	IGHV5-51	IGHJ5
TGTGCGAGAGATTATACCATGATAGTAGTGGTTATTACGCAACCCAACTGGTTCGACCCCTGG	CARDYTMIVVVITQPNWFDPW	IGHV4-61	IGHJ5
TGTGCAAGAGGGTCTGGCTGTGGGCTTTTTGGAGTGGTTATGAGCGAGTACGAAAGTGACTACTGG	CARGSGCGLFGVVMSEYESDYW	IGHV3-13	IGHJ4
TGTGCGAAAGTGTACCTGAAGGACGTTAAGCACTACTGG	CAKVYLKDVKHYW	IGHV3-23	IGHJ4
TGTGCGAGAGTTAGGGGCCCTTGCGGGGGGGGTCCGCAGTACTACTACTACTACATGGACGTCTGG	CARVRGPCGGGPQYYYYYMDVW	IGHV1-2	IGHJ6
TGTGCGAGAGGGGAAGAATGCAGCAGCTGGCCGGACATGGACGTCTGG	CARGEECSSWPDMDVW	IGHV1-46	IGHJ6
TGTGCGAGACCCCCTGTAGTGGTGGTAGCTGCTACTGGGTGTGGAGCCTTTGACTACTGG	CARPPVVVVAATGCGAFDYW	IGHV4-38-2	IGHJ4
TGTGCGAGACATCCTTTATTTTCTGATAGTAGTGGTTATTACTATTTGTGTGACTACTGG	CARHPLFSDSSGYYYLCDYW	IGHV4-39	IGHJ4
TGTGCGAGACATATAACTCCGGATATTGTAGTAGTACCAGCATGTAGTGACTACTGG	CARHITPDIVVVPACSDYW	IGHV5-51	IGHJ4
TGTGCGAGACTCCTCGCTGACTACTGG	CARLLADYW	IGHV4-4	IGHJ4
TGTGCACGGATACAGGGATACGCCATTGGGAACTGGTTCGACCCCTGG	CARIQGYAIGNWFDPW	IGHV2-70	IGHJ5
TGTGCGAGAGGAGAAAACAAGCGTATGGTTCAGGGAGTTATTATATACTACTACTACTACTACATGGACGTCTGG	CARGENKRMVQGVIIYYYYYYMDVW	IGHV4-59	IGHJ6
TGTGCGAGAGACGCTATTGTAGTAGTACCAGCTGCTATGCGGAATACTAATAGCTGGTTCGACCCCTGG	CARDAIVVVPAAMRNTNSWFDPW	IGHV7-4-1	IGHJ5
TGTGCGAGAGCGGGATATTGTAGTAGTACCAGCTGCTATGTTACCGGGCGGGGGCCCTACTACTACATGGACGTCTGG	CARAGYCSSTSCYVTGRGPYYYMDVW	IGHV3-11	IGHJ6
TGTGCGAGACGGGAAAGCCCATCGGGGCTACATATAGTGGCTACGATTCACTACTACTACATGGACGTCTGG	CARRESPSGLHIVATIHYYYMDVW	IGHV5-51	IGHJ6
TGTGCGAGAATTGTAGTGGTGGTAGCTGCTAGGTGGTTCGACCCCTGG	CARIVVVVAARWFDPW	IGHV1-18	IGHJ5
TGTGCGAGACGAATGGAAGAGTATAGCAGCTTATCAAATTTTGACTACTGG	CARRMEEYSSLSNFDYW	IGHV7-4-1	IGHJ4
TGTGCGAGACGATACGATTTTTGGAGTGGTTATTATACCGGTATCCAGGCGCCTAGGCCTATACCCCTGGGGCCACCTTACTACTACTACTACTACATGGACGTCTGG	CARRYDFWSGYYTGIQAPRPIPLGPPYYYYYYMDVW	IGHV5-51	IGHJ6
TGTGCGAGAGATGTGGCGCGCATTCCCGGGGGTCGATATTGTAGTGGTGGTAGCTGCTACTTTGTTCATCATTACTACTTTGACTACTGG	CARDVARIPGGRYCSGGSCYFVHHYYFDYW	IGHV3-7	IGHJ4
TGTGCGAGAGAAGGAGCCGACTGTGGATATAGTGGCTACGATTTGAACTGGTTCGACCCCTGG	CAREGADCGYSGYDLNWFDPW	IGHV1-69	IGHJ5
TGTACCACGGGTATAGCAGTGGCTGGTACGAAGTACTACTTTGACTACTGG	CTTGIAVAGTKYYFDYW	IGHV3-15	IGHJ4
TGTGCGAGAGATCGTCCTACCGGGTATAGCAGCAGCAGGTGCGAGCGAGGCTGG	CARDRPTGYSSSRCERGW	IGHV3-11	IGHJ5
TGTGCAAGGATTCAGGAGCAACACCCAGCAGCTGGGAGCCCCTACTTTGACTACTGG	CARIQEQHPAAGSPYFDYW	IGHV3-43	IGHJ4
TGTGCGAGAGATCGGCCGTTTCATTGTAGTAGTACCAGCTGCTATAGCTGCTACTCGATAAACTGGTTCGACCCCTGG	CARDRPFHCSSTSCYSCYSINWFDPW	IGHV1-46	IGHJ5
TGTGCGAGAGCCGACGCGGAGATGGCTACAATTTACATTGACTACTGG	CARADAEMATIYIDYW	IGHV1-2	IGHJ4
TGTGCGAAGGTTCGTGGCTACGATTCCCATGCTTTTGATATCTGG	CAKVRGYDSHAFDIW	IGHV3-NL1	IGHJ3
TGTGCGAAGTCGATCTCCACGGCCGCCCCGCAGTGGCTGGCAGGAGGACTTGAGCTCCCCCACCGGATTGACTACTGG	CAKSISTAAPQWLAGGLELPHRIDYW	IGHV3-NL1	IGHJ4
TGTGCGAAAGATCCGGGACCCAGTGGCTGGGCCCGCTCCATTAGTTACTGG	CAKDPGPSGWARSISYW	IGHV3-23	IGHJ4
TGTGCGAGAGATCTTAGCAGTGGCTGGTACGGTCAATCCTGG	CARDLSSGWYGQSW	IGHV3-20	IGHJ4
TGTGCGAGAGACGATTTTTGGAGTGGTTATTGGACCTACAACTGGTTCGACCCCTGG	CARDDFWSGYWTYNWFDPW	IGHV3-30	IGHJ5
TGTGCGAGGGGCCCCGGGATTACTATGATAGTAGTGGTTATTCATACCTTTGACTACTGG	CARGPGITMIVVVIHTFDYW	IGHV1-46	IGHJ4
