TGTGCGAGAGCTGAGACGATTTTTGGAGTGGGGGTCTACTGG	CARAETIFGVGVYW	IGHV4-59	IGHJ4
TGTGCGAGAGGCCAAGTTGGTGGTGTATGCTATATCTACTACTACTACATGGACGTCTGG	CARGQVGGVCYIYYYYMDVW	IGHV4-34	IGHJ6
TGTGCCGGGAACCCTTCAGGGTTTTTCTACTGG	CAGNPSGFFYW	IGHV3-NL1	IGHJ4
TGTGCGAGAGATCCCGGGATACGAACAGTGGCTGGTACGCCCGACCGGGAGTGGTACTACTACTACTACTACATGGACGTCTGG	CARDPGIRTVAGTPDREWYYYYYYMDVW	IGHV1-69	IGHJ6
TGTGCGAGCCCTTTCGGTGGCTTTGACTACTGG	CASPFGGFDYW	IGHV4-59	IGHJ4
TGTGCAAGATATTCCGGCGATGGACTCAACTGGTTCGACCCCTGG	CARYSGDGLNWFDPW	IGHV3-13	IGHJ5
TGTGCGAGAGTACTAAATTTTCCCCATTGTACTGGTGGTGTATGCTATAAATACTACTACTACATGGACGTCTGG	CARVLNFPHCTGGVCYKYYYYMDVW	IGHV3-11	IGHJ6
TGTGCGAAAAAAATAGGTGGCTGGTACTGG	CAKKIGGWYW	IGHV3-NL1	IGHJ4
TGTGCGAGTGGATACGCAATGTTAGTAACTACGAGGCACTACTTTGACTACTGG	CASGYAMLVTTRHYFDYW	IGHV4-59	IGHJ4
TGTACCGGACATTACGATATTTTGACTGGTTATTATTTTTGTCTCTACTGG	CTGHYDILTGYYFCLYW	IGHV3-15	IGHJ4
TGTGCGAGACCCAATACGATTTTTGGAGTGGGACTAGAGCCGGGAGGGGTCGCTTTTGATATCTGG	CARPNTIFGVGLEPGGVAFDIW	IGHV4-38-2	IGHJ3
TGTGCCCCTCTACCGGCACTGATGGGACGTTCTCTTGATGCTTTTGATATCTGG	CAPLPALMGRSLDAFDIW	IGHV4-59	IGHJ3
TGTGCGAGAGAACACGCTTGGCTAGTGGTGGTAGCTGCTATGTGCAACCCGTTTGATATCTGG	CAREHAWLVVVAAMCNPFDIW	IGHV1-3	IGHJ3
TGTGCGAGCAATGAGATTGTAGTAGTACCAGCTGCTATACCAGGGTACTACTTTGACTACTGG	CASNEIVVVPAAIPGYYFDYW	IGHV3-7	IGHJ4
TGTGCACACCGTATGGTGCTATGGTTACTAAGCCGGAAGATTGACTACTGG	CAHRMVLWLLSRKIDYW	IGHV2-5	IGHJ4
TGTGCGAGGGTTCCCGGGTATAGCAGTGGCTGGTCGTCTAAGCGGACCCTTTACTACTACATGGACGTCTGG	CARVPGYSSGWSSKRTLYYYMDVW	IGHV4-34	IGHJ6
TGTGCGAGAGATTTGGTTAGTAGTACCAGCTGCTATAAAACATACTTTGACTACTGG	CARDLVSSTSCYKTYFDYW	IGHV3-53	IGHJ4
TGTGCGAAAGATGGTACTGGGGTTGGAGTGGTTATTAACTGGTTCGACCCCTGG	CAKDGTGVGVVINWFDPW	IGHV3-23	IGHJ5
TGTGCGAGAGACGAACCCAGTGGCTGGTACCACATCTGGTTCGACCCCTGG	CARDEPSGWYHIWFDPW	IGHV3-7	IGHJ5
TGTGCGAGACCGTCCCTCCCAAAGGTCGTGAAGCCTTCTGGATATTGTAGTGGTGGTAGCTGCTATAAGGTGTGG	CARPSLPKVVKPSGYCSGGSCYKVW	IGHV5-51	IGHJ5
TGTGCGAGCGATTTTTGGAGTGGTTTCGTCCCACTAAACTGGTTCGACCCCTGG	CASDFWSGFVPLNWFDPW	IGHV1-2	IGHJ5
TGTGCGAGAGGGGGGTATAGCAGCAGCTGGTACCGGACGGCTTTTGATATCTGG	CARGGYSSSWYRTAFDIW	IGHV3-48	IGHJ3
TGTGCGAGAGCATGTTGGTACGTGGATACAGCTACCCGGTCTTACTTCGATCTCTGG	CARACWYVDTATRSYFDLW	IGHV1-69	IGHJ2
TGTGCGAGAGATTATAGCAGTGCCCGATTCAGCTACTACTACTACATGGACGTCTGG	CARDYSSARFSYYYYMDVW	IGHV1-3	IGHJ6
TGTGCGAGAGATCCTCCATTGGGGACCGCTATTACTATGGTTCAGGGAGTTATTATAACGAAGGTCCCCGGCGATGATGCTTTTGATATCTGG	CARDPPLGTAITMVQGVIITKVPGDDAFDIW	IGHV4-61	IGHJ3
TGTGCGAGAGATGTTTGGCGTAGTAGGGGGCGAAGTGTGCCCGATTACGATATTTTGACTGGTTATTACTCTTGG	CARDVWRSRGRSVPDYDILTGYYSW	IGHV3-53	IGHJ5
TGTGCGAGAGGGATTCAGCTGGTACCACACAACTGGTTCGACCCCTGG	CARGIQLVPHNWFDPW	IGHV1-69	IGHJ5
TGTACCACGGCTCGTATAGCAGCTCGTCAAGCGAGGAGTGTGTGTACATGTCCGTGGTTAGTGGTACGAGACATGGACGTCTGG	CTTARIAARQARSVCTCPWLVVRDMDVW	IGHV3-15	IGHJ6
TGTGCGAGAAATGTCCGGGTTGTTCTTGGGGGAAACTGGTTCGACCCCTGG	CARNVRVVLGGNWFDPW	IGHV3-64	IGHJ5
TGTGGGATGCAGTGGCTGGTACGGAAGCCCTACTGG	CGMQWLVRKPYW	IGHV3-30	IGHJ4
TGTGCGAAAGATCCCCAGTGGTGGTGTATGCTATCGTTGCTTGTATACTACATGGACGTCTGG	CAKDPQWWCMLSLLVYYMDVW	IGHV3-23	IGHJ6
TGTACTAGAAGATCCTACCAAGGGGGGTGGGACTACTGG	CTRRSYQGGWDYW	IGHV3-49	IGHJ4
TGTGCGAAATCGCTAGGATATTGTAGTAGTACCAGCTGCTATAAAGGGGGGTTTAGGGGCGTCTACTGG	CAKSLGYCSSTSCYKGGFRGVYW	IGHV3-NL1	IGHJ4
TGTGCGAGAGGTCCGGGTTGTGTACCAGCGGTTCATAACTGGTTCGACCCCTGG	CARGPGCVPAVHNWFDPW	IGHV3-11	IGHJ5
TGTGCGAAATTTGGCCCACCAGGCCATTTTGGTGGTAGCTGCTACTCCGGGGTTAAACAACACTGG	CAKFGPPGHFGGSCYSGVKQHW	IGHV3-NL1	IGHJ4
TGTGCGAGAGTTAGGAGGGGAGTACCGAGTTCTATTGTAGTAGTACCAGCTGCTTGGAAGTACTACTTTGACTACTGG	CARVRRGVPSSIVVVPAAWKYYFDYW	IGHV4-59	IGHJ4
TGTGCGGGCACTGTCCTGCAGTGGCTGGTACCTCCCCCTGCCCCCCCCTTGGAAGCAGACTACTGG	CAGTVLQWLVPPPAPPLEADYW	IGHV3-20	IGHJ4
TGTAAGGTTCCTATCGGGGTGTATTACTATGGTTCAGGGAGTTATTATACCAGTGCAGCGAATTCCCCGGCTGAAGGAAAAGCCTACTACTACTACATGGACGTCTGG	CKVPIGVYYYGSGSYYTSAANSPAEGKAYYYYMDVW	IGHV3-73	IGHJ6
TGTACCACAGATGTCAGAGTAAGAGTCTTGCGAGGTATGTGTGGGTTACCGGACCGGTACTATGATAGTAGTGGTTATGGGGTTGCTTTTGATATCTGG	CTTDVRVRVLRGMCGLPDRYYDSSGYGVAFDIW	IGHV3-15	IGHJ3
TGTGCGAGAGACGGGGTAGGGGACTACTACTACATGGACGTCTGG	CARDGVGDYYYMDVW	IGHV3-30	IGHJ6
TGTGCGAGAATACGGCTGGCCTATTACTATGGTTCAGGGAGTTATGGATTCTCCCGTGTAGTCGACCCCTGG	CARIRLAYYYGSGSYGFSRVVDPW	IGHV1-18	IGHJ5
TGTGCGAGAGATCCGAAAGTGGTGGTAGCTGCTATCCCCTACTACTACTACATGGACGTCTGG	CARDPKVVVAAIPYYYYMDVW	IGHV4-59	IGHJ6
TGTGCGAAAGGAGGTTCCCCGGGAGCTATGGTTCGGGGAGTTATTATAACGTCACAGTGGTTCGACCCCTGG	CAKGGSPGAMVRGVIITSQWFDPW	IGHV3-NL1	IGHJ5
TGTGCGAGAAACCCGAGTCCCTATGTAGGCCCGCGGGATGGGGTAGAGTACTACTTTGACTACTGG	CARNPSPYVGPRDGVEYYFDYW	IGHV3-21	IGHJ4
TGTACTAGAGCCTCGGATAGAGTTGGATATTGTAGTAGTACCAGCTGCTATTGGTCCTACTACTACTACATGGACGTCTGG	CTRASDRVGYCSSTSCYWSYYYYMDVW	IGHV3-49	IGHJ6
TGTGCGAGAGAGGAACAAAGGATTTTTGGAGTGGAGGACATCAACTGGTTCGACCCCTGG	CAREEQRIFGVEDINWFDPW	IGHV4-61	IGHJ5
TGTGCGAGAGCTAGAGGAAGGAGGCCATTACGATTTTTGGATCCCTACTACTTTGACTACTGG	CARARGRRPLRFLDPYYFDYW	IGHV3-21	IGHJ4
TGTGCGAGAGCCCCCCGTGGTTATTATACCCCCAGATGCTTTTTTGACTACTGG	CARAPRGYYTPRCFFDYW	IGHV1-3	IGHJ4
TGTGCAAAAGCCGGATATTGTAGTGGTGGTAGCTGCTACTCCGTAAGAGATAACTGGTTCGACCCCTGG	CAKAGYCSGGSCYSVRDNWFDPW	IGHV3-43D	IGHJ5
TGTGCGAGAGGCTATGGTTCAGGGAGTTATTATCACTTCCTCGCTTCCCCGCTAAATGCATGCTTTGACTACTGG	CARGYGSGSYYHFLASPLNACFDYW	IGHV1-69	IGHJ4
TGTGCGAGAGCCAGTAGCAGTGGCTGGGTTGACTACTGG	CARASSSGWVDYW	IGHV1-46	IGHJ4
TGTGCGAACCCGACTACGGTAGGGCCACGGGGGTACTTCGATCTCTGG	CANPTTVGPRGYFDLW	IGHV3-23	IGHJ2
TGTGCGAGAGTAGTGTGGCTTCATAAACTTTTACCGTTCTATTGTAGTGGTGGTAGCTGGCGTGACTACTGG	CARVVWLHKLLPFYCSGGSWRDYW	IGHV3-64	IGHJ4
TGTGCACGGATACAACAGGAGCCTACTAATGGTGTATGCTATAGACCCGACTACTGG	CARIQQEPTNGVCYRPDYW	IGHV2-26	IGHJ4
TGTGGCTGGCCATATGGTTCGGGGAGTTGCTCCCAGTATAACCACAACTGGTTCGACCCCTGG	CGWPYGSGSCSQYNHNWFDPW	IGHV1-8	IGHJ5
TGTGCGAGAGAGGAAAGGACTATGATAGTAGTGCCTAAGCCTTTTGACTACTGG	CAREERTMIVVPKPFDYW	IGHV3-20	IGHJ4
TGTGCGAGCCACGGTCCCGTATTACTATGGTTCGGGGAGTCAGCCGAGTACTACTTTGACTACTGG	CASHGPVLLWFGESAEYYFDYW	IGHV1-3	IGHJ4
TGTGCGAAATTTGTAGGGTATCACTGGTACGAACAAGTAACTACAAAAGGGTTCGACCCCTGG	CAKFVGYHWYEQVTTKGFDPW	IGHV3-NL1	IGHJ5
TGTGCGAGAGGAGGACCATTATTCCGGTATAGCAGTGGCTGTGATGCTTTTGATATCTGG	CARGGPLFRYSSGCDAFDIW	IGHV3-30	IGHJ3
TGTGCGAAAGAGAACCGCTGGACTCCTATTACTATGATAGTAGTGGTTATTGGCGACTACTGG	CAKENRWTPITMIVVVIGDYW	IGHV3-23	IGHJ4
TGTGCGAAATACATATTCCGTGCCCGGAAACGATTGGCGCCGATCCAGCACTGG	CAKYIFRARKRLAPIQHW	IGHV3-NL1	IGHJ1
TGTGCGAGAGAAGATTCTCCCCGTGCATATTGTGGTGGTGACTGCTATTTTCGGGCTAAATTCTGTGAAGTTGACTACTGG	CAREDSPRAYCGGDCYFRAKFCEVDYW	IGHV3-53	IGHJ4
TGTGCGAGAGATCACGAAGGACAGATTTTTGGAGTGGTTATTATTTTTTTATTCGACTACTGG	CARDHEGQIFGVVIIFLFDYW	IGHV3-53	IGHJ4
TGTGCGAGAGGATATGCGAGGGCGTATAGCAGTGGCTGGTACCGCCTGGGGGCTATTGACTACTGG	CARGYARAYSSGWYRLGAIDYW	IGHV4-59	IGHJ4
TGTGCGAGAGATAGGATATTACGATTTTTGGAGTGGTTAAGGGGAGCGGATTACTACTACTACTACTACATGGACGTCTGG	CARDRILRFLEWLRGADYYYYYYMDVW	IGHV4-59	IGHJ6
TGTGCGAGAGACTTCGCCGCGCAAGCCGTATTACGATTTTTGGAGTGGTTATTATCGGACTACTGG	CARDFAAQAVLRFLEWLLSDYW	IGHV1-2	IGHJ4
TGTGCGAAAGTGATGAGGCCACATTTTCGGCCAATTGTAGTGGTGGTAGCTGCTAATGCCCCCCGATACTGG	CAKVMRPHFRPIVVVVAANAPRYW	IGHV3-23	IGHJ4
TGTGCGAAAGATCACGGGGGTTGTAGTAGTACCAGCTGCCGTTTATTGGTGTGGGTCGCCTACTACTTTGACTACTGG	CAKDHGGCSSTSCRLLVWVAYYFDYW	IGHV3-NL1	IGHJ4
TGTGCACGGATAAATGCGGGAGCCCATATTACTATGATAGTAGTGGTTATCTTACGTGAGTTTTATTTGTCCAGCGTTGACTACTGG	CARINAGAHITMIVVVILREFYLSSVDYW	IGHV2-26	IGHJ4
TGTGCGAGAATTACCCCTCATGTAGTAGTACCAGCTGCTAGGAACTACTACTACTACATGGACGTCTGG	CARITPHVVVPAARNYYYYMDVW	IGHV4-38-2	IGHJ6
TGTGCAAGAGATCTCCCCACTATGGTTCAGGGAGTTATCGGTCTTCGAATGGACGTCTGG	CARDLPTMVQGVIGLRMDVW	IGHV3-13	IGHJ6
TGTGCGAGACGACCTACAGGCCCCCACTGG	CARRPTGPHW	IGHV5-51	IGHJ4
TGTGCACGCGAATCAGCAGCAGCTGGGGCCCTCGGACCGTACAACTGGTTCGACCCCTGG	CARESAAAGALGPYNWFDPW	IGHV2-5	IGHJ5
TGTGCGAGATGGGTAGTTTTCGATATTGTAGTAGTACCAGCTGCTATGGTAGCCAATAATGATGCTTTTGATATCTGG	CARWVVFDIVVVPAAMVANNDAFDIW	IGHV7-4-1	IGHJ3
TGTGCGAGCTTCGTGCATATTGTGGTGGTGACCGGCTTTGACTACTGG	CASFVHIVVVTGFDYW	IGHV4-4	IGHJ4
TGTGCGAAAGATGGGGCATATTGTGGTGGTGATTGCTATTCGGCCCTTGACTACTGG	CAKDGAYCGGDCYSALDYW	IGHV3-NL1	IGHJ4
TGTGCGAGATCAGGGGAAAGGGGGTTTATTACGATTTTTGGAGTGGTTATTATTATCCGGGTCTGGTTCGACCCCTGG	CARSGERGFITIFGVVIIIRVWFDPW	IGHV4-38-2	IGHJ5
TGTGCGAAAGATCAAGGCATTGTAGTAGTACCAGCTGCCCTTAATCGGCCGAGCTACTACTACTACTACATGGACGTCTGG	CAKDQGIVVVPAALNRPSYYYYYMDVW	IGHV3-23	IGHJ6
TGTGCGAAAGTGATGGGGTCTCTACCAGCTGCTTGTCGAAAAAAACCCTACTACTACTACTACATGGACGTCTGG	CAKVMGSLPAACRKKPYYYYYMDVW	IGHV3-NL1	IGHJ6
TGTGCGAGAGTGTGTCCCAATTGTAGTGGTGGTAGCTGCTACGGGTTCGACCCCTGG	CARVCPNCSGGSCYGFDPW	IGHV1-2	IGHJ5
TGTGCGAGGGGTTACGATTTTTGGAGTGGTTATTCGGGCGGGCTCGACCCCTGG	CARGYDFWSGYSGGLDPW	IGHV5-51	IGHJ5
TGTGCGAGAGATCATAAGACCCACTATGGTTCAGGGAGTTATCTCTACTACTACTACTACATGGACGTCTGG	CARDHKTHYGSGSYLYYYYYMDVW	IGHV1-18	IGHJ6
TGTGCGAGACTAAGCCTTGTAGTAGTACCAGCTGCATTATACTACTACTACTACTACATGGACGTCTGG	CARLSLVVVPAALYYYYYYMDVW	IGHV5-51	IGHJ6
TGTGCGAGAGATGAAGATGAAACGCAGCAGCCGGGTTACTGG	CARDEDETQQPGYW	IGHV1-69	IGHJ4
TGTGCGAGAGATTCGGGCAATGTTCATTGTACTGGTGGTGTATGCTATACCATACCCTTTGACTACTGG	CARDSGNVHCTGGVCYTIPFDYW	IGHV1-18	IGHJ4
TGTGCGAAAGATCGGGGCGAGGCGGATATTGTAGTGGTGGTAGGCATGGACGTCTGG	CAKDRGEADIVVVVGMDVW	IGHV3-NL1	IGHJ6
TGTGCGAGAGGACTATATAGTGGCTACGATTGGCGAGGCGTCTACTGG	CARGLYSGYDWRGVYW	IGHV1-69	IGHJ4
TGTGCGAGTAGGTTTAGCGGATATTGTAGTAGTACCAGCTGCAACTGCGGGGGCTACTACTACTACTACATGGACGTCTGG	CASRFSGYCSSTSCNCGGYYYYYMDVW	IGHV7-4-1	IGHJ6
TGTGCACACAGACATTTGATTTTTGGAGTGGTTATGAGCGGTTTTGGGTACTACTTTGACTACTGG	CAHRHLIFGVVMSGFGYYFDYW	IGHV2-5	IGHJ4
TGTGCAAAAGATAGAAGGTATAGCAGTGGCTGGTACCACTTTGACTACTGG	CAKDRRYSSGWYHFDYW	IGHV3-43D	IGHJ4
TGTGCGAGAGATGGGGGTGGTAGCTGCTTTTCCGTCGTGTTATCAAAAACGAGCACGTACAACTGGTTCGACCCCTGG	CARDGGGSCFSVVLSKTSTYNWFDPW	IGHV3-66	IGHJ5
TGTGCGAAAGATCGGGTATTACGATTTTTGGAGTGGTTATTATGGAAGTACTTTGACTACTGG	CAKDRVLRFLEWLLWKYFDYW	IGHV3-NL1	IGHJ4
TGTGCGAGGCCCAAGTGCCCCCGTTGTAGTAGTACCAGCTGCTTAGGGTTTGACTACTGG	CARPKCPRCSSTSCLGFDYW	IGHV3-30	IGHJ4
TGTGCGAGAGATCCTCCGATGCCGTTTGACTACTGG	CARDPPMPFDYW	IGHV3-11	IGHJ4
TGTGCGTCCTCAAATAACGCCAACTGGAACTACAAGTGCGAGGCCGTCCCCCCGTGGCTGGTCCCGTACTACTTTGACTACTGG	CASSNNANWNYKCEAVPPWLVPYYFDYW	IGHV3-30	IGHJ4
TGTGCGAGACTGAGCGTGGCTGCTACTCAAAAGGCCCGAAACTACTTTGACTACTGG	CARLSVAATQKARNYFDYW	IGHV1-3	IGHJ4
TGTGCGAGAGGGGCCCCCCTACTACTATGGTTCAGGGAGCGGGGGGCCCCCCGCGTGTACAACTGGTTCGACCCCTGG	CARGAPLLLWFRERGAPRVYNWFDPW	IGHV4-34	IGHJ5
TGTGCGAAAAACATGCTTACCCCAAAATGTGGCGACTACTACTACTACATGGACGTCTGG	CAKNMLTPKCGDYYYYMDVW	IGHV3-23	IGHJ6
TGTGCGAGAGGGACGGTGACGAGGACCGCGGTCTACTTTGACTACTGG	CARGTVTRTAVYFDYW	IGHV3-53	IGHJ4
TGTGCGAGATTACCCTGGAAATCCCAGAGATTGACTACAGTAACGCACTGG	CARLPWKSQRLTTVTHW	IGHV5-10-1	IGHJ4
