TGTGCGAGAAGGCCTTTCGTAGCAGCAGCTGGTCGGTTCGACCCCTGG	CARRPFVAAAGRFDPW	IGHV1-3	IGHJ5
TGTGCACGGATGGACCCCCCACTATATTGTGGTGGTGACTGGGATTTCCACTTTGACTACTGG	CARMDPPLYCGGDWDFHFDYW	IGHV2-26	IGHJ4
TGTGCGAAAGAGGCCGGAACTATTGTGGTGGTGACTGCGGTTGACGGGTCCCTGTACGTTAACTTTGACTACTGG	CAKEAGTIVVVTAVDGSLYVNFDYW	IGHV3-23	IGHJ4
TGTGCGAAAGATTTACTACTTCGGGATAGCAGCAGCTGGTACGACCCGGTCTACTACTACTACTACATGGACGTCTGG	CAKDLLLRDSSSWYDPVYYYYYMDVW	IGHV3-NL1	IGHJ6
TGTGCGATCCTGAGACTGACTACGTGGATACAGCTATGGTTGCCAGAAGACTACTGG	CAILRLTTWIQLWLPEDYW	IGHV3-NL1	IGHJ4
TGTGCACGGATCATTCCTACTATGATAGTAGTGGTTATTAAGAGGACATCCACGTTACACTTTGACTACTGG	CARIIPTMIVVVIKRTSTLHFDYW	IGHV2-26	IGHJ4
TGTACCACAGTCCTAGATATTGTAGTAGTACCAGCTGCTATCTGGGCCTCTCTGAGTTGGCTCGGTGATTTCTACTACTACTACATGGACGTCTGG	CTTVLDIVVVPAAIWASLSWLGDFYYYYMDVW	IGHV3-15	IGHJ6
TGTGCACGGATACCCTTTCTCTATATTGTAGTAGTACCAGGGCCCTACTGG	CARIPFLYIVVVPGPYW	IGHV2-26	IGHJ4
TGTGCGAGATGGCCGCAGCAGCTGGTGGTACTCGATGGATGCGCCCCCCCGTTTGACTACTGG	CARWPQQLVVLDGCAPPFDYW	IGHV3-53	IGHJ4
TGTGCGAGAGATCGAGGGGGGGTCGCGCAGTGGCTGGTACCACTCGCGGGTGCCGAAGAGCGCACGGACTACTGG	CARDRGGVAQWLVPLAGAEERTDYW	IGHV3-33	IGHJ4
TGTGCGAGAAACACCTATAATACGGTGACTACCTACTGG	CARNTYNTVTTYW	IGHV4-38-2	IGHJ4
TGTGCACACAGACTGGCAAATTACTATGGTTCGGGGAGTTTGTTCCCTCTGTGGTACTTCGATCTCTGG	CAHRLANYYGSGSLFPLWYFDLW	IGHV2-5	IGHJ2
TGTGCGAGAATCATGATTTTTGGAGTGACCACCTACTACTACTACATGGACGTCTGG	CARIMIFGVTTYYYYMDVW	IGHV1-18	IGHJ6
TGTGCGAAAAGAGATTTTTGGAGTGGTAGATACTACTACTACTACATGGACGTCTGG	CAKRDFWSGRYYYYYMDVW	IGHV3-23	IGHJ6
TGTGCGAGAGATCCTAACAGGTATGGTTCGGGGAGTTATTTAGACCAACGCACGAGAAGGGTTCCTGACTACTGG	CARDPNRYGSGSYLDQRTRRVPDYW	IGHV3-11	IGHJ4
TGTGCGAAAGGGAACGTAACTCCGGTTTACTTTGACTACTGG	CAKGNVTPVYFDYW	IGHV3-NL1	IGHJ4
TGTGCGAGAGAAAGGGAAGTACAACGATTTTTGGAGTGGTTATTATACCACAACTGGTTCGACCCCTGG	CAREREVQRFLEWLLYHNWFDPW	IGHV1-46	IGHJ5
TGTGCACACCTCTGCTACCTACATTGTAGTAGTACCAGCTGCTATCCTGGGGAAGTTGACTACTGG	CAHLCYLHCSSTSCYPGEVDYW	IGHV2-5	IGHJ4
TGTGCGAGATGGGCCCAGCGCACCGTCGTTCCGTACGTCCCCCCGTTTGACTACTGG	CARWAQRTVVPYVPPFDYW	IGHV3-53	IGHJ4
TGTGCGAGAGATCCTAGGACCCTAGGATATTGTAGTGGTGGCTTATGGCATCTGTACAACTGGTTCGACCCCTGG	CARDPRTLGYCSGGLWHLYNWFDPW	IGHV1-2	IGHJ5
TGTGCGAGAGAACCAAAGGGGATCCGACGATTTTTGGAGTGGTTATTAGAAGATTACTACTACTACTACTACATGGACGTCTGG	CAREPKGIRRFLEWLLEDYYYYYYMDVW	IGHV1-3	IGHJ6
TGTGCGAGAGATTCGAGTTGGATTGTAGTAGTACCAGCTGCTATATCTGAACTCGACTGGTTCGACCCCTGG	CARDSSWIVVVPAAISELDWFDPW	IGHV3-11	IGHJ5
TGTGCAAGAGATGGATATCGAGCAGCAGCTGGAGCATACTTTGACTACTGG	CARDGYRAAAGAYFDYW	IGHV3-74	IGHJ4
TGTGCAAGAGATAAGGTAGCAGCTCGTCCAAAAAACTGG	CARDKVAARPKNW	IGHV3-13	IGHJ4
TGTGCGAGAGTTATAGCAGTGGCTGGTACGGTGTTCGGAAAGTACTACTACTACATGGACGTCTGG	CARVIAVAGTVFGKYYYYMDVW	IGHV1-46	IGHJ6
TGTGCGAGAGAGCCGAAGGCTATGGTTCAGGGAGTTACTCGGGATTTCAATACCTTCGACTGGTTCGACCCCTGG	CAREPKAMVQGVTRDFNTFDWFDPW	IGHV5-10-1	IGHJ5
TGTGCTAGCCCCGAAGATGCCCGGATGGCTACCCGCCCCCCCCTCAGGGGACTAGACTACTGG	CASPEDARMATRPPLRGLDYW	IGHV3-72	IGHJ4
TGTGCGAGTTACCGGAGACATCTAGGATATTGTAGTAGTACCAGCTGCTATAAGAAGGTTGACTACTGG	CASYRRHLGYCSSTSCYKKVDYW	IGHV1-2	IGHJ4
TGTGCGAAAGATCCCTTCCCTACGGGGCTAAGGGGTATTACGATTTTTGCCAACCTTTGGGCATCCCACTACTACTACTACTACATGGACGTCTGG	CAKDPFPTGLRGITIFANLWASHYYYYYMDVW	IGHV3-NL1	IGHJ6
TGTGCGAGAGATCGGCAGTTACTATGGTTCAGGGAGTTATTAGACCCCTTTGACTACTGG	CARDRQLLWFRELLDPFDYW	IGHV1-46	IGHJ4
TGTGCGAGAGATGGCGAACCAGGACTACGGTCCGATGCTTTTGATATCTGG	CARDGEPGLRSDAFDIW	IGHV4-4	IGHJ3
TGTGCGAGAGAGGGATTCCAATTACGATTTTTGGAGTACCGGTTCTCCTACTGG	CAREGFQLRFLEYRFSYW	IGHV3-7	IGHJ4
TGTGCGAGTGGGAGGGTCCTTATGATTACATTTGGGGGAGTTATCGTTCCCCCCCGTGGGAAGTACTACTTTGACTACTGG	CASGRVLMITFGGVIVPPRGKYYFDYW	IGHV1-2	IGHJ4
TGTGCACACTGGATGGCTACAATTTACTGGTACTGG	CAHWMATIYWYW	IGHV2-5	IGHJ4
TGTGCGAAAGACAGGCTATATAGCAGTGGCTGGTACAGGAGGTGTTACTTTGACTACTGG	CAKDRLYSSGWYRRCYFDYW	IGHV3-23	IGHJ4
TGTGCGAAAGAGATCCAACTTATTTTGAGGTCTTGGTGCAAGGTAGGCTACATTAACTGGTTCGACCCCTGG	CAKEIQLILRSWCKVGYINWFDPW	IGHV3-23	IGHJ5
TGTGCGAGAGGCCATGGAGATAGTAGTGGTTGCTGGTTCGACCCCTGG	CARGHGDSSGCWFDPW	IGHV4-34	IGHJ5
TGTGCGAGAGAGACCGAGGGTGTAGTGGTGGTAGCTGCTGAATGGGGATGGGTAAGCGGAACGAGCTACTACTACTACATGGACGTCTGG	CARETEGVVVVAAEWGWVSGTSYYYYMDVW	IGHV1-3	IGHJ6
TGTGCGAGAGAGGCAGGGTTTAGTGGTGGTAGCTGCTACGTTGATCTCTGG	CAREAGFSGGSCYVDLW	IGHV4-34	IGHJ2
TGTGCGAGAGACGGTTGTAGTGGTGGTAGCTGCTACTCCGCGGCCCGTCCGGGCTTTGACTACTGG	CARDGCSGGSCYSAARPGFDYW	IGHV3-11	IGHJ4
TGTGCAACAGACTCCACGTATTACTATGATAGTAGTGGTTATTCCGGAGGTGGTCACGCTTTTGACTACTGG	CATDSTYYYDSSGYSGGGHAFDYW	IGHV1-24	IGHJ4
TGTGCGGGTTGTGCGCGGGTTATGACTACGGTGAACCACTGGTACTTCGATCTCTGG	CAGCARVMTTVNHWYFDLW	IGHV3-23	IGHJ2
TGTGCGAGAGGAGGGCCCCCTAACTCTGGCAGTTCCGGGACGTATTACTATGGTTCAGGGAGTTATCCCCGCTTCAATAGGAACTGGTTCGACCCCTGG	CARGGPPNSGSSGTYYYGSGSYPRFNRNWFDPW	IGHV1-3	IGHJ5
TGTGCGGGCCCTACGTTTGGGGGAGTTATCGTTCCGCCCCCGTTTGACTACTGG	CAGPTFGGVIVPPPFDYW	IGHV3-11	IGHJ4
TGTGCGAATCTTTCCCCTACAGCTATGGTTAGAGACTACTGG	CANLSPTAMVRDYW	IGHV3-7	IGHJ4
TGTGCGAGACCGGCTACTATGGTTCGGGGAGTTATTTTTAGTCGCCACCAGACGAACCAAGGGGATGATGCTTTTGATATCTGG	CARPATMVRGVIFSRHQTNQGDDAFDIW	IGHV5-51	IGHJ3
TGTGCGAGGTGCGGATACAGCTATGGTTTGGCGAGGACCCAGTACTACTACTACTACTACATGGACGTCTGG	CARCGYSYGLARTQYYYYYYMDVW	IGHV3-11	IGHJ6
TGTGCGAGAGGCGGGGGGGTGTTCGGTTCGGGGAGTTATCGTCTCCGCTTTTTTGACTACTGG	CARGGGVFGSGSYRLRFFDYW	IGHV4-34	IGHJ4
TGTGCGAGCAAAGATCGTAGTAGTACCAGCTGCTGGCCCTTGCGGCACTCATTCTACTTTGACTACTGG	CASKDRSSTSCWPLRHSFYFDYW	IGHV1-3	IGHJ4
TGTGCACGGATAGGGCAAATGTGTGACTGCTGCCCGCCCACCGGAACCGATTGGGAGTTTCATGGCCCCGATCTCTGG	CARIGQMCDCCPPTGTDWEFHGPDLW	IGHV2-70	IGHJ2
TGTGCGAGGAGGGAGGGTATAGCAGCAGCTGGTACTACCTTTGACTACTGG	CARREGIAAAGTTFDYW	IGHV4-34	IGHJ4
TGTGCGAAAGCGGTGAGTATAGCAGCTCGTCACGGCCACCGTAGCTTTGACTACTGG	CAKAVSIAARHGHRSFDYW	IGHV3-NL1	IGHJ4
TGTACCACTATTAAAACTATGATAGTAGTGGTTATGGCAGACTGGTTCGACCCCTGG	CTTIKTMIVVVMADWFDPW	IGHV3-49	IGHJ5
TGTGCAATAGCACTGGATATTGTAGTAGTACCAGCTTTAACCCACTACTACTACTACTACATGGACGTCTGG	CAIALDIVVVPALTHYYYYYMDVW	IGHV3-13	IGHJ6
TGTGCGAGTGTTTATAGCAGTGGCTGCCAGCGGTTGGTTGACTACTGG	CASVYSSGCQRLVDYW	IGHV1-18	IGHJ4
TGTGCGAGAGATCGGGGGAACCGGGGGCGACTTATTGTAGTAGTACCAGCTGCAGTACCTAAATTTGACTACTGG	CARDRGNRGRLIVVVPAAVPKFDYW	IGHV1-2	IGHJ4
TGTGCGAGAGATTTGACCTGTATAGCAGCAGCTGGTTTCCCGTTTGATGCTTTTGATATCTGG	CARDLTCIAAAGFPFDAFDIW	IGHV1-18	IGHJ3
TGTGCGAGGGATATTGTAGTAGTACCAGCTGCTATACGTCCGGTCGGAAGCCACTTTGACTACTGG	CARDIVVVPAAIRPVGSHFDYW	IGHV1-46	IGHJ4
TGTGCGAGATTCTTTTTGACCTTTGGAGGTGTTAGGTCCGGGAGGCCCGTTACGATTTTTGGAGTGGTTATTCTCTACTGG	CARFFLTFGGVRSGRPVTIFGVVILYW	IGHV3-11	IGHJ4
TGTGCGAGAGTCTCGTCCCCTCTTTCGTATTACGATTTTTGGAGTGGTTATTATCTGACGTGTGGGCTATACTTTGACTACTGG	CARVSSPLSYYDFWSGYYLTCGLYFDYW	IGHV4-61	IGHJ4
TGTGCGAGAACGGGGTATAGCAGTGGCTGGTACCGAACATGTCACTTTGACTACTGG	CARTGYSSGWYRTCHFDYW	IGHV3-11	IGHJ4
TGTGCGAGGCAACCGATGATAGTAGTGGTTATTACCGATATTCTGGAGTACCCGTTTGGCCGGGGGAAAGGTGACTACTGG	CARQPMIVVVITDILEYPFGRGKGDYW	IGHV4-59	IGHJ4
TGTGGAGTGCCCCGTGGTAGCAGCCTGATCGGGGCTTTTGATATCTGG	CGVPRGSSLIGAFDIW	IGHV1-2	IGHJ3
TGTGCGAGTTCCCGCGCCCGTATTACGATTTTTGGAGTGGTTATTATCGAACGACCCCACTACTACTACTACTACATGGACGTCTGG	CASSRARITIFGVVIIERPHYYYYYMDVW	IGHV4-34	IGHJ6
TGTGCGAGAGCTGGGAAGGTCTATTACGATTTTTGGAGTGGTGTGGCCCCTGGGGGCCTTGACTACTGG	CARAGKVYYDFWSGVAPGGLDYW	IGHV1-2	IGHJ4
TGTGCGAGACCGGAGTCTCGAAAATCCCTTCACTTTGACTACTGG	CARPESRKSLHFDYW	IGHV5-51	IGHJ4
TGTGCACTAGAGCGGTATAACTGGAACGACGTGGGCTACTGG	CALERYNWNDVGYW	IGHV2-26	IGHJ4
TGTGCACACAGACGGTTACGGCTTATAGCAGCTCGTCCCCCCCTGGTTGACTACTGG	CAHRRLRLIAARPPLVDYW	IGHV2-5	IGHJ4
TGTGCGAGACAGGGCCCGTGGGCCACAAGCAGCAGCTGGTACCCGGGGGTACTTGTAGTTAAACCCTTTGACTACTGG	CARQGPWATSSSWYPGVLVVKPFDYW	IGHV5-51	IGHJ4
TGTGACGGGGCCGCTTGTAGTAGTACCAGCTGCTATGCCGAACTAAGATTTCGCTTACAAGACTACTGG	CDGAACSSTSCYAELRFRLQDYW	IGHV3-30	IGHJ4
TGTGCAAAGACCAAAGCGGTTTTCGATATTATCCAAAATGACTACAGTAACTACGGTTGGTTCGACCCCTGG	CAKTKAVFDIIQNDYSNYGWFDPW	IGHV3-43	IGHJ5
TGTGCGAGAGGGAAGGAGGCGCTGGTTCGGGAAAAGCTCTTTGACTACTGG	CARGKEALVREKLFDYW	IGHV3-20	IGHJ4
TGTGCGAGAGCGGTGTATCCGGATATTGTAGTGGTGGTAGCTGCTATGCCTCAAGGCTACTGG	CARAVYPDIVVVVAAMPQGYW	IGHV3-11	IGHJ4
TGTACTAGAGATCGTCCCCCTAACGTATTACTATGGTTCAGGGAGTTCGCATACTACTACTACTACTACATGGACGTCTGG	CTRDRPPNVLLWFREFAYYYYYYMDVW	IGHV3-49	IGHJ6
TGTGCGAAGAGTAGTGATTACGCCGAACGTCACCGGAAGAGAAATAGCAGCAGCTGGAATCACCCGGGCTACTGG	CAKSSDYAERHRKRNSSSWNHPGYW	IGHV4-34	IGHJ4
TGTGCGAGGAGCAGAGTGATTTTGACTGGTTATTATGGAAAGTACTACTTTGACTACTGG	CARSRVILTGYYGKYYFDYW	IGHV3-21	IGHJ4
TGTGCACGGATCCAGGATACAGCTATGGAGGATGACTACTGG	CARIQDTAMEDDYW	IGHV2-26	IGHJ4
TGTGCGAGAGCCGATTGCCCTCGATATAGTGGCTACGAGCCGTCATTTGACTACTGG	CARADCPRYSGYEPSFDYW	IGHV1-69	IGHJ4
TGTGCGAGAGATCCGTTAAATAGCAGTGGCTGGGGTCCGTACTACTTTGACTACTGG	CARDPLNSSGWGPYYFDYW	IGHV4-61	IGHJ4
TGCTGGATACAGCTATGGTTACCGGCCAATGTAATCCTGAACGCTCAGGGCTACTTTGACTACTGG	CWIQLWLPANVILNAQGYFDYW	IGHV4-39	IGHJ4
TGTGCGAAAGATATAGTGGTGGTAGCTGCTACTGATTGGTACTACTACTACTACATGGACGTCTGG	CAKDIVVVAATDWYYYYYMDVW	IGHV3-NL1	IGHJ6
TGTACTAGAGCCCTACCAGCTGCTATGAGTAATGACTACTGG	CTRALPAAMSNDYW	IGHV3-49	IGHJ4
TGTGCGAGAATACAAGGACGTCCCGTCTGGTTCGACCCCTGG	CARIQGRPVWFDPW	IGHV1-46	IGHJ5
TGTGCGAAAGATCGTAAAAAGAATTACGATTTTTGGAGTGGTCCGAGGTCATTTGGATTCGACCCCTGG	CAKDRKKNYDFWSGPRSFGFDPW	IGHV3-23	IGHJ5
TGTGCGAGCCCAGAAACCCAGGGGGGGCTTGCCCCCTACGGTGACTACGTCCTGAGGTTGTTCTACTACTACTACTACATGGACGTCTGG	CASPETQGGLAPYGDYVLRLFYYYYYMDVW	IGHV1-2	IGHJ6
TGTGCAAGAGATCTCCCCGGCCACAGCAGCTGGTACCCCTGGTTCGACCCCTGG	CARDLPGHSSWYPWFDPW	IGHV3-13	IGHJ5
TGTGCGAGACCAGGAGTGGTTATTATAAACGGTCGGACTCCAAGATCTCGACGTGACTACTGG	CARPGVVIINGRTPRSRRDYW	IGHV1-46	IGHJ4
TGTGCGAGAGATAGTCGGGATTCCACTACGGTGACTACGTCGAGGTGGGTGAATGATGCTTTTGATATCTGG	CARDSRDSTTVTTSRWVNDAFDIW	IGHV3-11	IGHJ3
TGTGCGAGAGGCTATCGTCTTAGGCCCAGCTGCTGGACTGGGGACTGGTTCGACCCCTGG	CARGYRLRPSCWTGDWFDPW	IGHV4-34	IGHJ5
TGTGCGAGAGACCTCCACCCCGACGGAACGACGGAGGGGTTCGACCCCTGG	CARDLHPDGTTEGFDPW	IGHV3-7	IGHJ5
TGTGCGAGAGATAACCGTCGTATTGTAGTGGTGGTAGCTGCTCTCTTCCCGTTTGACTACTGG	CARDNRRIVVVVAALFPFDYW	IGHV3-21	IGHJ4
TGTGCGAGTACTAGGGGAATTGGAGTGGTTTTGGGCGGGGTTGACTACTGG	CASTRGIGVVLGGVDYW	IGHV1-69	IGHJ4
TGTGCGAGAGAGGATTTAGCAGTGGCTGGGCAAAAAAAGTTCTACTACTTTGACTACTGG	CAREDLAVAGQKKFYYFDYW	IGHV4-4	IGHJ4
TGTGCGAGAGATCGTCTAGGGCATGCTACGGTGACTACTGTAGAAAAACTTGACTACTGG	CARDRLGHATVTTVEKLDYW	IGHV1-18	IGHJ4
TGTGCGAAAGATCGAGGATTATTACGATATTTTGACTGGCCCATTCTGGTGTACTACTACTACTACTACATGGACGTCTGG	CAKDRGLLRYFDWPILVYYYYYYMDVW	IGHV3-23	IGHJ6
TGTGCGAGAAAAGGGGGTGGCTGGTACGTAGGAGGGTTCCAGCACTGG	CARKGGGWYVGGFQHW	IGHV4-59	IGHJ1
TGTGCGAGAGTTGTCGGACAACGACGTAGCTGCTACTCCTTTGCTTTTGATATCTGG	CARVVGQRRSCYSFAFDIW	IGHV4-38-2	IGHJ3
TGTGCGAAAGGGGGGCATCTCAGTGGCGAAAATGACTACTGG	CAKGGHLSGENDYW	IGHV3-23	IGHJ4
TGTGCGAAAGAAGGGGGAGGAACGTATTACTATGATAGTAGTGGTTATTATTGTTACTGG	CAKEGGGTYYYDSSGYYCYW	IGHV3-23	IGHJ4
TGTGCGAAAGACTCCATCTATTCCGCAATCAAGTTCGGACTGTCGGAGGACTACTGG	CAKDSIYSAIKFGLSEDYW	IGHV3-23	IGHJ4
