TGTGCGAGGGACCGGGCTACAGGTGCTTACGATTTTTGGAGTGGTTATTATACCAGAATCGACTACTGG	CARDRATGAYDFWSGYYTRIDYW	IGHV3-21	IGHJ4
TGTGGAAGTATATATTACGATATTTTGACTGGTTATTATAATCTGTACTACTTTGACTACTGG	CGSIYYDILTGYYNLYYFDYW	IGHV3-30	IGHJ4
TGTGCACGGAGGTACCCTATTACTATGGTTCAGGGAGGTACGCTTTACAACTGGTTCGACCCCTGG	CARRYPITMVQGGTLYNWFDPW	IGHV2-26	IGHJ5
TGTGCGAGAGATCAGTACTGGTGGTGTATGTGCTGGTTCGACCCCTGG	CARDQYWWCMCWFDPW	IGHV3-48	IGHJ5
TGTGCGAGAGGGCGCCCCGTGACGGCGAGGTTCCATAGAGGCACGATTTTTGGAGTGGAAGAACCTACCTACTGG	CARGRPVTARFHRGTIFGVEEPTYW	IGHV1-2	IGHJ4
TGTGCGAGAGGGATCCTATGGTTCAGGGAGTTATTATTTACCCCTCCAAAAGGCGCATTTGACTACTGG	CARGILWFRELLFTPPKGAFDYW	IGHV3-53	IGHJ4
TGTGCGAGATTTGAACCCCATTACTATGATAGTAGTGGCGAAGACTTTGACTACTGG	CARFEPHYYDSSGEDFDYW	IGHV1-3	IGHJ4
TGTGCGAGAGATCGGCCCCACCCGCCGCGATTACATTTGGGGGAGTTATCGGTTCACCGGGACTACTGG	CARDRPHPPRLHLGELSVHRDYW	IGHV3-11	IGHJ4
TGTGCAAGAGATAACGTCTGTTATTGTAGTAGTGGGACGGGGTTCGACCCCTGG	CARDNVCYCSSGTGFDPW	IGHV3-13	IGHJ5
TGTGCGAGCCCCGAAGTCGCGTTTCCATATTGTAGTAGTACCAGCTGCTATAACCCGGGAAGGTTGGACAACTGGTTCGACCCCTGG	CASPEVAFPYCSSTSCYNPGRLDNWFDPW	IGHV3-7	IGHJ5
TGTGCGAAAGATCCAACGCGCTCAGTAGCAGTGGCTGGTACCTATGACTACTGG	CAKDPTRSVAVAGTYDYW	IGHV3-23	IGHJ4
TGTGCGGGGGACTCTGGCTATGGCCCTCTATTAACTGGGCGATACTACTTTGACTACTGG	CAGDSGYGPLLTGRYYFDYW	IGHV3-30-3	IGHJ4
TGTGCGAACTCTTATCCGGGTATAGCAGTGGCTGCTCGGTTCGACCCCTGG	CANSYPGIAVAARFDPW	IGHV4-59	IGHJ5
TGTGCGAGAGCCTATCCAGTAGAGGGATATTGTAGTGGTGGTAGCTGCTACAGCCCTAATGACTACTGG	CARAYPVEGYCSGGSCYSPNDYW	IGHV1-18	IGHJ4
TGTATCATAGCAGTGGCTGGCGCCTGGGCCAGGAATTTGTTTGACTACTGG	CIIAVAGAWARNLFDYW	IGHV4-59	IGHJ4
TGTGCGAAAGATCATGTAGGTGTAGTAGTACCAGCTGCTAGTCGGGGACGACGGTTTTTTTTGTTTACCCTATACTACTACTACTACATGGACGTCTGG	CAKDHVGVVVPAASRGRRFFLFTLYYYYYMDVW	IGHV3-23	IGHJ6
TGTGCGAGAGTTCTAGCAGCTCCCCAATTTGATATCTGG	CARVLAAPQFDIW	IGHV3-20	IGHJ3
TGTGCACGGATGCCTATTGTAGTGGTGGTAGCTGCTACTAACCACTACTACTACATGGACGTCTGG	CARMPIVVVVAATNHYYYMDVW	IGHV2-70	IGHJ6
TGTGCGAGGCCTAAGATCTATTGTAGTGGTGGTAGCTGCCTATTTGTTGACTACTGG	CARPKIYCSGGSCLFVDYW	IGHV1-69	IGHJ4
TGTGCAAGAGATACTAACTCGATGCATATTGTGGTGGTGACTGCTATTCGAAGTACATCGTCCGTCTACTACATGGACGTCTGG	CARDTNSMHIVVVTAIRSTSSVYYMDVW	IGHV3-13	IGHJ6
TGTGCGAGTGCCGGGGGACCACTTATTACGATTTTTGGAGTGGTTCTGCCGAACTGGTTCGACCCCTGG	CASAGGPLITIFGVVLPNWFDPW	IGHV1-18	IGHJ5
TGTGCGAACGCCGGGGCAACGATTTTTGGAGTGGTTATTATATCAAGGCCCTACTTCCAGCACTGG	CANAGATIFGVVIISRPYFQHW	IGHV3-NL1	IGHJ1
TGTGCGCTGCGTAGCTGCTACGTGGTGTGCTACTACTACTACATGGACGTCTGG	CALRSCYVVCYYYYMDVW	IGHV3-30-3	IGHJ6
TGTGCGAGAGATATGGAGGCTTGTACGATTTTTGGAGTGGTTATTATACGAGACTACTTTGACTACTGG	CARDMEACTIFGVVIIRDYFDYW	IGHV4-59	IGHJ4
TGTGCGAAAGATCTCTGGGGGTATAGCAGCAGCTGGTACCTGGTCGTAAATGCCGGGACTGGCCCCATTTACTGG	CAKDLWGYSSSWYLVVNAGTGPIYW	IGHV3-NL1	IGHJ4
TGTGAGCAGCTGTGGATAGGCTACTACTACTACTACTACATGGACGTCTGG	CEQLWIGYYYYYYMDVW	IGHV5-51	IGHJ6
TGTGCTCTGGGGAGTATTACGATTTTTGGAGTGGTTATTATAAGGACGCTGTCCTTCTGG	CALGSITIFGVVIIRTLSFW	IGHV5-10-1	IGHJ5
TGTGCGAGAGATCATGTGTATTACGATTTTTGGAGTGGTCAGGGCCAAGTAGACTACTACTACTACTACATGGACGTCTGG	CARDHVYYDFWSGQGQVDYYYYYMDVW	IGHV3-20	IGHJ6
TGTGCAAGAGCCATTTGGACCAGCCAAGGATCGAGTATAGCAGCTCGACTTACTGACTACTGG	CARAIWTSQGSSIAARLTDYW	IGHV3-74	IGHJ4
TGTGCGAGACCTGTCTATGGTTCAGGGAGTTATGTTGCGAGGCACTACTACTACTACATGGACGTCTGG	CARPVYGSGSYVARHYYYYMDVW	IGHV4-38-2	IGHJ6
TGTGCGAGAGATCCGGTATCACCGGGGGGAGGTCATCCCGCTCCCTTGTATTACTATGATAGTAGTGGTTATTGGTTACCAAAGGAACCCTACTGG	CARDPVSPGGGHPAPLYYYDSSGYWLPKEPYW	IGHV3-48	IGHJ4
TGTGCGAGAGCATGGCTTTATGTACTGGTGGTGTATGCTAGCGGGGTCCCGGGGTACTACTACTACTACTACATGGACGTCTGG	CARAWLYVLVVYASGVPGYYYYYYMDVW	IGHV4-38-2	IGHJ6
TGTGCGAAAGACATGGGCACGGCTGATATGGAGGTTAGATTGAACCCCCCCAAGAGTTTTCCGCCCTTTGACTACTGG	CAKDMGTADMEVRLNPPKSFPPFDYW	IGHV3-NL1	IGHJ4
TGTGCGAGAACGGTCCTTCCGACGGCCTGTTACGATATTTTGACTGGTGTGGGCTACTGGTACTTCGATCTCTGG	CARTVLPTACYDILTGVGYWYFDLW	IGHV4-61	IGHJ2
TGTGCGAGAGAAGTCCGAATACAGCTATGGTTCTCTCAGACAGGGTACTACTACTACTACTACATGGACGTCTGG	CAREVRIQLWFSQTGYYYYYYMDVW	IGHV3-11	IGHJ6
TGTGCGAGAGATCCCAACTGGAACGACTTGACAAGGTTTTTCTACTACTACTACTACATGGACGTCTGG	CARDPNWNDLTRFFYYYYYMDVW	IGHV3-20	IGHJ6
TGTGCAAGAGATCCGCCACGGAAGTGTTGCGGAATCGGTTGTCCTGGGGGAGCTACCCCCACGATTAGAAGCAGCCTGGACTACTGG	CARDPPRKCCGIGCPGGATPTIRSSLDYW	IGHV6-1	IGHJ4
TGTGCGAAAATAGGTATAGCAGTGGCTGGTAAGGACCTAGGGGGTGACTACTGG	CAKIGIAVAGKDLGGDYW	IGHV3-NL1	IGHJ4
TGTGCAACAGCAGCAGAGCTCGGTGGCTACTACTTTGACTACTGG	CATAAELGGYYFDYW	IGHV1-24	IGHJ4
TGTGCGAGAGAGGAGAAACTGGTGGTGTATGCAGCCTACTACTACTACTACATGGACGTCTGG	CAREEKLVVYAAYYYYYMDVW	IGHV3-20	IGHJ6
TGTGCGAAAGCGGCTTGGGAAAGAGCAGTGGCTGTCTCGTACTACTTTGACTACTGG	CAKAAWERAVAVSYYFDYW	IGHV3-23	IGHJ4
TGTGCGAGACACCCTCAACATGACTACGGTGACTACGGGTACTGGTACTTCGATCTCTGG	CARHPQHDYGDYGYWYFDLW	IGHV4-39	IGHJ2
TGTGCGAGAGAAAGAGCCTCTCAGTGGACTATGGTTCAGGGAGTTATTAACTACGAATACTACTACTACTACTACATGGACGTCTGG	CARERASQWTMVQGVINYEYYYYYYMDVW	IGHV1-46	IGHJ6
TGTGCGAGAGAACGTTATTACGATTTTTGTGAGGCCTACTGG	CARERYYDFCEAYW	IGHV1-18	IGHJ4
TGTGCGAGCTGGGGGCGGTATTACTATGGTTCAGGGAGTCTCGCGGCTTTTGATATCTGG	CASWGRYYYGSGSLAAFDIW	IGHV3-7	IGHJ3
TGTGCGAGAGGGGCTCTAAAAGATATTGTAGTGGTGGTAGCTGCTACGAAACACATTGACTACTGG	CARGALKDIVVVVAATKHIDYW	IGHV3-7	IGHJ4
TGTGCGAGAGGCCCCAGATACGATTTTTGGAGTGGTTATTATACCGACTACTACTACTACATGGACGTCTGG	CARGPRYDFWSGYYTDYYYYMDVW	IGHV4-59	IGHJ6
TGTGCGAGACCCCTTAATCGATTCGGACCCCCCAGTATTACTATGATAGTAGTGGTTACCCCCTACTGG	CARPLNRFGPPSITMIVVVTPYW	IGHV3-7	IGHJ4
TGTACTAGCGGCAGGGGTGGTAGCTGCTACGGTGTCGGAGTCACCCGGGGCTACTACTTTGACTACTGG	CTSGRGGSCYGVGVTRGYYFDYW	IGHV3-49	IGHJ4
TGTGCGAGAGATCATTATGATTACATTTGGGGGAGTTATCGTAGGAAGGAATGCTACTACTACTACTACATGGACGTCTGG	CARDHYDYIWGSYRRKECYYYYYMDVW	IGHV4-59	IGHJ6
TGTGCACACAGCGCCCATAGTGGGAGCTATTATCTATTAGGGGCGGACTTTGACTACTGG	CAHSAHSGSYYLLGADFDYW	IGHV2-5	IGHJ4
TGTGCGAGAGGCTCCAATCAACGAGTTAATTGTAGTAGTACCAGCTGCGACGCGGTCTACTGG	CARGSNQRVNCSSTSCDAVYW	IGHV4-34	IGHJ4
TGTGCGAGAGTAAAAGGGGTTAGCAGCAGCTGCGAGAATACTAGTTGCTTTGACTACTGG	CARVKGVSSSCENTSCFDYW	IGHV1-2	IGHJ4
TGTGCGTACACGCACTTCGTAAATAATTCAGCATGGATACCTCTAACTACGGTGGTAACTTGGTCGTACTGGTACTTCGATCTCTGG	CAYTHFVNNSAWIPLTTVVTWSYWYFDLW	IGHV1-3	IGHJ2
TGTGCGAGCCAGTCCCAAGGCAGTGGCTGGTACCCCCAAGGTCGCTTTGACTACTGG	CASQSQGSGWYPQGRFDYW	IGHV4-4	IGHJ4
TGTGCGAGAGCCCTGCGGAATTTTTGTACTGGTGGTGTATGCGAGGTGTGG	CARALRNFCTGGVCEVW	IGHV3-20	IGHJ5
TGTGCGAGGTCAACGTTGTACTACTACTACTACATGGACGTCTGG	CARSTLYYYYYMDVW	IGHV1-69	IGHJ6
TGTGCGAAAGGGGGTATAGCAGTGGCTGGTACGTCGACGGCCTCTATACCCCGTTTCTCAAGTGACTACTGG	CAKGGIAVAGTSTASIPRFSSDYW	IGHV3-23	IGHJ4
TGTGCGAGAAGCATTGTAGTGGTGGTAGCTGCTACTTCACCTCTTGATGCTTTTGATATCTGG	CARSIVVVVAATSPLDAFDIW	IGHV4-38-2	IGHJ3
TGTGCGAGACTTTTGGAGTGGTTATTATTGGTCCGAATCTACTGG	CARLLEWLLLVRIYW	IGHV4-39	IGHJ4
TGTGCGAGAGATAGGGGTCCGCTTGATTGTAGTGGTGGTAGCTGCTATGTGCAGTACTACTACTACTACATGGACGTCTGG	CARDRGPLDCSGGSCYVQYYYYYMDVW	IGHV1-2	IGHJ6
TGTGCATACCACGATTTTTGGAGTGGTTCGGGTTGCTACTACTACATGGACGTCTGG	CAYHDFWSGSGCYYYMDVW	IGHV1-45	IGHJ6
TGTGCGAGCCTGCAGCTGGTACGCAAGAGCTTTGACTACTGG	CASLQLVRKSFDYW	IGHV4-61	IGHJ4
TGTACTAGAGATCAGGTCTCAATGGACTATGATGCTTTTGATATCTGG	CTRDQVSMDYDAFDIW	IGHV3-49	IGHJ3
TGTGCAAGAGATGGAGATATTGTAGTGGTGGTAGCTGCTACTGTTGACTACTGG	CARDGDIVVVVAATVDYW	IGHV3-13	IGHJ4
TGTGCGAGACCGGACTACAGTAACTACGTTTGTCCCGGTTTCATGGACGTCTGG	CARPDYSNYVCPGFMDVW	IGHV4-39	IGHJ6
TGTGCGAAACGCCAGTGGCTGGGGGCTGATAACATTGGTGACTACTACTACATGGACGTCTGG	CAKRQWLGADNIGDYYYMDVW	IGHV3-23	IGHJ6
TGTGCGAGAGATTCTGATGGTTCGGGGAGTTATCTACATGCTTTTGATATCTGG	CARDSDGSGSYLHAFDIW	IGHV1-69	IGHJ3
TGTGCACGGTTGCGGGTAAACGCCCGGATTACTATGATAGTAGTGGTTATCGGGGACTACTGG	CARLRVNARITMIVVVIGDYW	IGHV2-26	IGHJ4
TGTGCGAGAGATCCCCCCGGAAGAGAGCGAGGTGGGGACCGTCCGATTGACTACTGG	CARDPPGRERGGDRPIDYW	IGHV3-33	IGHJ4
TGTGCGAGACCCTCAATTGGACGTTCGGGGAGTTATTACCTAGGGGTGTCGCTTACCTTTGACTACTGG	CARPSIGRSGSYYLGVSLTFDYW	IGHV5-51	IGHJ4
TGTGCGAAAGATACGGTGACTATAATACACTGGTTCGACCCCTGG	CAKDTVTIIHWFDPW	IGHV3-NL1	IGHJ5
TGTGCGTACGGCCGCTGGCGTGGACTCCGCCAGGGGAGTACCTTTATTACTATGGTTCAGGGAGTTAACGGCTCCAACTCCCACTACTACTACTACATGGACGTCTGG	CAYGRWRGLRQGSTFITMVQGVNGSNSHYYYYMDVW	IGHV3-NL1	IGHJ6
TGTGCAAGAGGGGCATTGGTGACTACAAACTTACTATCCTGG	CARGALVTTNLLSW	IGHV3-74	IGHJ3
TGTGCGAGAGCCGGGGGGGCCTTGAGGTCGCGCTACTACTACTACTACATGGACGTCTGG	CARAGGALRSRYYYYYMDVW	IGHV1-3	IGHJ6
TGTGCGAGAGGGGACCCAGTGGTGGTAGCTGCTATAATGGAAGGTCCTTACTACTACATGGACGTCTGG	CARGDPVVVAAIMEGPYYYMDVW	IGHV3-7	IGHJ6
TGTGCGAAAGATCATAGGAACGGTGACTACGAAACTTTTAACTTTGACTACTGG	CAKDHRNGDYETFNFDYW	IGHV3-NL1	IGHJ4
TGTACCACAGATGTCCAACAAGTCGGTGGTGTATGCAGGAGGGGGGCGCGAACTCGGTACTCCCTTGGACGGGAGGATAACTACTTTGACTACTGG	CTTDVQQVGGVCRRGARTRYSLGREDNYFDYW	IGHV3-15	IGHJ4
TGTGCGACCGCAGATTGTACTAATGGTGTATGCTATGGACCGCCGGTTGGGTCTGAATACTTCCAGCACTGG	CATADCTNGVCYGPPVGSEYFQHW	IGHV3-23	IGHJ1
TGTGCGAGAGATTGTTTGACGCGGAATATTGTAGTGGTGGTAGCTGCTACTGTCTACTACTACTACATGGACGTCTGG	CARDCLTRNIVVVVAATVYYYYMDVW	IGHV3-7	IGHJ6
TGTGCAACAACCTGGCGATGGTTCGGGGAGTTATTGGGGGGGGTTGACTACTGG	CATTWRWFGELLGGVDYW	IGHV1-2	IGHJ4
TGTGCGAGAGAAAGGAGGGTTCAGGGAGTTATTATCTCCAGGGGCGACCCCTGG	CARERRVQGVIISRGDPW	IGHV4-59	IGHJ5
TGTACGGACCGCCCTCCATACGGTGACAAGTACTGGTACTTCGATCTCTGG	CTDRPPYGDKYWYFDLW	IGHV3-9	IGHJ2
TGTGCGAAGTATTACTATGATAGTAGTGGTTATAAGACCGACTACTGG	CAKYYYDSSGYKTDYW	IGHV3-NL1	IGHJ4
TGTGCGAGGGGGCCACCTATAGCAGCAGCTGGCCCATTCATGGACGTCTGG	CARGPPIAAAGPFMDVW	IGHV3-64	IGHJ6
TGTGCGAGACCGCGTTCGGATTATTGTAGTGGTGGTAGCTGCTACCTTGGCCCTTCCGGGCGCAACTGGTTCGACCCCTGG	CARPRSDYCSGGSCYLGPSGRNWFDPW	IGHV3-30	IGHJ5
TGTGCGAAAGATCAGACGTGTTACTGGTACTTCGATCTCTGG	CAKDQTCYWYFDLW	IGHV3-NL1	IGHJ2
TGTGTGCTTAACCGATTTTTGGAGTGGTCCTCCTACTACTACTACTACATGGACGTCTGG	CVLNRFLEWSSYYYYYMDVW	IGHV3-15	IGHJ6
TGTGCGAGAATTAAACCGGCGGATATTGTAGTGGTGGTAGCTGCTACCCTTGACAACTGGTTCGACCCCTGG	CARIKPADIVVVVAATLDNWFDPW	IGHV1-8	IGHJ5
TGTGCGAAAGAAAGTGGTATAGCAGCAGCTGGAAAATACCGATACTTTGACTACTGG	CAKESGIAAAGKYRYFDYW	IGHV3-NL1	IGHJ4
TGTACCACAACCCATATTGTAGTGGTGGTAGCTGCACTAGACTACTACTACATGGACGTCTGG	CTTTHIVVVVAALDYYYMDVW	IGHV3-15	IGHJ6
TGTGCGAAAGATCTAGACTCGGCTACGATAAGCCAATTAGAGAGGGCGGACTACTGG	CAKDLDSATISQLERADYW	IGHV3-NL1	IGHJ4
TGTACTAGAGATTTCAACATTGTAGTAGTACCAGCTGCTATATATCACCCTTACATGGACGTCTGG	CTRDFNIVVVPAAIYHPYMDVW	IGHV3-49	IGHJ6
TGTACTAGACCCAGGACCAGCAGCTCGTGTGACTACTGG	CTRPRTSSSCDYW	IGHV3-73	IGHJ4
TGTGCGAGAGATGAAGGGCCTTGGTGTAGTAGTACCAGCTGCTTGCCGTACTACTACTACTACATGGACGTCTGG	CARDEGPWCSSTSCLPYYYYYMDVW	IGHV3-21	IGHJ6
TGTGCGAAATATAACCGGTTGCCATTGTACTGGTGGTGTATGCTATTCCTCTACTTCTGGTTCGACCCCTGG	CAKYNRLPLYWWCMLFLYFWFDPW	IGHV3-NL1	IGHJ5
TGTGCGAGGTCCAGTAGTGGTGGTAGCTGCTACCAAACGGCACTCTCACGCTGGTTCGACCCCTGG	CARSSSGGSCYQTALSRWFDPW	IGHV5-51	IGHJ5
TGTGCGAGCCCACGTATTACGATTTTTGGAGTGGTTATTATACGGAAAGACTACTACTACTACATGGACGTCTGG	CASPRITIFGVVIIRKDYYYYMDVW	IGHV1-18	IGHJ6
TGTGCGAGAGACCCGCGATTTCTACGTATTGTAGTAGTACCAGCTGCATGGAATTTTTGG	CARDPRFLRIVVVPAAWNFW	IGHV3-21	IGHJ5
TGTGCGAAACCTACAGCAGCTGTGGCGAGTCAGAAGGTCGAAGCGCCCCGCCACTGG	CAKPTAAVASQKVEAPRHW	IGHV3-NL1	IGHJ4
