TGTGCGAGAGGGTGTCTCCCGTGGTACATCAACACTGTTGACTACTGG	CARGCLPWYINTVDYW	IGHV4-59	IGHJ4
TGTGCGAGAGGAGAAATATATTACGATATTTTGACTGTCCTTCAGGGTTACTACTACTACTACTACATGGACGTCTGG	CARGEIYYDILTVLQGYYYYYYMDVW	IGHV5-10-1	IGHJ6
TGTGCGAATTATCGAGGTCACTCGGAAAGACCTTTCCTGGCACAGAGTGTTGGGGGAGCTTTTGATATCTGG	CANYRGHSERPFLAQSVGGAFDIW	IGHV4-59	IGHJ3
TGTGCGAAAGATGTAAGTATAGCAGTGGCTGGTACCGTCCTGTTGGGTTACTGG	CAKDVSIAVAGTVLLGYW	IGHV3-23	IGHJ4
TGTGCGAGAAAGGATATTGTAGTAGTACCAGCTGCTATGGCTGCAACGACCCCCTATTACTACTACTACTACTACATGGACGTCTGG	CARKDIVVVPAAMAATTPYYYYYYYMDVW	IGHV3-64	IGHJ6
TGTGCGAGAGATGTTGCCACGAACGTATTACGATTTTTGGAGTGGTTATTAGAATACTACTACTACTACATGGACGTCTGG	CARDVATNVLRFLEWLLEYYYYYMDVW	IGHV3-21	IGHJ6
TGTGCGAGAGATCCCGAGTGCCCCGGACCTCTCTTAAAGCAGCTCGAGAGTCCCAACTGGTTCGACCCCTGG	CARDPECPGPLLKQLESPNWFDPW	IGHV3-53	IGHJ5
TGTGCGAGAGATGAACCCTTAGCAGCAGCTGGTGTGGGAGGACCAAGCTGG	CARDEPLAAAGVGGPSW	IGHV3-48	IGHJ4
TGTGCGACCCTCTCCGGGGAAAGTATAGCAGCTCGTCTCTACTACGGCTACTGG	CATLSGESIAARLYYGYW	IGHV1-3	IGHJ4
TGTGCAAAAGATAGACGACCCTCGTATAGTGGGAGCTACTCCAGGTCTGACTACTGG	CAKDRRPSYSGSYSRSDYW	IGHV3-43	IGHJ4
TGTGCGTTCGGACACACGTATTATGATTACGTTTGGGGGAGTTATCGGGGTAACTGGTTCGACCCCTGG	CAFGHTYYDYVWGSYRGNWFDPW	IGHV3-23	IGHJ5
TGTGCGAGCCCATTGGGGAATAGTAGTACCAGCTGCTATCGGTACTACTTTGACTACTGG	CASPLGNSSTSCYRYYFDYW	IGHV1-69	IGHJ4
TGTACCACAGGGGGCGCAGTGGCTGGTATGTGGTTCGACCCCTGG	CTTGGAVAGMWFDPW	IGHV3-15	IGHJ5
TGTGCGAGAGATGGATTTGTAGTAGTACCAGCTGCTATACGTTGGGACTGG	CARDGFVVVPAAIRWDW	IGHV1-69	IGHJ4
TGTGCGAAAAAATGGCCATATTATGATTACATTTGGGGGAGTTATCGTTATACCCGGGGTACCTACTTTGACTACTGG	CAKKWPYYDYIWGSYRYTRGTYFDYW	IGHV3-23	IGHJ4
TGTGCCATATTAATACAGCTATGGTTGGAATTTTACTTCGATCTCTGG	CAILIQLWLEFYFDLW	IGHV3-11	IGHJ2
TGTGCGAGAGATCCGGGAAAGCAACTGGAACGTGTCGACTACTGG	CARDPGKQLERVDYW	IGHV1-46	IGHJ4
TGTGCGAAAGATACGGGCCGGATATTGTACTGGTGGTGTATGCTATTAATATTATGG	CAKDTGRILYWWCMLLILW	IGHV3-NL1	IGHJ5
TGTGCGAGTAGCCTGGTTCAGGGAGTTATTATAACTCGTAACTGGTTCGACCCCTGG	CASSLVQGVIITRNWFDPW	IGHV3-48	IGHJ5
TGTGCGAGAGATCTCCGGGGGTCCACACGTATTACGATTTTTGGAGTGGTTAGGTACTACTTTGACTACTGG	CARDLRGSTRITIFGVVRYYFDYW	IGHV1-2	IGHJ4
TGTGCGAGAGATAATGGACCTCCTATTGTAGTGGTGGTAGCTGCTAGGGGGTCACGTCAAGACTGGTTCGACCCCTGG	CARDNGPPIVVVVAARGSRQDWFDPW	IGHV3-30	IGHJ5
TGTGCGAGAGGGTCGACAATTGTAGTGGTGGTAGCTGCTACCGAACTCCTGGACAAGAACTACATGGACGTCTGG	CARGSTIVVVVAATELLDKNYMDVW	IGHV3-7	IGHJ6
TGTGCGAGCCGGGGGGCCCTCATGTATTATGATTACATTTGGGGGAGTTATCTTTGGTACTGG	CASRGALMYYDYIWGSYLWYW	IGHV1-69	IGHJ4
TGTGCGAGAGGTATTGTAGTGGTGGTAGCTGCTACTAGCGTCTACTACTACTACTACATGGACGTCTGG	CARGIVVVVAATSVYYYYYMDVW	IGHV1-3	IGHJ6
TGTCAATCTCCCCTTTGTAGTAGTACCAGCTGCTATACCCACGTTGACTACTGG	CQSPLCSSTSCYTHVDYW	IGHV3-30-3	IGHJ4
TGTGCGAGAGATGCGAAGGTTATAGCAGTGGCTGCAATGGGTAACAAGAGGCTTGACTACTGG	CARDAKVIAVAAMGNKRLDYW	IGHV3-21	IGHJ4
TGTCGGACCGGTATAGCAGCTCGTCGGGGGGTGATATATACGGCTAGACGTATAAAAGCTGCTTTTGATATCTGG	CRTGIAARRGVIYTARRIKAAFDIW	IGHV1-3	IGHJ3
TGTGCGAGAGATGGGCTAGTCGGGTATTGTAGTAGTACCAGCTGCTATTACTGG	CARDGLVGYCSSTSCYYW	IGHV4-61	IGHJ4
TGTGCGAGAGGGGGATTACGATATTTTGACTGGTTATTTTTAGGGTACTACTACTACATGGACGTCTGG	CARGGLRYFDWLFLGYYYYMDVW	IGHV1-2	IGHJ6
TGTGCGAAAGATCTAGGATATTGTACTGGTGGTGTGTCCCCGATGGATGCTTTTGATATCTGG	CAKDLGYCTGGVSPMDAFDIW	IGHV3-23	IGHJ3
TGTGCGAGAAAAGGATATTTTGGAGTGGTTAACGGGTTAGACTACTGG	CARKGYFGVVNGLDYW	IGHV7-4-1	IGHJ4
TGTGCGAGAGTAACCATAGTGGCTACGATTGGGGACTACTGG	CARVTIVATIGDYW	IGHV3-66	IGHJ4
TGTGCGAGGAAGGTGGGAGTTTGGGTTTCCCATAGCAGCAGCCCTATTCCCTATCGTCCCTGGTTCGACCCCTGG	CARKVGVWVSHSSSPIPYRPWFDPW	IGHV4-4	IGHJ5
TGTGCGAAACTTACGATCCACTTTGACTACTGG	CAKLTIHFDYW	IGHV3-23	IGHJ4
TGTGCGAGAGCATCGATTGTAGTGGTGGTAGCTGCTACTTTCCCTCCCTGG	CARASIVVVVAATFPPW	IGHV3-20	IGHJ4
TGTGCGAGGGTTACTATGATAGTAGTGGTTATCCTCACGCACTACTGG	CARVTMIVVVILTHYW	IGHV4-61	IGHJ4
TGTGCGAAGGATATTACGATTTTTGGAGTGGTTATTGGTCCCTACTACATGGACGTCTGG	CAKDITIFGVVIGPYYMDVW	IGHV3-7	IGHJ6
TGTGCGAGGGGGACGTATTCTAGCAGCAGGTTCGACCCCTGG	CARGTYSSSRFDPW	IGHV4-59	IGHJ5
TGTGCGAGAGACATAACTGGAACTACGAGTGAGGGCAACTGGTTCGACCCCTGG	CARDITGTTSEGNWFDPW	IGHV4-34	IGHJ5
TGTACCACAGATGGGCCGTGGGTTGAGTGGGCGCCACCTGGGTCGTTTGACTACTGG	CTTDGPWVEWAPPGSFDYW	IGHV3-15	IGHJ4
TGTGCCAGGAGGGGGGGGGTAGTAGTACCAGCTGCTATTTTGGGGAAACGAGACTACTGG	CARRGGVVVPAAILGKRDYW	IGHV3-48	IGHJ4
TGTGCGAGAGGGATTAGAAGAAACAGATATTGTAGTGGTGGTAGCTGCTACTCCGTAGTGACTCGGGCGGTCCACTACTTTGACTACTGG	CARGIRRNRYCSGGSCYSVVTRAVHYFDYW	IGHV1-3	IGHJ4
TGTGCAAGAGATCGGTCTATGGTTCAGGGAGTTATTCGAGGCCCCTTCTACGGAACCCCGCCACCGTTTTCCCCCTACTACTACTACTACATGGACGTCTGG	CARDRSMVQGVIRGPFYGTPPPFSPYYYYYMDVW	IGHV3-13	IGHJ6
TGTACCACAGATTCCCTCGACCCTGAGGGAAAAGCGGATATTGTAGTGGTGGTAGCTGCTACTCCTTACTGG	CTTDSLDPEGKADIVVVVAATPYW	IGHV3-15	IGHJ4
TGTGCGAAATTTCTGGGCTGGTACATGGTCGGACCGTCCACCCCCTGG	CAKFLGWYMVGPSTPW	IGHV3-NL1	IGHJ4
TGTGCACTGTCAGTATGCCTCGAAAATTGTGCGGCCCGTATTACTATGGTTCAGGGAGTTATTATAACGGCTAATACTGACTACTGG	CALSVCLENCAARITMVQGVIITANTDYW	IGHV1-69	IGHJ4
TGTGCGAGAGAATGCGACCGAAAAGGGGGGGGAGTCCCAACCATGACATTTGACTACTGG	CARECDRKGGGVPTMTFDYW	IGHV4-34	IGHJ4
TGTGCGAGACCTGGAGCAAGGTATAGCAGTGGCCCCGGATTTAGGCTAGACTGG	CARPGARYSSGPGFRLDW	IGHV4-61	IGHJ4
TGTGCGAGAGGACGAAAGGAGGGTCTTCAGATATTGTACTGGTGGAATAGCTTTTTTTCCTGGCTTAAAAATTACGGCTACTACTACTACTACATGGACGTCTGG	CARGRKEGLQILYWWNSFFSWLKNYGYYYYYMDVW	IGHV1-2	IGHJ6
TGTACCACTCAGGATATTGTAGTGGTGGTAGCTGTCCCTTCCCAGGACTACTGG	CTTQDIVVVVAVPSQDYW	IGHV3-15	IGHJ4
TGTGGGAGCGATATTTTGACTGGTTATTACACTGCGCTCTACTGG	CGSDILTGYYTALYW	IGHV3-30-3	IGHJ4
TGTGCGAGAGGCCAGCCTGATTACATTTGGGGGAGTTATCGTTATGGGCCCTACTTTGACTACTGG	CARGQPDYIWGSYRYGPYFDYW	IGHV4-34	IGHJ4
TGTGCGAGAGATCACGTTCTACGATATTTTGACTGGTTATTATATGATAATCAAGGTGGCGTCCCGCTGGGGGACTACTGG	CARDHVLRYFDWLLYDNQGGVPLGDYW	IGHV1-69	IGHJ4
TGTGCGAGAGTCCCCAGTGGCAGTGGCTGGTGTGGTACCTCTGAATACTTCCAGCACTGG	CARVPSGSGWCGTSEYFQHW	IGHV4-34	IGHJ1
TGTGCGAGAGATTCCGGGTATAGCAGTGGCTGGTACCTCGTTGACTACTTTGACTACTGG	CARDSGYSSGWYLVDYFDYW	IGHV3-21	IGHJ4
TGTGCGAGAGACCCCTTTGGGTATGGTTCGGGGAGTTATTATACTCTCCACTTTGACTACTGG	CARDPFGYGSGSYYTLHFDYW	IGHV1-69	IGHJ4
TGTGCGAGAGGCGCGGAAAAAGTAGGCGGGGGATCCGGGGCTCGGTTTATTATGATTACATTTGGGGGAGTTATCGTTATACTGTATATGCGTTGTGTGAGACACTTTGACTACTGG	CARGAEKVGGGSGARFIMITFGGVIVILYMRCVRHFDYW	IGHV4-34	IGHJ4
TGTGCAAAAGATACCAGGCGCCTGGACCTCCGGGGTAGTGGTGGTAGCTGCTACTCGAACTACTGG	CAKDTRRLDLRGSGGSCYSNYW	IGHV3-43	IGHJ4
TGTGCTAGAAGGAGGTACGTATTACGATTTTTGGAGTGGTTAAATAACTTTTTCCCCAAAAGGGGGAACTGGTTCGACCCCTGG	CARRRYVLRFLEWLNNFFPKRGNWFDPW	IGHV3-72	IGHJ5
TGTGCGAGTGAGCAAGCATATTGTGGTGGTGATTGCTATTCACACTTTGACTACTGG	CASEQAYCGGDCYSHFDYW	IGHV1-69	IGHJ4
TGTGCGAGAGGAGCCGACCCGTGGCTACGGTATGACTACTACTACTACATGGACGTCTGG	CARGADPWLRYDYYYYMDVW	IGHV4-59	IGHJ6
TGTACCACCCGGGGACAAGCCGAAAGTTCGGTCGACACCCCTTTGGCTACGGTGACTACGACAGGCTTTGACTACTGG	CTTRGQAESSVDTPLATVTTTGFDYW	IGHV3-15	IGHJ4
TGTGCGAGATGGACGGTTGTCCTTTCGATACGTATTACGATTTTTGGAGTGGTTATTACCTACTACTACTACATGGACGTCTGG	CARWTVVLSIRITIFGVVITYYYYMDVW	IGHV1-2	IGHJ6
TGTGCAAAAGGGGATCCTATCGACTTTGACTACTGG	CAKGDPIDFDYW	IGHV3-43	IGHJ4
TGTGCGAGAGATCCTTCTATAGTGGTAAGCTACTGG	CARDPSIVVSYW	IGHV3-48	IGHJ4
TGTACCACACAACCCCATATTGTAGTGGTGGTAGCTGCTACTCCACCCTGGTTCGACCCCTGG	CTTQPHIVVVVAATPPWFDPW	IGHV3-15	IGHJ5
TGTGCGAGAATGAGGGATTTGGTAGCTGCGTATGGTCACAGGTTCGACCCCTGG	CARMRDLVAAYGHRFDPW	IGHV1-3	IGHJ5
TGTGCGAGATTTTGGCCCCCCTGTGGGTACTATAGCAGCCGGAACTGGGCGGGCTGGTTCGACCCCTGG	CARFWPPCGYYSSRNWAGWFDPW	IGHV4-38-2	IGHJ5
TGTGCGAGAGATCTGGAGGGGTTTACTATGGTTCAGGGAGTGGCCGGAGTTACCTGG	CARDLEGFTMVQGVAGVTW	IGHV3-30	IGHJ5
TGTGCGACCCGTGTAGTAGTACCAGCTGCGCGGTACTACTACTACATGGACGTCTGG	CATRVVVPAARYYYYMDVW	IGHV1-69	IGHJ6
TGTGCGAAAGATTATCCCCAAGTGGGAGCTACTAACCTGGGGGGCCACTGG	CAKDYPQVGATNLGGHW	IGHV3-NL1	IGHJ4
TGTACCACAGTATTGAGGAATTGTAGTGGTGGTAGCTGCTATATTTTCGACCCCTGG	CTTVLRNCSGGSCYIFDPW	IGHV3-15	IGHJ5
TGTGCGAGTTTCAGTCTTACCAGAGGGGCGTCCATCCTCTCTCACTACTACTACTACTACATGGACGTCTGG	CASFSLTRGASILSHYYYYYMDVW	IGHV3-66	IGHJ6
TGTGCGAGAGCTAAGATTGTACTGGTGGTGTATGCCCTAGGCTTAAAATACTACTACTACATGGACGTCTGG	CARAKIVLVVYALGLKYYYYMDVW	IGHV4-34	IGHJ6
TGTGCGAGAGTCCCACTTCCCGGTGACCGAGGTATAGCAGCTCGTGGAACACTTGACTACTGG	CARVPLPGDRGIAARGTLDYW	IGHV3-7	IGHJ4
TGTGCGGCAGGAAGTAGCAGCTCGTCTAAGGCCTTCCCTTCTGACTACTGG	CAAGSSSSSKAFPSDYW	IGHV1-58	IGHJ4
TGTGCGAGAGATCCGGCCACATTTGACTACTGG	CARDPATFDYW	IGHV3-21	IGHJ4
TGTGCGAGAGGGGCTCCCGTGTTGGTGGTGATTGCTATACGGGACCTTGCTTTTGATATCTGG	CARGAPVLVVIAIRDLAFDIW	IGHV3-11	IGHJ3
TGTGCGAAAGATGAGACTTACGATATTTTGACTGGTTATTATGAACTTGACTACTGG	CAKDETYDILTGYYELDYW	IGHV3-23	IGHJ4
TGTGCACGGGCCCCCAGGGTAATCGAAGGGGATATCTGG	CARAPRVIEGDIW	IGHV3-30	IGHJ3
TGTGCGAGAGATGTTTATTGTAGTACCAGCTGCCACCCATGGAGTTTTGACTACTGG	CARDVYCSTSCHPWSFDYW	IGHV4-61	IGHJ4
TGTACTAGACATAGGGCTCGGGCCTCCTACTACTTTGACTACTGG	CTRHRARASYYFDYW	IGHV3-73	IGHJ4
TGTGCGAGACCGGCCGGTATTACTATGATAGTAGTGGTTAAGTCCTACTTTGACTACTGG	CARPAGITMIVVVKSYFDYW	IGHV3-23	IGHJ4
TGTGCGAGAGAGTCGGATTACCAGTATAGCAGCTCGTTATTGCACCCGTTTGACTACTGG	CARESDYQYSSSLLHPFDYW	IGHV1-2	IGHJ4
TGTGCGAGAAGGTGGTACGACTACTTTGACTACTGG	CARRWYDYFDYW	IGHV4-34	IGHJ4
TGTGCGAGAATTTCTCCTGATAGCAGTGGCTGGTACGGTGACTACTGG	CARISPDSSGWYGDYW	IGHV3-53	IGHJ4
TGTGCGAGAGGGAACGATAGTAGTGGCCTAACGGGTGGACTGCAACTATACTACTACTTTGACTACTGG	CARGNDSSGLTGGLQLYYYFDYW	IGHV1-46	IGHJ4
TGTATGAGGGCCCCCTATAGGCTATGGTTCAGGGAGTTAAGGGGTTTAGGGTACTACTTTGACTACTGG	CMRAPYRLWFRELRGLGYYFDYW	IGHV3-15	IGHJ4
TGTGCGAAAGGGGAGGATATTGTGGTGGTGACAGCTGACTACTGG	CAKGEDIVVVTADYW	IGHV3-23	IGHJ4
TGTGCGAAAATGACGGTGGTAACGCGTATCCGCAGACTTGGGGGGGTTGACTACTGG	CAKMTVVTRIRRLGGVDYW	IGHV3-NL1	IGHJ4
TGTGCGGGGGAAGGCTATAGCAGTGGAAAAGTCTACTTTGACTACTGG	CAGEGYSSGKVYFDYW	IGHV1-45	IGHJ4
TGTGCGAGCAGGTTATTCCTGTATTATGGTAGAGGGTGGGACCTCTACTGG	CASRLFLYYGRGWDLYW	IGHV1-46	IGHJ4
TGTGCGAAAGATCTTCTGTATTCCACGACGTATTACGATATTTTGACTGGGTCTCCTGCCTACTACTACTACTACATGGACGTCTGG	CAKDLLYSTTYYDILTGSPAYYYYYMDVW	IGHV3-NL1	IGHJ6
TGTGCGAGAGATCTCCCGCCGGTTGGATACAGATATTGTAGTAGTACCAGCTGCTATGTAAACCTAAATACCTACTACTACATGGACGTCTGG	CARDLPPVGYRYCSSTSCYVNLNTYYYMDVW	IGHV1-2	IGHJ6
TGTGCGAAAACTACGCATATTGTAGTGGTGGTAGCTGCTAATTGTAATGACTACTGG	CAKTTHIVVVVAANCNDYW	IGHV3-23	IGHJ4
TGTGCGAGGGGTGATATTGTAGTAGTACCAGCGACTTCCCTTTACATGGACGTCTGG	CARGDIVVVPATSLYMDVW	IGHV1-2	IGHJ6
TGTGCGAGAGGGTACGAGCATTGTAGTAGTACCAGCGCCCGCTACTACTACTACTACATGGACGTCTGG	CARGYEHCSSTSARYYYYYMDVW	IGHV1-3	IGHJ6
TGTGCGAGCCCAGGAGGAGCATACTATGATAGTAGTGGTTATTACGAATTTGACTACTGG	CASPGGAYYDSSGYYEFDYW	IGHV1-18	IGHJ4
TGTGCGAATATAAATGGAGACCCAATACCAGCTGCTATACACTACTACATGGACGTCTGG	CANINGDPIPAAIHYYMDVW	IGHV3-NL1	IGHJ6
TGTGCGAGACACTTGGACTGGAACCTGAACTGGTTCGACCCCTGG	CARHLDWNLNWFDPW	IGHV4-39	IGHJ5
