TGTGCGAAATGGGTGTGTACTGGTGGTGTATGCTATAGGCCCCTCTGGTACTTCGATCTCTGG	CAKWVCTGGVCYRPLWYFDLW	IGHV3-23	IGHJ2
TGTGCGAGAGGCTTATTAGTGAGGATTCTAGGATATTGTAGTGGTGGTAGCTGCTACTCGATCCCGGCTGACTACTGG	CARGLLVRILGYCSGGSCYSIPADYW	IGHV4-34	IGHJ4
TGTGCAAAAGATGCCCCCACCCGCAAACGCCCTGCCTACTGG	CAKDAPTRKRPAYW	IGHV3-43D	IGHJ4
TGTGCGAGAGGGGACGGACGGGGCTACGATATTTTGACTGGTATCGAATCCTACTACTTTGACTACTGG	CARGDGRGYDILTGIESYYFDYW	IGHV4-59	IGHJ4
TGTGCGAGAGATAACGTCGTAACTACGCAGACTATTTTCAGGGCCTTATGGACGGGACACTGGTACTTCGATCTCTGG	CARDNVVTTQTIFRALWTGHWYFDLW	IGHV1-69	IGHJ2
TGTACTAGAGAGCCCCTCCAGAATTTCCGGGTTCGGGGAGTTATTATTGGATCGTCAGCTTTTGATATCTGG	CTREPLQNFRVRGVIIGSSAFDIW	IGHV3-49	IGHJ3
TGTGCGAGAGTAAGGGATAGCAGTGGCTGGACTCACCCTGGCTACTACTACTACTACATGGACGTCTGG	CARVRDSSGWTHPGYYYYYMDVW	IGHV4-59	IGHJ6
TGTGCGAGAGCGGGGATTACTATGATAGTAGTGGTTATTAGAGCGGGGGAGGGGGTTGACTACTGG	CARAGITMIVVVIRAGEGVDYW	IGHV1-2	IGHJ4
TGTGCGAGAGAAGGGGCTGAGGTAAATGATTACATTTGGGGGAGGGCCCCCAGGGTCTACTACTTTGACTACTGG	CAREGAEVNDYIWGRAPRVYYFDYW	IGHV7-4-1	IGHJ4
TGTGCGAGAGATCCGGTGACGGCGGGAGGTGGCTACGCTACGAGCTACTACTACTACTACATGGACGTCTGG	CARDPVTAGGGYATSYYYYYMDVW	IGHV3-11	IGHJ6
TGTACTAGCCGCAGATATTGTAGTGGTGGTAGCTGCTACACTGCGGGAGGGCGGTTCGACCCCTGG	CTSRRYCSGGSCYTAGGRFDPW	IGHV3-49	IGHJ5
TGCAACTATGGGGTACCTGATATTGTAGTGGTGGTAGCTGCTACGGGGCCCCTCGTCTTTGACTACTGG	CNYGVPDIVVVVAATGPLVFDYW	IGHV1-46	IGHJ4
TGTCTAAGAGCAGCAGCTAAGCCCTTGGATGCTTTTGATATCTGG	CLRAAAKPLDAFDIW	IGHV3-49	IGHJ3
TGTGCGAGAAATACACGTATTACTATGGTTCGGGGGGGGGTCTACTGG	CARNTRITMVRGGVYW	IGHV5-51	IGHJ4
TGTGCGAGAGATGGACTTTTTTACGGGACAGCTATGGTTTTGAGGGCCGTGGTTGACTACTGG	CARDGLFYGTAMVLRAVVDYW	IGHV3-11	IGHJ4
TGTGCGAGAGATTCTTGTGGGCTAATTCAAGTAGTACCAGCTGCTAATGACTACTGG	CARDSCGLIQVVPAANDYW	IGHV3-7	IGHJ4
TGTGCGAGGCCCCCCGTTCGATATTGTAGTAGTACCAGCTGCTATGTATTGGACAACTGGTTCGACCCCTGG	CARPPVRYCSSTSCYVLDNWFDPW	IGHV7-4-1	IGHJ5
TGTGCGAGTAATTTACCCGACCGGGGTTCGGGTCCCTACTACTTTGACTACTGG	CASNLPDRGSGPYYFDYW	IGHV3-53	IGHJ4
TGTGCGAGAACGGAGTTTGTAGTAGTACCAGCTGCTAGAATACGCGACATCCGTAAAGGGATTTTCCGACGCTGG	CARTEFVVVPAARIRDIRKGIFRRW	IGHV4-34	IGHJ5
TGTGCGAAAGAGGACGAGGCTCTAGTAGTACCAGCTGCGCAGCCCTACTTTGACTACTGG	CAKEDEALVVPAAQPYFDYW	IGHV3-23	IGHJ4
TGTGCGAAAGATCAGGCTATGGTTCGGGGCCGGGACGTTGACTACTGG	CAKDQAMVRGRDVDYW	IGHV3-23	IGHJ4
TGTACCACAGATCAGGGGGAGACCCGAGCAGTGGCTGGTCCCCGGGACTACTACTACATGGACGTCTGG	CTTDQGETRAVAGPRDYYYMDVW	IGHV3-15	IGHJ6
TGTGCGGGATATATTGTAGTGGTGGTAGCTGCTAAATCATTAGGCTGGTTCGACCCCTGG	CAGYIVVVVAAKSLGWFDPW	IGHV4-59	IGHJ5
TGTGCGAGACGGAGGGACTACGGTGACTCCCTTTACTACTACTACTACTACATGGACGTCTGG	CARRRDYGDSLYYYYYYMDVW	IGHV1-18	IGHJ6
TGTGCGAAAGATGCTTGTTGGAGTGGTGATTCGAGGGGTATTTGTATACATATTAGAGATCCTGACTACTGG	CAKDACWSGDSRGICIHIRDPDYW	IGHV3-23	IGHJ4
TGTGCAAGAGGGGGGGGTATTATGATTACGTTTGGGGGAGTTACGATCGAAAACTGGTTCGACCCCTGG	CARGGGIMITFGGVTIENWFDPW	IGHV3-13	IGHJ5
TGTGGGCTAGATGGTTCGGGGGGCTACTGG	CGLDGSGGYW	IGHV3-30	IGHJ4
TGTGCGAAAGGTATAGCAGTGGCTGCGAACTGGTTCGACCCCTGG	CAKGIAVAANWFDPW	IGHV3-23	IGHJ5
TGTGCGAAAGATATTCGTATTATGATTACATTTGGGGAGGGAAACTGGTTCGACCCCTGG	CAKDIRIMITFGEGNWFDPW	IGHV3-23	IGHJ5
TGTGCGAAGGATTTTCAGTGGCTGGATAGGCATGACTACTGG	CAKDFQWLDRHDYW	IGHV3-NL1	IGHJ4
TGTGCAAGAGTTCGTATTGTAGTAGTACCAGCTGCTAGATCGTACTACTTTGACTACTGG	CARVRIVVVPAARSYYFDYW	IGHV1-45	IGHJ4
TGTGCGAAAGATCTCAAACGTATTACTATGATAGTAGTGGTTATTGGATACCCCATTGACTACTGG	CAKDLKRITMIVVVIGYPIDYW	IGHV3-NL1	IGHJ4
TGTGCGAGAGATCCGGGGCAGCAGCTGGTACGTGGCCTGAACTGGTTCGACCCCTGG	CARDPGQQLVRGLNWFDPW	IGHV3-21	IGHJ5
TGTGCAAAATCAGAATGGTGGCTACGATTGGTACCCCCCTCAATCAACCGAGCCGCCGTAAACTGGTTCGACCCCTGG	CAKSEWWLRLVPPSINRAAVNWFDPW	IGHV3-43D	IGHJ5
TGTGCGAAAGGGGTGGTGGTGATTGCTATTTCTTGTTCGGTCTGG	CAKGVVVIAISCSVW	IGHV3-23	IGHJ5
TGTCAGTATAGCAGTGGCTCAGTTGACTACTGG	CQYSSGSVDYW	IGHV3-7	IGHJ4
TGTGCGAAAGCGTTATTGTACTGGTGGTGGGCCTACTGG	CAKALLYWWWAYW	IGHV3-23	IGHJ4
TGTGCGAAAGAGGTAACATATTGTAGTGGTGGTAGCTGCTACTCCGGGTCTTTGAAACTGCGTTGCCTTTTCTACTGG	CAKEVTYCSGGSCYSGSLKLRCLFYW	IGHV3-NL1	IGHJ4
TGTGCGCTGAATTGTAGTGGTGGTAGCCCTGGCGGGTGGTTCGACCCCTGG	CALNCSGGSPGGWFDPW	IGHV3-48	IGHJ5
TGTGCGACAGAAAGATATTGTAGTGGTGGTAGCTGCTACTCCGGTGGGTTTGACTACTGG	CATERYCSGGSCYSGGFDYW	IGHV4-31	IGHJ4
TGTGCGAGAGATCTCGAGCCCGACTACTGG	CARDLEPDYW	IGHV3-53	IGHJ4
TGTACTAGACCTGTAGCAGCAGCTGGTACGCAGTTCCAGCACTGG	CTRPVAAAGTQFQHW	IGHV3-73	IGHJ1
TGTGCGAGAGGAAATATTGTACTAATGGTGTATGCTATCCCCCCCTGGGAGCCACCCAACTGGTTCGACCCCTGG	CARGNIVLMVYAIPPWEPPNWFDPW	IGHV3-20	IGHJ5
TGTGCGAGAGATATTACTATGATAGTAGTGGTTATTAAAGTTGACTACTGG	CARDITMIVVVIKVDYW	IGHV3-66	IGHJ4
TGTGCGAGTCCGGTATTACTATGGTTCAGGGAGTTTTGGAACTGGTTCGACCCCTGG	CASPVLLWFREFWNWFDPW	IGHV5-10-1	IGHJ5
TGTGCGCGGGACCCTTGGAGTGGTCGGGACCCGAACTGGTTCGACCCCTGG	CARDPWSGRDPNWFDPW	IGHV4-39	IGHJ5
TGTGCGAGAGATTATGACCCGGTAGTGGTTATTACTAGGTATTTTGACTACTGG	CARDYDPVVVITRYFDYW	IGHV3-53	IGHJ4
TGTGCGAGAGATCGAGTCAGAGCAGATAGCAGCAGCTGGTACGTTATAAACTTTGACTACTGG	CARDRVRADSSSWYVINFDYW	IGHV3-21	IGHJ4
TGTGCGAGACCCTATTGGGGGACCTACAACTGGTTCGACCCCTGG	CARPYWGTYNWFDPW	IGHV1-46	IGHJ5
TGTGCGAGAGATCTTTCGAGCGGAACTGGCGGTATAGCAGCAGCTTGGCCCTTTGACTACTGG	CARDLSSGTGGIAAAWPFDYW	IGHV3-53	IGHJ4
TGTGCGAGAGGGTTTCGGGCTTATTACTATGATAGTAGTGGTTATTGGGTTGACTACTGG	CARGFRAYYYDSSGYWVDYW	IGHV7-4-1	IGHJ4
TGTGCACACAGCCATTGTAGTAGTACCAGCTGCTATACAACACCGGGGCGCCCCGACTACTACTACTACTACATGGACGTCTGG	CAHSHCSSTSCYTTPGRPDYYYYYMDVW	IGHV2-5	IGHJ6
TGTGCGAGAGATTTCGATTTTTGGAGTGGTTATAAGATCTGG	CARDFDFWSGYKIW	IGHV1-46	IGHJ4
TGTGCGAGAGAAGAGGATTACGATTTTTGGAGTGGTTATTGCCAACGGGTCTACTTTGACTACTGG	CAREEDYDFWSGYCQRVYFDYW	IGHV1-18	IGHJ4
TGTGCGAGACCTCCATATTGTACTGGTGGTGTATGCTATATGGGATCGGCCTCGTTTGACTACTGG	CARPPYCTGGVCYMGSASFDYW	IGHV5-51	IGHJ4
TGTGCAAAAGGGCGCAGCAGCTGGGCGGGGCCCGCTGAGACTGAATTGATCTGG	CAKGRSSWAGPAETELIW	IGHV3-43	IGHJ3
TGTGCGAGCCAAACCGGTATAGTGGGAGCTAGGGGCTGGTTCGACCCCTGG	CASQTGIVGARGWFDPW	IGHV4-39	IGHJ5
TGTGCGAGAGATTGTCCTACGATTTACCGAAGGGACTACTGG	CARDCPTIYRRDYW	IGHV3-11	IGHJ4
TGTGCGAGTCGGAAGTTTCTTCCGATTGTAGTGGTGGTAGCTGCTAGGGGTGACTACTGG	CASRKFLPIVVVVAARGDYW	IGHV3-30	IGHJ4
TGTGCAAGAGGAGTCAGTGGGAGCTCTTTGGGTGGTTGGTTCGACCCCTGG	CARGVSGSSLGGWFDPW	IGHV3-74	IGHJ5
TGTGCGAGCACGGACATAGTGGCTACGATGGGGAACTGG	CASTDIVATMGNW	IGHV1-18	IGHJ4
TGTACCACAGCTCTGGAGGTATACAGCTATGGCGTTGACTACTGG	CTTALEVYSYGVDYW	IGHV3-15	IGHJ4
TGTGCGAGCCCGGTGACTACGGCCACAAACTACTACTACTACTACATGGACGTCTGG	CASPVTTATNYYYYYMDVW	IGHV1-46	IGHJ6
TGTGCGAGGAGTGGTGGTAGCTGCTACTCGAACTGG	CARSGGSCYSNW	IGHV7-4-1	IGHJ4
TGTGCAAAAGATGGACGTCCTAACTGGGGAAGGGTTGTCTACTGG	CAKDGRPNWGRVVYW	IGHV3-43D	IGHJ4
TGTGCCGGAATAGCAGCAGCTGTGCGATGGGTTGGGGGCTACTGG	CAGIAAAVRWVGGYW	IGHV3-21	IGHJ4
TGTGCGAGAACCATTACGATTTTTGGAGTGGTTATTCCGGCTGTTGAGTCTGACTACTGG	CARTITIFGVVIPAVESDYW	IGHV5-51	IGHJ4
TGTGCGAGAACGATTTTTGGAGTGGTTATTATAGACGGTGACTACTGG	CARTIFGVVIIDGDYW	IGHV5-10-1	IGHJ4
TGTGCGAGACACCCGTATAGCAGCAGCTGGTACTACTACTACTACTACATGGACGTCTGG	CARHPYSSSWYYYYYYMDVW	IGHV5-51	IGHJ6
TGTGCGAGTGAAGCACGTATTTTGACTGGTTATACTTTCTACTACATGGACGTCTGG	CASEARILTGYTFYYMDVW	IGHV3-53	IGHJ6
TGCCGGAGCCTCCAGGGAATAGCAGCAGCTGGTCGGCCCTTTGACTACTGG	CRSLQGIAAAGRPFDYW	IGHV3-11	IGHJ4
TGTGCAAGAGATGTCGGGCCTGGGACTACGGTGAGGGGCGACTTTGACTACTGG	CARDVGPGTTVRGDFDYW	IGHV3-74	IGHJ4
TGTGCACACAGGGGCGGGTATAGCAGCGGCACGGGGGCCACATTTGACTACTGG	CAHRGGYSSGTGATFDYW	IGHV2-5	IGHJ4
TGTGCGAGACCAGATGGTCGGAGGGATTGTAGTGGTGGTAGCTGCTACAAAGACTGGTTCGACCCCTGG	CARPDGRRDCSGGSCYKDWFDPW	IGHV1-46	IGHJ5
TGTGCAAGAGATCATCATAACAATCGCTACAATACCCAGTGCGGTGACTACTGG	CARDHHNNRYNTQCGDYW	IGHV3-74	IGHJ4
TGTGCGAGAGATCTGACTGCTCGGGGTTACTACTTTGACTACTGG	CARDLTARGYYFDYW	IGHV4-34	IGHJ4
TGTGCGAAAGATCCTTCGGGGATAGCGGGAAAACGATATTTTGACTGGTTCTTACCCCCCGTGAAAGGGGACTACTGG	CAKDPSGIAGKRYFDWFLPPVKGDYW	IGHV3-NL1	IGHJ4
TGTGCGAGAGCGGATATTGTAGTGGTGGTAGCTGCTACTGATTTCTTGCCCTACTACTACTACATGGACGTCTGG	CARADIVVVVAATDFLPYYYYMDVW	IGHV1-69	IGHJ6
TGTGCGAAAAATAGAGGGGAGAGCATTTACTACTTTGACTACTGG	CAKNRGESIYYFDYW	IGHV3-23	IGHJ4
TGTGCGAGACACTCATCTTATATAGTGGCTACGAGGGAAGCCAACTACTTTGACTACTGG	CARHSSYIVATREANYFDYW	IGHV4-39	IGHJ4
TGTACCACTGGAGACTTTCAGTTGGGTATAGCACTGGCAGACTTCCAGCACTGG	CTTGDFQLGIALADFQHW	IGHV3-15	IGHJ1
TGTGCGAGAGATCCCCTGGTGGTGTATGCTAGGCCCTACTGG	CARDPLVVYARPYW	IGHV3-11	IGHJ4
TGTGCGAGGGAGCAGGGAGACGTATTACGATTTTTGGAGTGGTTATTATGCGCCGGATGGACCTTTAACACCCTCTACATGGACGTCTGG	CAREQGDVLRFLEWLLCAGWTFNTLYMDVW	IGHV4-38-2	IGHJ6
TGTGCGAGTAAACCAACCCGGTATTACTATGGTTCGGGGAGTTATTTACTTGACTACTGG	CASKPTRYYYGSGSYLLDYW	IGHV1-69	IGHJ4
TGTGCACGGATACCCGCATATTGTAGTGGTGGTAGCTGCTCAGATTTCGACCCCTGG	CARIPAYCSGGSCSDFDPW	IGHV2-26	IGHJ5
TGTGCGAGATCGGTCGTCGCCACTAGAGGTCCATCCTACTGGTACTTCGATCTCTGG	CARSVVATRGPSYWYFDLW	IGHV1-3	IGHJ2
TGTGCGAGCCGTAAGGTTATGATTACATTTGGGGGAGTTATCGTTGGGTCGGACTGG	CASRKVMITFGGVIVGSDW	IGHV1-69	IGHJ4
TGTACCACAGATGAGGCCGGTATTGTAGTAGGATACCCTTTTATTCGCTACTGG	CTTDEAGIVVGYPFIRYW	IGHV3-15	IGHJ4
TGTGCGAGACCCTTTTTGGAGTGGTTATTATCCGCCTTCTACTGG	CARPFLEWLLSAFYW	IGHV4-39	IGHJ4
TGTGCGAGATGGGGTTACGATTTTCCAACTTACTACATGGACGTCTGG	CARWGYDFPTYYMDVW	IGHV5-51	IGHJ6
TGTGCGAAAGATAATATTGTAGTAGTACCAGCTGCTAGTTATCGGGGATTTGACTACTGG	CAKDNIVVVPAASYRGFDYW	IGHV3-23	IGHJ4
TGTGCGAGAGGTGGGTCAGAGCTGGCTGGTAATGGCGGTCCATACTGG	CARGGSELAGNGGPYW	IGHV3-7	IGHJ4
TGTGCGAGAGTTGCCTCTTATGGTTCAGGGAGTTATTATAACTTGGCCCGGACCTATATGCCGAACTACTACTACTACTACTACATGGACGTCTGG	CARVASYGSGSYYNLARTYMPNYYYYYYMDVW	IGHV3-20	IGHJ6
TGTGCGAGCCGTATTACGATTTTTGGAGTGGGTCCTACGGCCGTGGTGTGCACTAGTAACTGGTTCGACCCCTGG	CASRITIFGVGPTAVVCTSNWFDPW	IGHV4-34	IGHJ5
TGTGCGTTTTCCGGTATAGCAGCAGAGCCGGCGTACAACTGGTTCGACCCCTGG	CAFSGIAAEPAYNWFDPW	IGHV3-48	IGHJ5
TGTGCGAGAGGGAACTGGAACGACTTATTTGACTACTGG	CARGNWNDLFDYW	IGHV7-4-1	IGHJ4
TGTGCGAGAGATCTCACAGTGCGATATTGTAGTAGTACCAGCTGCTATGGTATCTTGTTCTACTACATGGACGTCTGG	CARDLTVRYCSSTSCYGILFYYMDVW	IGHV4-59	IGHJ6
TGTGCGAAAGAGAACAGTGGTGGTAGCTGCTACCACCAGTACTACTTTGACTACTGG	CAKENSGGSCYHQYYFDYW	IGHV3-NL1	IGHJ4
TGTGCGGACATGATTACATTTGGGGGAGTTATCGTTAGGCCGGAGGGGTTGACCAAGGGGTTATGTGACTACTGG	CADMITFGGVIVRPEGLTKGLCDYW	IGHV3-23	IGHJ4
TGTGCAAGAGGTGAACAAAAAGATGGGTTTTGTAGTGGTGGTAGCTGCTACTCGTACTGG	CARGEQKDGFCSGGSCYSYW	IGHV3-74	IGHJ4
