TGTGCGAAACCGCTGGTACCTAGTGGGAGTTATTATAACACCGAACCAGTAAACCGTAACTGGTTCGACCCCTGG	CAKPLVPSGSYYNTEPVNRNWFDPW	IGHV3-NL1	IGHJ5
TGTGCGAGACAGGGTATTATGATTACATTGCCCAATGTATTCCGGGCCGGATGG	CARQGIMITLPNVFRAGW	IGHV3-30	IGHJ5
TGTGCACGATCGAATTATGATTACATTTGGGGGAGTTATCGTTGCCTACTTCCCGTGTTTGACTACTGG	CARSNYDYIWGSYRCLLPVFDYW	IGHV2-5	IGHJ4
TGTGCGAAAGGTGTACGAGAAGGATATTGTAGTGGTGGTAGCTGCACCTTTGACTACTGG	CAKGVREGYCSGGSCTFDYW	IGHV3-23	IGHJ4
TGTGCGCGTCCGGGTATAGCAGTGCCCTTTGACTACTGG	CARPGIAVPFDYW	IGHV1-3	IGHJ4
TGTGCGAGAGATCATTCCAGGGGCTGGTACAAATCGGCCGAATACTGG	CARDHSRGWYKSAEYW	IGHV1-3	IGHJ4
TGTGCGAGAGATGGGAATTGTACTGGTGGTGTATGCGGCAGCTACTACTACTACATGGACGTCTGG	CARDGNCTGGVCGSYYYYMDVW	IGHV1-3	IGHJ6
TGTGCGAGAGATTGGGCTCCGTATAGCAGCTCGTCTTTGTACTGG	CARDWAPYSSSSLYW	IGHV4-59	IGHJ4
TGTGCGAGATTTGTATTACGATTTTTGGAGTGGGACTACTACTACTACTACATGGACGTCTGG	CARFVLRFLEWDYYYYYMDVW	IGHV1-2	IGHJ6
TGTGCGAGAGATCTCGCCCCTTCCGTGGATATAGTGGCTACGACTGGCCACTGCCCAACAAACTGGTTCGACCCCTGG	CARDLAPSVDIVATTGHCPTNWFDPW	IGHV1-18	IGHJ5
TGTGCAAGAGATCAGGATATTGTAGTGGTGGTAGCTGCTACTTACCCCTTTGACTACTGG	CARDQDIVVVVAATYPFDYW	IGHV1-45	IGHJ4
TGTGCGAAAATTTTAGACGGCAGTACTATGATAGTAGTGGTTATTACGAATGAGAAGATGTCTTCGACCTTTGACTACTGG	CAKILDGSTMIVVVITNEKMSSTFDYW	IGHV3-23	IGHJ4
TGTGCGAGAGCCGTAGAAAGGGTGGTAGCTGCGCTCGGTTTTGACTACTGG	CARAVERVVAALGFDYW	IGHV1-2	IGHJ4
TGTGCGAGAGTCCCGGGGTATAGCAGTGGGGACCCCCCTTACTGGTTCGACCCCTGG	CARVPGYSSGDPPYWFDPW	IGHV4-4	IGHJ5
TGTGCGAGACCCCTAAGATTCGGTGCGGCCGGATATTACGATTTTTGGAGTGGTTATTGGAGTCACTTTGACTACTGG	CARPLRFGAAGYYDFWSGYWSHFDYW	IGHV3-53	IGHJ4
TGTGCGAAAGAAATTACTATGATAGTAGTGGTTATTACTAAGAGGGGGGGATTTGACTACTGG	CAKEITMIVVVITKRGGFDYW	IGHV3-NL1	IGHJ4
TGTGCGGCAGACATTGTAGTAGTACCAGCTGCGCCGGTCTGG	CAADIVVVPAAPVW	IGHV1-58	IGHJ3
TGTGCAAGAGATAGACAACTAGGATATTGTAGTAGTACCAGCTGCTATTCAAGGGGCTACTTTGACTACTGG	CARDRQLGYCSSTSCYSRGYFDYW	IGHV3-13	IGHJ4
TGTGCGAGACTAATTATTGTAGTAGTACCAGCTGCAATGTTCGACCCCTGG	CARLIIVVVPAAMFDPW	IGHV5-51	IGHJ5
TGTGCGGTAGGAGTATTACGATATTTTGACTGGTCAAACTACTTTGACTACTGG	CAVGVLRYFDWSNYFDYW	IGHV1-3	IGHJ4
TGTGCGAAGAGCGTGAAGTTTTCCCGGAGTATAGCAGCAGCTGGTCGTACCCCCTACTGG	CAKSVKFSRSIAAAGRTPYW	IGHV3-23	IGHJ4
TGTGCGAGAATCACTACGGTGACTCACTGG	CARITTVTHW	IGHV3-11	IGHJ4
TGTGCGAAAGATTATTTCTCAGGCCCCATTGTAGTGGTGGTAGCTGCTACGGTCTACTACTTTGACTACTGG	CAKDYFSGPIVVVVAATVYYFDYW	IGHV3-23	IGHJ4
TGTGCGAGAGGGGAGGTTAATCCTGACCAACGACGTATTACGATTTTTGGAGTGGTTATGGGTTACTACTACTACTACTACATGGACGTCTGG	CARGEVNPDQRRITIFGVVMGYYYYYYMDVW	IGHV3-11	IGHJ6
TGTGCGAGTGGCCGTCCTGGATTACTATGGTTCAGGGAGTCGTTTTTTGACTACTGG	CASGRPGLLWFRESFFDYW	IGHV3-11	IGHJ4
TGTGCACACAGACCCTTATTGGAGTTTTTACGTACCAGCTGCTATGCCCGGTTCGACCCCTGG	CAHRPLLEFLRTSCYARFDPW	IGHV2-5	IGHJ5
TGTACTTGGGATCCCCTAAACCATTTAATCGACCCCTGG	CTWDPLNHLIDPW	IGHV3-49	IGHJ5
TGTGCAACTTCTCCGGATCAGTGGGAGCTACTATCGCGGTACTTCGATCTCTGG	CATSPDQWELLSRYFDLW	IGHV1-69-2	IGHJ2
TGTACCAGGGGGAGGAATCTGAATTCTTACGACTACTTTGACTACTGG	CTRGRNLNSYDYFDYW	IGHV3-15	IGHJ4
TGTGCGAGAGCAAACTCATATTGTGGTGGTGACTGCTATTCCCCCCACTACTGG	CARANSYCGGDCYSPHYW	IGHV3-53	IGHJ4
TGTGCAATGTATTATGTTGCGCTACGTAGAGATGGCTACAAATTATTTGACTACTGG	CAMYYVALRRDGYKLFDYW	IGHV6-1	IGHJ4
TGTGCGAAAGATCGATTGCTACTGGTCATAGCAGTGGCTGAACGGCCCTTCAACTGGTTCGACCCCTGG	CAKDRLLLVIAVAERPFNWFDPW	IGHV3-NL1	IGHJ5
TGTGCGAAAGAGGAACGATTTTTGGAGTGGTTATTAGTCCAACTTTTAAATTGG	CAKEERFLEWLLVQLLNW	IGHV3-NL1	IGHJ5
TGTACCACAGATGGTGACCATGGATATTGTAGTGGTGGTAGCTGCGTCTGG	CTTDGDHGYCSGGSCVW	IGHV3-15	IGHJ4
TGTACTAGAGATCCCCCGGGAGCGCAGTGGCTGGTACTCGGGACCGTTGTGCCTGCTTACTACTACTACTACTACATGGACGTCTGG	CTRDPPGAQWLVLGTVVPAYYYYYYMDVW	IGHV3-49	IGHJ6
TGTGCGAGAGAACTGATGTATAGCAGCAGCTGGCCTTCCCCCATCTACTGG	CARELMYSSSWPSPIYW	IGHV1-3	IGHJ4
TGTGCGAGAAAATTAGATATTGTAGTAGTACCAGCTAACTGGTTCGACCCCTGG	CARKLDIVVVPANWFDPW	IGHV4-39	IGHJ5
TGTGCGAGAGACTATAGTGGCTACGACTGGTTCGACCCCTGG	CARDYSGYDWFDPW	IGHV3-7	IGHJ5
TGTGCAACAGGGCTTGCCCATATTGTAGTAGTACCAGCTGCTTTGGTCTGGTTCGACCCCTGG	CATGLAHIVVVPAALVWFDPW	IGHV1-2	IGHJ5
TGTGCGAGTCCAGGGCAGTGGCTGGTACTTGGTATTGCTTTTGATATCTGG	CASPGQWLVLGIAFDIW	IGHV4-34	IGHJ3
TGTGCGAGACGGTCCGTAGTGGTGGTAGCTGCTACTCGTTTATGG	CARRSVVVVAATRLW	IGHV4-38-2	IGHJ5
TGTGCGAAAGATCTTCTAATCACCGCCTTAGTAGGGGTGGCGTGGTACTACTGG	CAKDLLITALVGVAWYYW	IGHV3-NL1	IGHJ4
TGTGCGAAAGATCAGTTTTTAGTACCAGCTGCTATTGCCCCAGAGACGGGACACCTCGACTACTACTACTACATGGACGTCTGG	CAKDQFLVPAAIAPETGHLDYYYYMDVW	IGHV3-23	IGHJ6
TGTGCAAGCGCAAAGATGGCTACAATCGGCCTACGCGGTAGGAGCCCCCCTCCATACGTTATTCCCCCCCCCCCATACTACTTTGACTACTGG	CASAKMATIGLRGRSPPPYVIPPPPYYFDYW	IGHV1-45	IGHJ4
TGTGCGAAAGGACGGACCAGCTGCCCGCGACCTTACTGG	CAKGRTSCPRPYW	IGHV3-NL1	IGHJ4
TGTGCGAGAGGAAATGACCGCAATATTGTAGTGGTGGTAGCTGCTACTCTTATGTGTGCGTACTACTTTGACTACTGG	CARGNDRNIVVVVAATLMCAYYFDYW	IGHV1-3	IGHJ4
TGTGCGAAAGTCCAGGGCTGGGGAGTGGTGGTGATTGCTATCTTGGTGGTCGGAAATTACTACTACTACTACATGGACGTCTGG	CAKVQGWGVVVIAILVVGNYYYYYMDVW	IGHV3-23	IGHJ6
TGTGCGAGAGACCTGTATAGCAGCAGCTGGTACCGGGGGCCCAAAGGGCCCGGACTTAACTACTGG	CARDLYSSSWYRGPKGPGLNYW	IGHV3-48	IGHJ4
TGTGCGAGAGATATCATAGTAGTGGTGGTAGCTGCTACGATGGAAGACTACTGG	CARDIIVVVVAATMEDYW	IGHV4-59	IGHJ4
TGTACCCCCCCGGAATTGTTGTCATACTACTTTGACTACTGG	CTPPELLSYYFDYW	IGHV3-15	IGHJ4
TGTGCGAGAGCCCGGCGTATAGTTTGTGGTGGTGACTGCTATTTGCATTACGCCCCTTCCTACTGG	CARARRIVCGGDCYLHYAPSYW	IGHV3-11	IGHJ4
TGTACCGGGAAAGCCAATATTGTAGTGGTGGTAGCTGCTACTTTCGCGACTCCATCATACTACTTTGACTACTGG	CTGKANIVVVVAATFATPSYYFDYW	IGHV3-9	IGHJ4
TGTGCGAGAGATTACATTTGGGGGAGTTATCGTTCATTCCGCACTCGATACTTTGACTACTGG	CARDYIWGSYRSFRTRYFDYW	IGHV5-51	IGHJ4
TGTGCGAGAGACGCACTTGTAGTAGTACCAGCTGCAACGATTTGGTTCGACCCCTGG	CARDALVVVPAATIWFDPW	IGHV3-21	IGHJ5
TGTGCGAAAGATCCGTTTCCCGTATTACGATTTTTGGAGTGGTTATTCTATTACTACTACTACTACTACATGGACGTCTGG	CAKDPFPVLRFLEWLFYYYYYYYMDVW	IGHV3-NL1	IGHJ6
TGTGCGAGAGATTTTGGAAATATTGTACTAATGGTGTATGCTAGAAGCCCTGGCCTTGACTACTGG	CARDFGNIVLMVYARSPGLDYW	IGHV4-61	IGHJ4
TGTACTAGAGGAGATATTGTAGTGGTGGTAGCTGCTACTCCAAACTGGTTCGACCCCTGG	CTRGDIVVVVAATPNWFDPW	IGHV3-49	IGHJ5
TGTACTAGAGATAAAGGGGTCTACTACATGGACGTCTGG	CTRDKGVYYMDVW	IGHV3-49	IGHJ6
TGTGCGAGACACGGAGATGATAGTAGTGGTTATTACTACGCAACGTTTGACTACTGG	CARHGDDSSGYYYATFDYW	IGHV4-39	IGHJ4
TGTTACCCACGTACGATTTTTGGAGTGGCGGGCCCGACTCACTACATGGACGTCTGG	CYPRTIFGVAGPTHYMDVW	IGHV3-23	IGHJ6
TGTGCGAGGGGTGGTTACGATTTTTGGAGTGGTTATTATGTGCGGTACTACTTTGACTACTGG	CARGGYDFWSGYYVRYYFDYW	IGHV4-39	IGHJ4
TGTGCCCTAGGGGAAAAACCAGGTTTGGGGGGGGGGCCGCGGGGGGTGTATGACTACTGG	CALGEKPGLGGGPRGVYDYW	IGHV4-34	IGHJ4
TGTGCGAGAAACCATAGTGGCTACGATTCGCGATTAGCTTACTTTGACTACTGG	CARNHSGYDSRLAYFDYW	IGHV3-66	IGHJ4
TGTGCGAGACAACGAGGATATAGCAGTGGCTGTAGCCATCTGTACTGGTACTTCGATCTCTGG	CARQRGYSSGCSHLYWYFDLW	IGHV4-39	IGHJ2
TGTGCGAGAGAGGGTATTGTAGTAGTACCAGCTGCTGGGGTATGTACATATTACTACTACTACTACTACATGGACGTCTGG	CAREGIVVVPAAGVCTYYYYYYYMDVW	IGHV7-4-1	IGHJ6
TGTACCGTTTCTCATAAAAGCCACAACTGGTTCGACCCCTGG	CTVSHKSHNWFDPW	IGHV3-15	IGHJ5
TGTGCGAGAGATTATCCAACCCCGTATTACGATTCCTGCTTCGACTACTACTACTACTACATGGACGTCTGG	CARDYPTPYYDSCFDYYYYYMDVW	IGHV4-59	IGHJ6
TGTGCGAAAGGACTCTGGCAGGGGAGGGCTCCCAAAACTGATAAGACGAACTACTACTACTACATGGACGTCTGG	CAKGLWQGRAPKTDKTNYYYYMDVW	IGHV3-NL1	IGHJ6
TGTGCACACAGTTATTTACCAGGATATTGTAGTGGTGGTAGCTGCTACTCCCTAGACTACTGG	CAHSYLPGYCSGGSCYSLDYW	IGHV2-5	IGHJ4
TGTGCGAGAGACGGTATTACTATGATAGTAGTGGTTATACGCTACTTTGACTACTGG	CARDGITMIVVVIRYFDYW	IGHV3-48	IGHJ4
TGTGCGAGAGGCGCGAGCAGCAGCAGCTGGTACTGCCCAACTTTTGACTACTGG	CARGASSSSWYCPTFDYW	IGHV4-34	IGHJ4
TGTGCGAGACAGTCGGTGGAAACCGATTGTAGTAGTACCAGCTGCTATGAACTCGACTACTGG	CARQSVETDCSSTSCYELDYW	IGHV1-69	IGHJ4
TGTGCGTCGACAGTATTACGATTTTTGGAGTGGTTATTAATTCCTAAGCTCCTCTTTGACTACTGG	CASTVLRFLEWLLIPKLLFDYW	IGHV4-61	IGHJ4
TGTGCGAGAAGTATAGCAGCAGCTGGAACTAGCGACTACTGG	CARSIAAAGTSDYW	IGHV3-21	IGHJ4
TGTGCACGGATCCGGCAGTGGCTGGTAACTGGGGTGGACTACTGG	CARIRQWLVTGVDYW	IGHV2-26	IGHJ4
TGTGCGAGGGTTATTGTAGTAGTACCAGCTGCTATATTATACTACTACATGGACGTCTGG	CARVIVVVPAAILYYYMDVW	IGHV7-4-1	IGHJ6
TGTGCGAGAGAAGAGACGGGGTACTATGGTTCAGGGAGTCCTCCCTCCTTGGCGTATAACTGGTTCGACCCCTGG	CAREETGYYGSGSPPSLAYNWFDPW	IGHV4-59	IGHJ5
TGTGCAAGAGATCGTAGCTGCTACTCCGCTGACCCTCCTGACTACTGG	CARDRSCYSADPPDYW	IGHV3-74	IGHJ4
TGTGCGAAAGAGTACGTCTCCGAGGATATTGTAGTAGGGACCGACCCCTGG	CAKEYVSEDIVVGTDPW	IGHV3-NL1	IGHJ5
TGTGCGAAAGGTCACATTATTTATATAGCAGCACAGCTTGACTACTGG	CAKGHIIYIAAQLDYW	IGHV3-23	IGHJ4
TGTGCGAGAGGGGGTATGGGGCCTACGGTGACTACTAACCCCGGCTGGTTCGACCCCTGG	CARGGMGPTVTTNPGWFDPW	IGHV3-53	IGHJ5
TGTGCGAGATTCCGGGGGTGGGGGCCCCCCTGTATTTGTAGTAGTACCAGCTGCTATAGGACGGGGATCTACTACTACTACTACATGGACGTCTGG	CARFRGWGPPCICSSTSCYRTGIYYYYYMDVW	IGHV1-2	IGHJ6
TGTGCGAGAGGGAACTACAGTAACTACGCCTACTACTACTACTACATGGACGTCTGG	CARGNYSNYAYYYYYMDVW	IGHV3-20	IGHJ6
TGTACTAGAGATCCCCGTGTACCGACCCCTTTTCCCACCTGTACTGGTGGTGTATGCTATCCCATTCCCTGGTTCGACCCCTGG	CTRDPRVPTPFPTCTGGVCYPIPWFDPW	IGHV3-49	IGHJ5
TGTGCGAGAGCCCAACTACGATTTTTGGAGTGGTTATTAAGCTCGAACTTTGACTACTGG	CARAQLRFLEWLLSSNFDYW	IGHV3-53	IGHJ4
TGTGCGAGTGTTGGGGCCAGATATTGTAGTGGTGGTAGCTGCTTTAAATCCCCGTGGTTCGACCCCTGG	CASVGARYCSGGSCFKSPWFDPW	IGHV3-48	IGHJ5
TGTGCAAGAGACCCCAAGTTCCCCGGGCGTTTCTATAGTGGCTACGACCTTGACTACTGG	CARDPKFPGRFYSGYDLDYW	IGHV3-74	IGHJ4
TGTGCGAGAGCGGTGCGTGTCCTAGGATATTGTAGTAGTACCAGCTGCTATAGGTACTACTACTACTACATGGACGTCTGG	CARAVRVLGYCSSTSCYRYYYYYMDVW	IGHV4-61	IGHJ6
TGTGCGAGAGATCCATGGGGATATTGTAGTGGTGGTAGCTGCTACGGGGCGCACTACTACTACTACTACTACATGGACGTCTGG	CARDPWGYCSGGSCYGAHYYYYYYMDVW	IGHV1-2	IGHJ6
TGTGCGAGATGGATTCCCAGCAGCTGGAGGGACCCCTGG	CARWIPSSWRDPW	IGHV5-10-1	IGHJ5
TGTGCGAGAGTCGATTTACTATGGTTCAGGCCCAAATCTGAGGAGCAGTACTACTACTACATGGACGTCTGG	CARVDLLWFRPKSEEQYYYYMDVW	IGHV3-21	IGHJ6
TGTGCGAGAGTTGTGGGCTACTATGGTTCAGGGAGTTCGTTCGTTGACTACTGG	CARVVGYYGSGSSFVDYW	IGHV3-11	IGHJ4
TGTGCAAGAGATGGGGAGTGGGAGCTACTACAAAGAGGGGGTTCTGGGGAACCGGGAGGGCAGAAAGGGATCCGCAACCATTACTACTACTACTACTACATGGACGTCTGG	CARDGEWELLQRGGSGEPGGQKGIRNHYYYYYYMDVW	IGHV3-13	IGHJ6
TGTGCGAGAGGTTATTGTAGTAGTACCAGCTGCTATGCGGTAACGAAATACTACATGGACGTCTGG	CARGYCSSTSCYAVTKYYMDVW	IGHV3-53	IGHJ6
TGTGCGAATTTCCAGCGCGTCCATTACGATTTTTGGAGTGGTTATTTAACGGTACACCCCTGCTACTACTACTACTACATGGACGTCTGG	CANFQRVHYDFWSGYLTVHPCYYYYYMDVW	IGHV3-NL1	IGHJ6
TGTGCGAAGTACCGGTTCCTGGGGGAAGTGGGAGCTACCCCAAACCAAAGATACTTCCAGCACTGG	CAKYRFLGEVGATPNQRYFQHW	IGHV3-23	IGHJ1
TGTGCGTCCAGTCCCGTTGAGTGTAGTAGTACCAGCTGCGAACAGTACAACTGGTTCGACCCCTGG	CASSPVECSSTSCEQYNWFDPW	IGHV3-43D	IGHJ5
TGTGCAAAAGATTGCGGACCCTGCGTCAGCAGTGGCTGGCTGGTGACCTTTGACTACTGG	CAKDCGPCVSSGWLVTFDYW	IGHV3-43	IGHJ4
TGTGCGAGAGACGGCATTACTATGGTTCAGGGAGTTATTATAAGGGTGCTTTGGTACTACTTTGACTACTGG	CARDGITMVQGVIIRVLWYYFDYW	IGHV1-2	IGHJ4
TGTGCGAGAGTGGGAGGTAAGGTAGTAGTACAACCCCAGTACTACTTTGACTACTGG	CARVGGKVVVQPQYYFDYW	IGHV3-11	IGHJ4
