TGTGCAAGAGGTCGGATTGTAGTGGTGGTAGCTGCTACCCATCGGTTTTGTGTCCTTGACTACTGG	CARGRIVVVVAATHRFCVLDYW	IGHV3-13	IGHJ4
TGTGCGAGGGGTCCTTATTGTACTGGTGGTGTATGCTATGGGGAGATGCACTTTGACTACTGG	CARGPYCTGGVCYGEMHFDYW	IGHV4-59	IGHJ4
TGTGCGAGACTTGGTGAGGGGGATATTGTAGTAGTACCAGCTGCTATGCCCTGGTTCGACCCCTGG	CARLGEGDIVVVPAAMPWFDPW	IGHV1-3	IGHJ5
TGTGCGAGAGCCCAAAATTACTATGGTTCGGGGAGTTATTATAACCGCACTCGGACCTACTTTGACTACTGG	CARAQNYYGSGSYYNRTRTYFDYW	IGHV1-46	IGHJ4
TGTGCGAGAGAGATGGCATTTTATATTTTTGGTTCGGGGAGTTATTATAACGGACTCCTCCTCTCAAGGCGGTTGCGGAACATGTTCCCCATTGATTTCTTTGACTACTGG	CAREMAFYIFGSGSYYNGLLLSRRLRNMFPIDFFDYW	IGHV4-34	IGHJ4
TGTGCGAGAGTGTCCTTAGGAGTTTCAAGGTTTTACGATTTTTGGAGTGGTTATTATGGGGGGCGTGCTTTTGATATCTGG	CARVSLGVSRFYDFWSGYYGGRAFDIW	IGHV4-59	IGHJ3
TGTGCAACAGGCCCTCCTACTATGATAGTAGTGGTTATTACTACGTTTAAGCTTGACTACTGG	CATGPPTMIVVVITTFKLDYW	IGHV1-24	IGHJ4
TGTGCGAGAGCTTGTCGTGGCTACGATACTTTTGACTACTGG	CARACRGYDTFDYW	IGHV1-18	IGHJ4
TGTGCGAGAGAAGGTCTTGTAGTAGTACCAGCTGCTAAAGTCATGGACGTCTGG	CAREGLVVVPAAKVMDVW	IGHV3-7	IGHJ6
TGTGCGAGAGATTGGACGTTTTTTGACTGGTTATTGGTCTTTGACTACTGG	CARDWTFFDWLLVFDYW	IGHV4-61	IGHJ4
TGTGCGAGAGGCGGGGATTCTTACGATTTTTGGAGTGGTTATTATACTTTACACTTTGACTACTGG	CARGGDSYDFWSGYYTLHFDYW	IGHV5-51	IGHJ4
TGTGCGAGAATACCCTGTAGTACGATAGCAGCAGCTGTCCACGACCCCTGG	CARIPCSTIAAAVHDPW	IGHV1-69	IGHJ5
TGTGCGAGAGATGAAGGGGGGGAGTTATGGCTTTGCTGCCCCCCGAGGTGTGATGCTTTTGATATCTGG	CARDEGGELWLCCPPRCDAFDIW	IGHV4-59	IGHJ3
TGTACCACAGTCCCCCCAGGGCCAGACTTCCCCTATGAGTATTACTATGATAGTAGTGGTTATTACTACAATTACCAATACTTCCAGCACTGG	CTTVPPGPDFPYEYYYDSSGYYYNYQYFQHW	IGHV3-15	IGHJ1
TGTGCGAAAGAGGAAGGGCAGCCACGATTTTTGGAGTGGTTATTCGGCTGGGGCTGGTTCGACCCCTGG	CAKEEGQPRFLEWLFGWGWFDPW	IGHV3-23	IGHJ5
TGTGCGAAAGATGGGCTGCCCCAGTGGCTACGATTAACCCCTTTTGACTACTGG	CAKDGLPQWLRLTPFDYW	IGHV3-23	IGHJ4
TGTGCGAGAGCCGGTCCTGGTGGTGTATGCTATTGCTACTACTACTACATGGACGTCTGG	CARAGPGGVCYCYYYYMDVW	IGHV3-7	IGHJ6
TGTGCGAGAGACGGACTGTGGGGGGGGCATATTGTGGTGGTGACTGCTATTCCCTCGTACTGG	CARDGLWGGHIVVVTAIPSYW	IGHV1-69	IGHJ4
TGTGCGAGACGCTGGGGACGGACCGGGGATTACGATTTTTGGAGTGGTTACCTGCCCCACGACTACTGG	CARRWGRTGDYDFWSGYLPHDYW	IGHV7-4-1	IGHJ4
TGTACCGTCGAATCCCCCCAAGGTTCTATAGTAGTACCAGCTGCTAGTCCCACCCGGGGGCCCTGTACGCCCGTGGACTACTGG	CTVESPQGSIVVPAASPTRGPCTPVDYW	IGHV3-49	IGHJ4
TGTGCGAGAGATGTAACGCCGAATAGTGGTGGTAGCTGCTACCAGGCTAGTGGGAACCACTACTGG	CARDVTPNSGGSCYQASGNHYW	IGHV3-20	IGHJ4
TGTGCGGGGGGGGATTACGATTTTTGGAGTGGTTATTACCACGGAAAATGGTTCGACCCCTGG	CAGGDYDFWSGYYHGKWFDPW	IGHV5-10-1	IGHJ5
TGTGCGAGAAGATCAAGTATAGTAGTAGTACCAGCTGCTATGCGGAATGACTACTGG	CARRSSIVVVPAAMRNDYW	IGHV1-18	IGHJ4
TGTGCACACAGTTCTAGCCCGGGTATAGCAGTGGCTGGTACGTATTTAGGTCCCCGGGCGTTCGGTCCATGG	CAHSSSPGIAVAGTYLGPRAFGPW	IGHV2-5	IGHJ4
TGTGCGAGACGGCCTGTGGTGGTAGCTGCTAGGATTTGGTACTTCGATCTCTGG	CARRPVVVAARIWYFDLW	IGHV3-11	IGHJ2
TGTGCGAGAGGGGATGATAGTAGTGGTTATGGTGAGGCCCCACACACTGATGCTTTTGATATCTGG	CARGDDSSGYGEAPHTDAFDIW	IGHV4-61	IGHJ3
TGTGCGAGAGATCGCTTCCTAGATTTTTGGAGTGGTTATTCGGTGTACTGG	CARDRFLDFWSGYSVYW	IGHV4-59	IGHJ4
TGTGCCAGACAGTGGCTGGTGGGGTTTGACTACTGG	CARQWLVGFDYW	IGHV3-53	IGHJ4
TGTGCGAGAGGGGCTTTATTAGTAGTACCAGCTGCTATGCGCTTGACATACTACTACTACTACATGGACGTCTGG	CARGALLVVPAAMRLTYYYYYMDVW	IGHV4-38-2	IGHJ6
TGTGCGAGTGTAGTTATACGATTTTTGGAGTGGTTATTAGGGAAAATTGACTACTGG	CASVVIRFLEWLLGKIDYW	IGHV4-34	IGHJ4
TGTGCGAGAGGTTGGAAGCCCATTATGATTACGTTTGGGGGAGTTATCGGTGATGCTTTTGATATCTGG	CARGWKPIMITFGGVIGDAFDIW	IGHV3-7	IGHJ3
TGTGCGAGAGAGGGGGTGAATATGGTTCAGGGAGTTATTATAAGGATCCCCCCTTGGTTCGACCCCTGG	CAREGVNMVQGVIIRIPPWFDPW	IGHV3-7	IGHJ5
TGTGTACGCATTGTAGTGGTGGTAGCTGCTACGAGTGGGCGGTTCGACCCCTGG	CVRIVVVVAATSGRFDPW	IGHV3-43	IGHJ5
TGTGCACGGCTTTCTGATTACGATATTTTGACTGGGGAACCATACTGGTTCGACCCCTGG	CARLSDYDILTGEPYWFDPW	IGHV2-26	IGHJ5
TGTGCGAGAGATACCTTACTATGGTTCAGGGAGTTGACTAATGACTACTGG	CARDTLLWFRELTNDYW	IGHV3-30	IGHJ4
TGTGCGAGAGGGATGAGCCTAGCAGCTAAATGTTACAACTGG	CARGMSLAAKCYNW	IGHV4-34	IGHJ4
TGTGCGAGACACCTCTTTACTGGTGGTGTATCGACATACGGCTCTTCAAAAGGTGCTTTTGATATCTGG	CARHLFTGGVSTYGSSKGAFDIW	IGHV1-2	IGHJ3
TGTGCGAGAGTCGTTGTAGTAGTACCAGCTGCTATGCCTAGTATGTACTACTACTACTACATGGACGTCTGG	CARVVVVVPAAMPSMYYYYYMDVW	IGHV3-20	IGHJ6
TGTGCGAGAGCTGTGGTGGTAGCTGCTACAACCTGCTGGTTCGACCCCTGG	CARAVVVAATTCWFDPW	IGHV4-4	IGHJ5
TGTGCGAGAGATCTCCTCCCTGATTCTCGGGGCGAAGACCTGGTGGTGTATGCTATCGACTGG	CARDLLPDSRGEDLVVYAIDW	IGHV1-2	IGHJ5
TGTGCGAGAAGTGGATATTGTAGTAGTACCAGCTGCTATCATCGGTGCCTTCCTGATGCTTTTGATATCTGG	CARSGYCSSTSCYHRCLPDAFDIW	IGHV5-10-1	IGHJ3
TGTGCGAGCACCGACCGAATTACATTTGGGGGGACGATTGACTACTGG	CASTDRITFGGTIDYW	IGHV3-7	IGHJ4
TGTGCGAGATCTCGAGGATCTTATGGTTCGGGGAGTGACTTTGACTACTGG	CARSRGSYGSGSDFDYW	IGHV4-39	IGHJ4
TGTACTAGAGATCCCCCTACTACGGTGACTAAAGGATTAGACTACTGG	CTRDPPTTVTKGLDYW	IGHV3-49	IGHJ4
TGTACCACAGATCTGCTTGCCCTCAACGGACCATCCCCGAGAACGCTGATAGTGGCTACCGGCGCCTACTGG	CTTDLLALNGPSPRTLIVATGAYW	IGHV3-15	IGHJ4
TGTGCGAGAAGGAAGTACCAGCTGCTAGGTTATCAACCGGTGTACTACTTTGACTACTGG	CARRKYQLLGYQPVYYFDYW	IGHV3-7	IGHJ4
TGTGCGAGACCGCCTCCAGGAAATTGTACTAATGGTGTATGCTATATCGGCTTTGACTACTGG	CARPPPGNCTNGVCYIGFDYW	IGHV3-7	IGHJ4
TGTGCGAAAGAGTGCATTAGCGGCTTCCCCCAGTGTTGTAGTGGTGGTAGCTGCTACCGGGAGCGAGATGCTTTTGATATCTGG	CAKECISGFPQCCSGGSCYRERDAFDIW	IGHV3-23	IGHJ3
TGTGCGAAAGATAAGTTCCCACGCTGTAATCCTGAGACCCAGATCCGGATAGCAGTGGCTGGATCAGGAAGCGACTACTTTGACTACTGG	CAKDKFPRCNPETQIRIAVAGSGSDYFDYW	IGHV3-NL1	IGHJ4
TGTGCGAGAGATCAGCCTATAACTCGACTGTTACGATTTTTGGAGTGGTTATTATACAGGCCGAACTACTACTACTACTACATGGACGTCTGG	CARDQPITRLLRFLEWLLYRPNYYYYYMDVW	IGHV1-69	IGHJ6
TGTGCGAGAGACGAGAGTATAGCAGCTCGTCGCCTCCAGCACTGG	CARDESIAARRLQHW	IGHV1-2	IGHJ1
TGTGCGAGAGATCGCTATCATGATAGTAGTGGTTATTACCCCAGGGTGATCTGG	CARDRYHDSSGYYPRVIW	IGHV4-59	IGHJ3
TGTGCGAGAGATGGTCTTACCTTAACTGGGCTCATTAGCAGTGGCTGGTACAGTACCCACTTTGACTACTGG	CARDGLTLTGLISSGWYSTHFDYW	IGHV7-4-1	IGHJ4
TGTGCGAAAATTAGGTACAAATACTGG	CAKIRYKYW	IGHV3-NL1	IGHJ4
TGTGTGGTGGGGTATAGCAGTGGCTGGTTCGGGCCGGGCTCCCCAATTGGCTTTGACTACTGG	CVVGYSSGWFGPGSPIGFDYW	IGHV1-3	IGHJ4
TGTGCGAGTTTAGGCGTATTACGATTTTTGGAGTGGTTAGGGCTCGGCTTTGACTACTGG	CASLGVLRFLEWLGLGFDYW	IGHV3-21	IGHJ4
TGTACCACAGTTCGTATTGTAGTGGTGGTAGCTGCTACATACTGG	CTTVRIVVVVAATYW	IGHV3-15	IGHJ4
TGTGCAAGAAGGGTGGCCTACCCGGCAAAGCGCTACTACTACTACTACTACATGGACGTCTGG	CARRVAYPAKRYYYYYYMDVW	IGHV3-13	IGHJ6
TGTGCACGGATAGGTCAGCAGCTCGTATTTACCGGTACTTTTGACTACTGG	CARIGQQLVFTGTFDYW	IGHV2-70	IGHJ4
TGTGCACACACCACTAATGGTATACCCGGGCTTCGTATTACTATGATAGTAGTGGTTACCGCTTTTGATATCTGG	CAHTTNGIPGLRITMIVVVTAFDIW	IGHV2-5	IGHJ3
TGTGCGAGGCTCATTCGTACCAGCTGCTATGGAGGCCATCTGATCTGGTTCGACCCCTGG	CARLIRTSCYGGHLIWFDPW	IGHV4-34	IGHJ5
TGTGCGAGCGCAATCTTGGGACGTATTACTATGATAATTTCGTCCCCACCCGAATACTTCCAGCACTGG	CASAILGRITMIISSPPEYFQHW	IGHV4-4	IGHJ1
TGTGCGAGAGATACCGATAGCAGCAGCTGGTTATTAAAAATGATGAGGTGGTTCGACCCCTGG	CARDTDSSSWLLKMMRWFDPW	IGHV3-7	IGHJ5
TGTGCGAGAGCCCACGATTGTAGTGGTGGTAGCTGCCATGTATACTACTACTACTACATGGACGTCTGG	CARAHDCSGGSCHVYYYYYMDVW	IGHV4-61	IGHJ6
TGTGCGAAAGATTTATTACGATTTTTGGAGTGGTTATTATCCGGATATGACTACTGG	CAKDLLRFLEWLLSGYDYW	IGHV3-NL1	IGHJ4
TGTGTAATTATTACGATTTTTGGAGTGGTTATTATACTACCTTTCAGGTCCTACTTTGACTACTGG	CVIITIFGVVIILPFRSYFDYW	IGHV3-30-3	IGHJ4
TGTACTAGACTATTGGATATTACGATTTTTGGAGTGCCCTGTTACTACTACTACTACATGGACGTCTGG	CTRLLDITIFGVPCYYYYYMDVW	IGHV3-73	IGHJ6
TGTGCGAGAGATTGTACTGTCAGGCTATGCCGGAAGATAGTAGTGGTTATTAACGGGGGCAACTGGTTCGACCCCTGG	CARDCTVRLCRKIVVVINGGNWFDPW	IGHV1-2	IGHJ5
TGTGCGAGAGATCCCGGTGACTACCAGGATGCTTTTGATATCTGG	CARDPGDYQDAFDIW	IGHV4-59	IGHJ3
TGTGCGAGAGCTGGCCGGGGTCATATTGTGGTGGTGACTGCTATGTTTCACTGG	CARAGRGHIVVVTAMFHW	IGHV3-21	IGHJ4
TGTGCGAGGGGGGATTGTAGTGGTGGTAGCTGCTACTTTCACTACTACTACTACTACATGGACGTCTGG	CARGDCSGGSCYFHYYYYYMDVW	IGHV3-21	IGHJ6
TGTGCACACAGTTACTATGGTTCAGGGAGTGGGCCGCTTTACCCCACCACGCAATACTTATGCCCTGGGGGGGCCGCAGGCTGGGAAAACTGGTTCGACCCCTGG	CAHSYYGSGSGPLYPTTQYLCPGGAAGWENWFDPW	IGHV2-5	IGHJ5
TGTGCGAGAGATAGTCACGGTATTGTAGTGGTGGTAGCTGCTACTCCCAACTACTGG	CARDSHGIVVVVAATPNYW	IGHV1-2	IGHJ4
TGTGGTTCCCGATACAGCGTTTACTACTTTGACTACTGG	CGSRYSVYYFDYW	IGHV7-4-1	IGHJ4
TGTGCGAGGGTTGTAGTGGTGGTAGCTGCTACGAAACGCTACTACTACTACTACTACATGGACGTCTGG	CARVVVVVAATKRYYYYYYMDVW	IGHV3-53	IGHJ6
TGTGCGAGATTTAGTTGCCCGATTGTAGTGGTGGTAGCTGCTACGGACAACTGGTTCGACCCCTGG	CARFSCPIVVVVAATDNWFDPW	IGHV1-3	IGHJ5
TGTGCGAAAGAAAATTTGGTGGAGTGGCTGGGCTGGTTCGACCCCTGG	CAKENLVEWLGWFDPW	IGHV3-23	IGHJ5
TGTGCGAGTATGGTTCAGGGAGTTATTAAGGCGAGGGACTACATGGACGTCTGG	CASMVQGVIKARDYMDVW	IGHV3-21	IGHJ6
TGTGCGAGAGGAATGACCCGGGCCCGTGCCCCCAGCTGGGTCTACTGG	CARGMTRARAPSWVYW	IGHV3-11	IGHJ4
TGTGCGAGACTGGCCGTAGCAGTGGCTGAGGGGTACACAACCCCGTACTACTTTGACTACTGG	CARLAVAVAEGYTTPYYFDYW	IGHV5-51	IGHJ4
TGTACTAGAGATCCCTGCGTAGGATATTGTAGTAGTACCAGCTGCTATGGAATCTCCCCGGACTACTGG	CTRDPCVGYCSSTSCYGISPDYW	IGHV3-49	IGHJ4
TGTGCAAGAACGGATAGCAGTGGCTGCTGCCTTGACTACTGG	CARTDSSGCCLDYW	IGHV1-45	IGHJ4
TGTGCGAGAGGGACCAATAGCAGTGGCTGCTGCTACTGGTTCCGTCTAGACTACTGG	CARGTNSSGCCYWFRLDYW	IGHV4-61	IGHJ4
TGTGCACACAGAAAGCTAACCTGTACGATTTTTGGAGTGGTTTTAGGATACTACTACTACTACATGGACGTCTGG	CAHRKLTCTIFGVVLGYYYYYMDVW	IGHV2-5	IGHJ6
TGTGCGGGTGTTCCGCCAGGTATAGCAGCAGCTGAGTATCTAAACCCTGGTTTTTACTACTACTACTACATGGACGTCTGG	CAGVPPGIAAAEYLNPGFYYYYYMDVW	IGHV4-59	IGHJ6
TGTGCGAGAGAGACAAAGGATATTGTAGTAGTACCAGCTGCTATGCCTCCGGACTACTGG	CARETKDIVVVPAAMPPDYW	IGHV3-7	IGHJ4
TGTGCGAGAACGTTGACCGTACCCCCTGTTATAGGCTTTGACTACTGG	CARTLTVPPVIGFDYW	IGHV4-61	IGHJ4
TGTGCGAGAGATCCGAAGGCGCGTGCGTGGAGCTTTGACTACATGGACGTCTGG	CARDPKARAWSFDYMDVW	IGHV1-18	IGHJ6
TGTGCGAGTTCGGGTATAGCAGCAGCTGGTACGCGGCGAAAGTTTGACTACTGG	CASSGIAAAGTRRKFDYW	IGHV7-4-1	IGHJ4
TGTGCGAGAGATACGAAAACTACCACCAATACTTCTCGTGACTACTGG	CARDTKTTTNTSRDYW	IGHV3-11	IGHJ4
TGTGCGAAGACGTGCAGTAGTACCAGTGTCGGGTTATTTGACTACTGG	CAKTCSSTSVGLFDYW	IGHV1-3	IGHJ4
TGTGCGAGAGGCTGGACTAGGGGATTCAATAGCAGCTCGTCCTGGGGGGGCTACTGG	CARGWTRGFNSSSSWGGYW	IGHV4-34	IGHJ4
TGTGCGAGAGATCGTCCAGTCCTCATATGGTGGATACAGCTATGGGCTCCTTACTACTACTACTACATGGACGTCTGG	CARDRPVLIWWIQLWAPYYYYYMDVW	IGHV1-18	IGHJ6
TGTGCGAGGAGTGGGGCAGCTCGTCAAGTTGACTACTGG	CARSGAARQVDYW	IGHV1-2	IGHJ4
TGTGCGAGAGTCCCCTGGGGTTCCTGTATAGCAGTGGCTGGTACGGGTCCCACGGCTGACTACTGG	CARVPWGSCIAVAGTGPTADYW	IGHV1-2	IGHJ4
TGTGCGAGAGAGTCGGAGTACGATTACCGATTTGACTACTGG	CARESEYDYRFDYW	IGHV1-2	IGHJ4
TGTGCGAGAGTGTGCGTGGCTCCGATTGTAGTGGTGGTAGCTGCGGTGTCGTTGATTGACTACTGG	CARVCVAPIVVVVAAVSLIDYW	IGHV3-11	IGHJ4
TGTGCGAGACCTTTAGTATTACTATGGTTCAGGGAGATTAGTGTTGACTACTGG	CARPLVLLWFREISVDYW	IGHV4-38-2	IGHJ4
TGTCCTAACCTACTGACTACGGTGACTATGGAGAAAAGCTGTGACTACTGG	CPNLLTTVTMEKSCDYW	IGHV3-30-3	IGHJ4
TGTGCGAGGGAGTGGCTGGGCTATGGTGACTACTGG	CAREWLGYGDYW	IGHV3-13	IGHJ4
