TGTGCGAGGTATGCTGTAGGGCAGGGATATTGTACCCTGGGCGTTGGGGTCTACTACTACTACTACTACATGGACGTCTGG	CARYAVGQGYCTLGVGVYYYYYYMDVW	IGHV3-7	IGHJ6
TGTGCAACAGCAGTGGCTGGTACACAATCGCCCTGGGGATACTACTGG	CATAVAGTQSPWGYYW	IGHV1-46	IGHJ4
TGTGCACGGATTGCAGGGAGTAGCAGCTCGGCCGGTGTCCCCAACTGGTTCGACCCCTGG	CARIAGSSSSAGVPNWFDPW	IGHV2-26	IGHJ5
TGTGCCCCAGTAACGTATTACGATTTTTGGAGTGGTTATTATACGTCCAGAAGTTACATGGACGTCTGG	CAPVTYYDFWSGYYTSRSYMDVW	IGHV4-61	IGHJ6
TGTGCGAACGGGAGTAGAGTATCGGTTCAGGGAGTTATTATCCTACCGATCTACTACATGGACGTCTGG	CANGSRVSVQGVIILPIYYMDVW	IGHV3-23	IGHJ6
TGTGCGAGAGAGCCAACTCTTTATTGTAGTGGTGGTAGCTGCTACATAGGAGAGTACTACTACTACTACTACATGGACGTCTGG	CAREPTLYCSGGSCYIGEYYYYYYMDVW	IGHV1-18	IGHJ6
TGTGCAAGAGACGACGTATTACGATATTTTGACTGGTTACGCGTAAACACACCCCACCTTGACTACTGG	CARDDVLRYFDWLRVNTPHLDYW	IGHV3-13	IGHJ4
TGTGCGAGAGGGGGTTTGGAGTGGTTATCGAGCTTTGACTACTGG	CARGGLEWLSSFDYW	IGHV3-48	IGHJ4
TGTGCACGGATACGCCTGTTGTTCACCTTACCCACACAGTTCATGAGGCGCGGTCGCTATTGTAGTGGTGTGTCCTACTACTACTACTACATGGACGTCTGG	CARIRLLFTLPTQFMRRGRYCSGVSYYYYYMDVW	IGHV2-26	IGHJ6
TGTGCGAGCCGGGGTACACAGGGGAACCTTTGTAGTGGTGGTAGCTGCTACTCCGTAGTAGGAGGTGATAGTCCCCACTGG	CASRGTQGNLCSGGSCYSVVGGDSPHW	IGHV1-46	IGHJ4
TGTGCGAGAGATACTGGAGGGGTATACTCCCTTGGTGGCTACAATTGGCGCCGACAGGCACGAGGGCCTTGGGACGGGTGGTTTGACTACTGG	CARDTGGVYSLGGYNWRRQARGPWDGWFDYW	IGHV3-53	IGHJ4
TGTGCGAAATTCTTCCTATACGTTATACGTATTACTATGATAGTAGTGGTTAACCGGTTTGACTACTGG	CAKFFLYVIRITMIVVVNRFDYW	IGHV3-NL1	IGHJ4
TGTGCGAAACATAGGCCACTGCTATGGGCGCTCGTTGGTGACTACTGG	CAKHRPLLWALVGDYW	IGHV3-NL1	IGHJ4
TGTGCGAGAGGGGCCCCGGTATTACGATTTTTGGAGTGGTTATTATACCGGTTGCCCCCCTACTGG	CARGAPVLRFLEWLLYRLPPYW	IGHV7-4-1	IGHJ4
TGTGCGAGGGCCTGCCGAAGGAGTGGGATAGTAGTGGTTATTAGTTTTGACTACTGG	CARACRRSGIVVVISFDYW	IGHV5-51	IGHJ4
TGTGCAAGAGGTAAAACGCGTATTACGATTTTTGGAGTGGTTATCCTTTGGGAGAACCCTATTGACTACTGG	CARGKTRITIFGVVILWENPIDYW	IGHV3-13	IGHJ4
TGTGCGAAATTTCTAGGATATTGTAGTAGTACCAGCTGCGTGAGTGGGGACTGGTTCGACCCCTGG	CAKFLGYCSSTSCVSGDWFDPW	IGHV3-23	IGHJ5
TGTGCACGGATACGTCGCGCCCTAAGCAGTGGCTGGTTGGACAAAAGACCGGGCTACTGG	CARIRRALSSGWLDKRPGYW	IGHV2-70	IGHJ4
TGTGCGAGAGGATGGGGGTTCACTACGGCGAAGCTACATCCATTATTGAGATTTGACTACTGG	CARGWGFTTAKLHPLLRFDYW	IGHV7-4-1	IGHJ4
TGTGCGAGAACTACGATTTTTGGAGTGGTTATCTCTAGTGAATATTACTACTACTACTACTACATGGACGTCTGG	CARTTIFGVVISSEYYYYYYYMDVW	IGHV5-10-1	IGHJ6
TGTGCGAGAGACGGTCGTATAGCAGTGGCTGGTTCACGGCGTGAAGACTACTGG	CARDGRIAVAGSRREDYW	IGHV1-3	IGHJ4
TGTGCAAGAGATCCGCCTAGCCGGGGTATTACTATGATAGTAGTGGTTATTTCCTGGTTCGACCCCTGG	CARDPPSRGITMIVVVISWFDPW	IGHV3-13	IGHJ5
TGTGCGAGGATCCCTTCGTCTTATGATTACATTTGGGGGAGTTATCGTTACGAATCGACCCCCGGTGAACGTACCTCCGCCCCCTGG	CARIPSSYDYIWGSYRYESTPGERTSAPW	IGHV3-21	IGHJ4
TGTGCGAGAGGCGTTCTTGTAGTGGTGGTAGCTGCTACTCAAGTGTACAACTGGTTCGACCCCTGG	CARGVLVVVVAATQVYNWFDPW	IGHV4-34	IGHJ5
TGTGCGAAAGATCGGAACGAGATATACGATTGTGGTGGTGATTGCTATTCGGGAGGAGTCTACTGG	CAKDRNEIYDCGGDCYSGGVYW	IGHV3-23	IGHJ4
TGTGCGAGACCGGACAGTATTACTATGGTTCGGGGAGTTATCGCCTGGGCATGCTTTTTGACCTCGTACTACTTTGACTACTGG	CARPDSITMVRGVIAWACFLTSYYFDYW	IGHV4-59	IGHJ4
TGTGCACGGATACTGGGGCGCTATTACTATGGTTCGGGGAGTTATCGGGGAAACTGGTTCGACCCCTGG	CARILGRYYYGSGSYRGNWFDPW	IGHV2-70	IGHJ5
TGTGCGAGTATAGCAGTGGCTGGTACAGCCCCCTACTTTGACTACTGG	CASIAVAGTAPYFDYW	IGHV3-7	IGHJ4
TGTGCGAGAGCGGTGGGGCGTTACTACTACTACTACTACATGGACGTCTGG	CARAVGRYYYYYYMDVW	IGHV4-34	IGHJ6
TGTGCACAGAGCCCCGTGTATGCTATGCTTGTTATTGGCTACTGG	CAQSPVYAMLVIGYW	IGHV3-64	IGHJ4
TGTGCGGCATTGAGGGGGTCCGGACTTACTATGATAGTAGTGGTTATTACTGCGGTCTACTGG	CAALRGSGLTMIVVVITAVYW	IGHV3-20	IGHJ4
TGTGCGAGATGGCAGAGGGGGCGGGGGTTGGTGGTAGCTGCTACTCAATACTACTACTACTACATGGACGTCTGG	CARWQRGRGLVVAATQYYYYYMDVW	IGHV3-11	IGHJ6
TGTGCGAAAGAGAGAGTACACGAGCCCGGTGTGGTGGTGACTGGCCTGGCCCATGGGCGGTACTTTGACTACTGG	CAKERVHEPGVVVTGLAHGRYFDYW	IGHV3-23	IGHJ4
TGTGCGCCGGCCCCGTTACTAATGCCGAGCATCGACCAGCACTGG	CAPAPLLMPSIDQHW	IGHV3-20	IGHJ1
TGTACTAGACATCTCGGAAGGTATTACTATGATAGTAGTGGTTATTACTCTACGCTCGGGTTCCAGCACTGG	CTRHLGRYYYDSSGYYSTLGFQHW	IGHV3-73	IGHJ1
TGTGCGAGAGATGGGACCCTTCATAATCGGAAGGGGAGTATTACGATTTTTGGAGTGGTTATTGCCGGGGAAGGTTACTACTTTGACTACTGG	CARDGTLHNRKGSITIFGVVIAGEGYYFDYW	IGHV3-53	IGHJ4
TGTGCGAAAGATAATATAGCAGTGGCTGGTAAGTGCCATCTTGGGAGTGCTTTTGATATCTGG	CAKDNIAVAGKCHLGSAFDIW	IGHV3-23	IGHJ3
TGTGCGAGGGCTCGGTCCACGGATTCTAGCCGGGGAGTTGGTTGTGACTACTGG	CARARSTDSSRGVGCDYW	IGHV3-21	IGHJ4
TGTGCGAGGACCTACGAGCCCTCTATGGTTCAGGGAGTTATTACGATGCTCTCCGACTACTGG	CARTYEPSMVQGVITMLSDYW	IGHV4-59	IGHJ4
TGTGCACGGAATCAATTCACGTATAGCAGTGGCTGGGGGGCGGACTACTGG	CARNQFTYSSGWGADYW	IGHV2-26	IGHJ4
TGTGCACACACAAACTATTACTATGGTTCAGGGAGTGGATTTGACTACTGG	CAHTNYYYGSGSGFDYW	IGHV2-5	IGHJ4
TGTGCGAAAGATGCGGTCAGTTATAGCAGTGGCTGGTACAGGGACTCACATGACTACTGG	CAKDAVSYSSGWYRDSHDYW	IGHV3-23	IGHJ4
TGTGCAAAACGCATGACTACAGTAAGGGGGGTTTCATTTAGGGTTTCATACTACTACTACTACTACATGGACGTCTGG	CAKRMTTVRGVSFRVSYYYYYYMDVW	IGHV3-43D	IGHJ6
TGTGCGAGAAGCAGTAGTGGGGGCTTTGACTACTGG	CARSSSGGFDYW	IGHV4-28	IGHJ4
TGTGCGAAAGGATATATGTCTTACTTTGACTACTGG	CAKGYMSYFDYW	IGHV3-23	IGHJ4
TGTGCGAGAGCGGACGATATGATTACGTTTGGGGGAGTTATCGTTTCGTCGTGG	CARADDMITFGGVIVSSW	IGHV3-53	IGHJ5
TGTGCGAGAGATCGTTGGTGGTATTACGATTTTTGGAGTGGTTATTATAGGCCTGGGTACTACTTTGACTACTGG	CARDRWWYYDFWSGYYRPGYYFDYW	IGHV3-21	IGHJ4
TGTGCTAGAGACATGTGGGAAAGTGGGAGCTACTATCGGTGG	CARDMWESGSYYRW	IGHV3-72	IGHJ5
TGTGCGAAAGATAGGGTAGGGTGGGCCTTACCTTGCTTTGACTACTGG	CAKDRVGWALPCFDYW	IGHV3-NL1	IGHJ4
TGTGCGAGAGTAGTGTCTACGGTGACTAGAGTCGACTACTGG	CARVVSTVTRVDYW	IGHV3-21	IGHJ4
TGTGCGAAAGACGAGTGTAGTGGTGGTAGCTGCTACCGCTACTGG	CAKDECSGGSCYRYW	IGHV3-23	IGHJ4
TGTGCGAAAGATCTATTGGGCGTGGGTCCGGCATATTGTGGTGGTGATTGCTATTCCCCGGACTACTGG	CAKDLLGVGPAYCGGDCYSPDYW	IGHV3-NL1	IGHJ4
TGTGCGAGAGATCCCAGTATAGCAGCAGCTGGTCGGGGTAACTGGTTCGACCCCTGG	CARDPSIAAAGRGNWFDPW	IGHV3-21	IGHJ5
TGTGCAAGGGTCCAGCCGGCTTTTGATATCTGG	CARVQPAFDIW	IGHV3-74	IGHJ3
TGTGCGAGACATGGACCCCCCTTTCCGTCCCATACCCAATGCCTATTGCGGGCATTACGATATTTTGACTGGTTATTTATCGGGCCGACAAAAGGTCACCCTGACGGTGACTACTGG	CARHGPPFPSHTQCLLRALRYFDWLFIGPTKGHPDGDYW	IGHV5-51	IGHJ4
TGTGCAAGAGTAAGCTCAAAGACTATGGTTCAGGGAGTTATTTTGTCAGGCCCCTCCTGGTTCGACCCCTGG	CARVSSKTMVQGVILSGPSWFDPW	IGHV3-13	IGHJ5
TGTGCGAGAGAAGTCCATTTCCGGATACAGCTATGGTTGGAAGTAAACTGGTTCGACCCCTGG	CAREVHFRIQLWLEVNWFDPW	IGHV4-61	IGHJ5
TGTACGATGGGAAGCAGTGGCTGGTTAAGGGTAAAAGCCTGG	CTMGSSGWLRVKAW	IGHV3-49	IGHJ4
TGTGCGAGCAGGGCCGGGGAGCAGCTGGTACACGTTTGGGACACCCACTGG	CASRAGEQLVHVWDTHW	IGHV1-18	IGHJ4
TGTGCGAGAGGGAAGGGTAGCTGCTACGCGCCCGGGCCCTCCTTTGACTACTGG	CARGKGSCYAPGPSFDYW	IGHV1-3	IGHJ4
TGTGCGAGAGCCAAATATAGCAGCCACCGACTCTCCGGCCATGATGCTTTTGATATCTGG	CARAKYSSHRLSGHDAFDIW	IGHV3-30	IGHJ3
TGTGCGAAACGGTATGCTACGTGGATACAGCTATGGTTATGGGATCCTCACTACTGG	CAKRYATWIQLWLWDPHYW	IGHV3-NL1	IGHJ4
TGTGCGAGAGAGATAGTGGTGGTAGCTGCTACTCAGGCCTCCGGTAGGGCCGGACTGTGGGAGTTTGACTACTGG	CAREIVVVAATQASGRAGLWEFDYW	IGHV1-69	IGHJ4
TGTGCGAGAGTCCAGGCCTCCCCGGATTGTAGTAGTACCAGCTGCTATCCCTACAACTGGTTCGACCCCTGG	CARVQASPDCSSTSCYPYNWFDPW	IGHV1-18	IGHJ5
TGTGCGAGAGGCCGCCTCTGGCTGTACTACTTTGACTACTGG	CARGRLWLYYFDYW	IGHV4-61	IGHJ4
TGTGCAAGATGGCCCCATACGATTTTTGGAGTGGCTTCTCTTTTTGACTACTGG	CARWPHTIFGVASLFDYW	IGHV3-13	IGHJ4
TGTGCGAGACATCCCCCTTTGGAGACCAGCAGCTGGTACGGATTTGACTACTGG	CARHPPLETSSWYGFDYW	IGHV5-51	IGHJ4
TGTGCGAGCGCCCTAGACTACGATATTTTGCAGTACTGG	CASALDYDILQYW	IGHV3-53	IGHJ4
TGTGCGAGAGATCGGGATTGTAGTAGTACCAGCTGCTATGGGCTCTACTACTACTACTACATGGACGTCTGG	CARDRDCSSTSCYGLYYYYYMDVW	IGHV4-59	IGHJ6
TGTGCGAGAGATATCCTGTTCTTCCCAGCTGCGGGCTGGTTCGACCCCTGG	CARDILFFPAAGWFDPW	IGHV3-64	IGHJ5
TGTGCGAGAGATCATAAGCTGCTACTCCGCGCCTACTGG	CARDHKLLLRAYW	IGHV3-11	IGHJ4
TGTGCGGTCACCCTGCTTTTGCGCCGACACGGTCCACCGTGGCTACGATCGGGAAAACAAATGGAGGAATCCATCTTTTATTACTACTACTACTACTACATGGACGTCTGG	CAVTLLLRRHGPPWLRSGKQMEESIFYYYYYYYMDVW	IGHV3-30	IGHJ6
TGTGCGAGAGAATCCCAGGTACTACCAGCTCGTCCGGGCCAAACGGGCTTTGACTACTGG	CARESQVLPARPGQTGFDYW	IGHV3-21	IGHJ4
TGTGCGAGGTGGAGTAGCTGCTACAAAAACACGGGACGGTTTGACTACTGG	CARWSSCYKNTGRFDYW	IGHV1-2	IGHJ4
TGTGCGAAAGATCAAGTGGGAGCTGGGGTTGACTACTGG	CAKDQVGAGVDYW	IGHV3-NL1	IGHJ4
TGTACCTGGAATTCGTGCTACTTTGACTACTGG	CTWNSCYFDYW	IGHV3-49	IGHJ4
TGTGCGAAATATAGGCGCGGTATTACTATGATAGTAGTGGTTATTACACACCTCGCGGGTAGTGGCCGTGACTACTGG	CAKYRRGITMIVVVITHLAGSGRDYW	IGHV3-23	IGHJ4
TGTGCGAAACCTGTGGAAAAATCTGGACGCTACCCAGACTACTGG	CAKPVEKSGRYPDYW	IGHV3-23	IGHJ4
TGTGCGAGAGAGGCGGTGGCTTTATTTTTTGGCTCTGACTACTACTACTACATGGACGTCTGG	CAREAVALFFGSDYYYYMDVW	IGHV1-46	IGHJ6
TGTGCGAGAGATGGTATTGTAGTGGTGGTAGCTGCTACTCGCAACCGGAAGAGGATCCTGGACTACTGG	CARDGIVVVVAATRNRKRILDYW	IGHV3-66	IGHJ4
TGTGCGAGATTGGAATCTGATATTGTAGTGGTGGTAGCTGCTACTCTTATGCTAGGAGACTGGTTCGACCCCTGG	CARLESDIVVVVAATLMLGDWFDPW	IGHV5-10-1	IGHJ5
TGTGCGAGAGTATTCAAGAGTGGTTATCGCTACTACTACTACTACATGGACGTCTGG	CARVFKSGYRYYYYYMDVW	IGHV3-7	IGHJ6
TGTGCGAGAGCGGGCAGGGGGAGAGCAGTGGCTGACGGACGTAAGCCAAGCTGG	CARAGRGRAVADGRKPSW	IGHV4-34	IGHJ5
TGTGCGACCCCGACCTACTGG	CATPTYW	IGHV4-4	IGHJ4
TGTGCGAGACGTTATTGTACTGGTGGTGTATGCGGGAGAATCACGATATACTACTACTACATGGACGTCTGG	CARRYCTGGVCGRITIYYYYMDVW	IGHV4-34	IGHJ6
TGTGCGAGAGATCATCTCCTTGGGTTACGATATTTTGACTGGTTATTAAGGTACTTTGACTACTGG	CARDHLLGLRYFDWLLRYFDYW	IGHV4-59	IGHJ4
TGTGCGAGACAGATCATTGATATTGTAGTAGTACCAGCTGCTATGCCGCGTTCATACTACTACTACTACATGGACGTCTGG	CARQIIDIVVVPAAMPRSYYYYYMDVW	IGHV4-39	IGHJ6
TGTGCGAAAATAATAGCAGCAGCTGCGCGGAAACCTTCCTGGTTCGACCCCTGG	CAKIIAAAARKPSWFDPW	IGHV3-23	IGHJ5
TGTGCGAAAGATAACACCCGGGGAGTAGGATATTGTAGTAGTACCAGCTGCTATACAACCGGGTGGCTCTTTGACTACTGG	CAKDNTRGVGYCSSTSCYTTGWLFDYW	IGHV3-NL1	IGHJ4
TGTGCGAAAGCCTATTACGATATTTTGACTGGTTATTGGTGTTTGGTCTACTACTACTACTACATGGACGTCTGG	CAKAYYDILTGYWCLVYYYYYMDVW	IGHV3-NL1	IGHJ6
TGTGCGAGGGATACTTCCCATGTCTGTAGTAGTACCAGCTGCCCTAAGTTGGGGTACTACTTTGACTACTGG	CARDTSHVCSSTSCPKLGYYFDYW	IGHV3-7	IGHJ4
TGTGCGAGAACTTTTGGGAGAGATTGTAGTAGTACCAGCTGCTTAGGGAGCTGG	CARTFGRDCSSTSCLGSW	IGHV4-38-2	IGHJ5
TGTACTAGACCCTTGGAGTGGTTATTATACCCCCCTGGGCGACTCTTTGACTACTGG	CTRPLEWLLYPPGRLFDYW	IGHV3-73	IGHJ4
TGTGCGAGACCACGAAGTAGCAGCAGCTCCCGGAAATTGGGAAGCTACTACTACTACTACATGGACGTCTGG	CARPRSSSSSRKLGSYYYYYMDVW	IGHV4-38-2	IGHJ6
TGTGCTAGAGATGTGCTCGACAGTCAGCAGCTCGTCCGAATTTACTGG	CARDVLDSQQLVRIYW	IGHV3-72	IGHJ4
TGTGCGAGCGAGTACGATATTTTGACTGGTTTAACCCGGTTGAGGTGGTTCGACCCCTGG	CASEYDILTGLTRLRWFDPW	IGHV1-3	IGHJ5
TGTGCAACAGCTTCAAACCGATGGGCGGCCAGCTGCTATACTAACTGG	CATASNRWAASCYTNW	IGHV1-24	IGHJ4
TGTGCGGAGGTTGTAGTGGTGGTAGCTGCTACCGCACCCTTTGACTACTGG	CAEVVVVVAATAPFDYW	IGHV3-23	IGHJ4
TGTGCACGGATATCACCTGTCCAACCCTCACAGCAGCGCGAGCCCCGGCGAGGAGGATATTGTAGTGGTGGTAGCTGCTACTCCGGGCACTGG	CARISPVQPSQQREPRRGGYCSGGSCYSGHW	IGHV2-26	IGHJ4
TGTGCGAATATTGGGGGATATTGTAGTGGTGGTAGCTGCTACAAGGCCTCGGGGGGTGACTACTGG	CANIGGYCSGGSCYKASGGDYW	IGHV3-NL1	IGHJ4
