TGTGCGAGAGATTCCAGGGTCTATCTGGTTCAGGGAGTTATTCAAGCCGCTTTTGATATCTGG	CARDSRVYLVQGVIQAAFDIW	IGHV4-61	IGHJ3
TGTGCGAGAGTAGTCGACCGCCTTGTAGTAGTACCAGCTGAAAGGCTTGACTACTGG	CARVVDRLVVVPAERLDYW	IGHV3-11	IGHJ4
TGTGCGAGAGGACCCGGAATTGTAGTGGTGGTAGCTGCTAAGGTCCGAGGACCGTGGTTCGACCCCTGG	CARGPGIVVVVAAKVRGPWFDPW	IGHV4-39	IGHJ5
TGTGCGAAACCTTATAGCAGCAGCTGGTACACTATAGTCGACTACTGG	CAKPYSSSWYTIVDYW	IGHV3-23	IGHJ4
TGTGGGCCGCCGGGAAGGCCCAGTGGCTGGTACTTTGATATCTGG	CGPPGRPSGWYFDIW	IGHV3-30-3	IGHJ3
TGTGCGAGAGCCACGCGGGAAACGTATAGCAGCAGCTGGAGCGACTACTGG	CARATRETYSSSWSDYW	IGHV4-59	IGHJ4
TGTGCGACCCTAGTCCCTCGTATTACTATGATAGTAGTGGTTAAAAAGAATTCGTGGGGCCGGGCGGGGGATGCTTTTGATATCTGG	CATLVPRITMIVVVKKNSWGRAGDAFDIW	IGHV1-2	IGHJ3
TGTGCGAGAGTCGGGAGTGGTGGTAGCTGCTACTCGTGCTGG	CARVGSGGSCYSCW	IGHV3-11	IGHJ4
TGTGCGAGCCTCCCCTATGCATATTGTAGTGGTGGTAGCTGCTACTCCAGGGTTGACTACTGG	CASLPYAYCSGGSCYSRVDYW	IGHV1-3	IGHJ4
TGTGCGAGAGATGGATGCGTTACTATGGTTCGGGGAGTTACCTGCTTCATGCACTTTGACTACTGG	CARDGCVTMVRGVTCFMHFDYW	IGHV3-11	IGHJ4
TGTGCGAAAGATGGACGGCGTTGTAGTAGTACCAGCTGCTACCGGGGGCCCCACTGGTTCGACCCCTGG	CAKDGRRCSSTSCYRGPHWFDPW	IGHV3-23	IGHJ5
TGTGCGAAAGCCCCAGGATTTTTGGGGGTCCCGTATTACTACTACTACTACTACATGGACGTCTGG	CAKAPGFLGVPYYYYYYYMDVW	IGHV3-23	IGHJ6
TGTGCGAGCCTCCGGTGCTTGGGACTACAGTACATGGCTCACTGGTTCGACCCCTGG	CASLRCLGLQYMAHWFDPW	IGHV3-21	IGHJ5
TGTGCGAGAGATCCTGGGTTGCACGGCCGTATTACTATGATAGTAGTGGTTAAGGAAATCGTTTTTAAGCAACCCGATCTTGACTACTGG	CARDPGLHGRITMIVVVKEIVFKQPDLDYW	IGHV3-7	IGHJ4
TGTGCAAAAGATATAGTGATAGTAGTGGTTATTACTACATGCCTTTTTGACTACTGG	CAKDIVIVVVITTCLFDYW	IGHV3-43	IGHJ4
TGTGCGAGACCTATTGTAGTAGTACCAGCTGCTATTTCTCCTTCGCCCAGGTGGGGCCAACGCGAGGGGGATTACTACTACTACTACTACATGGACGTCTGG	CARPIVVVPAAISPSPRWGQREGDYYYYYYMDVW	IGHV7-4-1	IGHJ6
TGTGCGCCTTGGGTGCTTTCATATTGTAGTGGTGGTAGCTGCTACCTACGGCTTGGGAACGTAGTATACTTTGACTACTGG	CAPWVLSYCSGGSCYLRLGNVVYFDYW	IGHV1-3	IGHJ4
TGTGCGAGAGCCCTGCGCCCAATTAAGACTATGATAGTACGTACCCACCAAAATGATGCTTTTGATATCTGG	CARALRPIKTMIVRTHQNDAFDIW	IGHV3-30	IGHJ3
TGTGCGAGACGATTTTCCGTATCCTATACATGCCATATTACGATTTTTGGAGTGGTTATGGGGAATGGTTTTCCGGGGATGATTGACTACTGG	CARRFSVSYTCHITIFGVVMGNGFPGMIDYW	IGHV5-51	IGHJ4
TGTGCGAGAGATTATTGTAGTGGTGGTAGCTGCTACGTTGACTACTGG	CARDYCSGGSCYVDYW	IGHV1-18	IGHJ4
TGTGCGAGACGGCTAGGTGGTAACTCCGTTCTTCACAACTGGTTCGACCCCTGG	CARRLGGNSVLHNWFDPW	IGHV1-69	IGHJ5
TGTGCGAAAGATCGCCAGGACCCCTCGAGCTTTGACTACTGG	CAKDRQDPSSFDYW	IGHV3-23	IGHJ4
TGTGCGAAAGATGTTACGATTTTTGGAGTGGTTATTAGCATTGATTACTACTACTACTACTACATGGACGTCTGG	CAKDVTIFGVVISIDYYYYYYMDVW	IGHV3-23	IGHJ6
TGTGCGAAAGGCCATGACTACGGTGACTACGATTTCGTTGTTGACTGG	CAKGHDYGDYDFVVDW	IGHV3-NL1	IGHJ4
TGTGCTTTTCGGTACCAGCTGCGCCATGTTGACTACTGG	CAFRYQLRHVDYW	IGHV4-38-2	IGHJ4
TGTGCGAGAGTCCGGGCTCCCAACCCGGTTGAAATTGTAGTAGTACCAGCTGCGGGCTGGTTCGACCCCTGG	CARVRAPNPVEIVVVPAAGWFDPW	IGHV7-4-1	IGHJ5
TGTGCGAGAACCTTAGTAACACGAGTATATTGTAGTAGTACCAGCTGCTATAAACCGGATTTGGGGCGGAGGGTCGACCCCTGG	CARTLVTRVYCSSTSCYKPDLGRRVDPW	IGHV1-46	IGHJ5
TGTGCGAGACGCCCTATACAGGATAGCAGCTCGGATTTCGTGTACCGGGCCGGGGACTTTGACTACTGG	CARRPIQDSSSDFVYRAGDFDYW	IGHV5-51	IGHJ4
TGTGCGTCCCCCGACCGTATTACGATTTTTGGAGTGGTTATTCATTTTACTCGGTACTACTACTACTACATGGACGTCTGG	CASPDRITIFGVVIHFTRYYYYYMDVW	IGHV3-11	IGHJ6
TGTACCACACTCTTACGTATTACTATGATAGTAGTGGTTATTAGATTTGACTACTGG	CTTLLRITMIVVVIRFDYW	IGHV3-15	IGHJ4
TGTGCGAGAATCGTAGCAGCAGCTGGGGCACGGGACTACTGG	CARIVAAAGARDYW	IGHV4-38-2	IGHJ4
TGTGCGAAGAACGATATTGTAGTAGTACCAGCTGCTATACTAAGGATTTTTGACTACTGG	CAKNDIVVVPAAILRIFDYW	IGHV3-NL1	IGHJ4
TGTGCGAAAGATCGTGCTAGCTCATTACGATTTTTGGAGTGGTTATTATCCCGTCGCTTTGACTACTGG	CAKDRASSLRFLEWLLSRRFDYW	IGHV3-23	IGHJ4
TGTGCTTGGTATAGCAGTGGCTGGTACCAACTCCCAGGCTACTACTACTACTACTACATGGACGTCTGG	CAWYSSGWYQLPGYYYYYYMDVW	IGHV3-NL1	IGHJ6
TGTGCGAGAAGCTCCGTCCATTACGATTTTTGGAGGTATGACTACTGG	CARSSVHYDFWRYDYW	IGHV4-38-2	IGHJ4
TGTGCGAGACGTACCGTTACTATGATAGTAGTGGTTCCAATTGACTACTGG	CARRTVTMIVVVPIDYW	IGHV5-51	IGHJ4
TGTACCCCGGCCATAGCAGCAGCTTGCCAATTTGACTACTGG	CTPAIAAACQFDYW	IGHV3-15	IGHJ4
TGTGCGAGACTTTATTACGATATTTTGACTGGTCTCTACTACTACTACATGGACGTCTGG	CARLYYDILTGLYYYYMDVW	IGHV4-39	IGHJ6
TGTGCGAGAGGTGGTTCAGGGAGAATAGACTACTACTACTACTACATGGACGTCTGG	CARGGSGRIDYYYYYMDVW	IGHV1-69	IGHJ6
TGTGCGAGAGACAAAGAGGGAGGGGGTGTGGGAGGGTCGTACTACTTTGACTACTGG	CARDKEGGGVGGSYYFDYW	IGHV4-34	IGHJ4
TGTGCGAGAGGGGTTGAAGCCGCGGGCTTCCCCACGTGGTGGTCCCTTGGGACCCAATTCCTGTATTGG	CARGVEAAGFPTWWSLGTQFLYW	IGHV3-66	IGHJ4
TGTGCGAAAGCGCGGCGGAATACCCGTGCGCAAGATGATGCTTTTGATATCTGG	CAKARRNTRAQDDAFDIW	IGHV3-NL1	IGHJ3
TGTGCGAGAGACCGCTGGTGTGCCTTGCGTGCAGCTGGTACATGGGACTACTACTACTACTACATGGACGTCTGG	CARDRWCALRAAGTWDYYYYYMDVW	IGHV3-11	IGHJ6
TGTGCGAGAGTAGCGCAGCCACAAGTGATTACTATGATAGTAGTGGCAGAGATCCCCGGGGGCTGGTTCGACCCCTGG	CARVAQPQVITMIVVAEIPGGWFDPW	IGHV3-20	IGHJ5
TGTGCGAAAGACCCCCTGAAGATGCCCAGCAGCTCGTCGTGCTGGTTCGACCCCTGG	CAKDPLKMPSSSSCWFDPW	IGHV3-NL1	IGHJ5
TGTACCACTAATAGATATTGTAGTGGTGGTCCTATAGTCCCGATCAAGGACTCTAGACTCGGTGACTACTGG	CTTNRYCSGGPIVPIKDSRLGDYW	IGHV3-15	IGHJ4
TGTGCGAGAACGTCCCTTAGGTGGTCGACGTATTACTATGATAGTAGTGGTTATTGGGTTCCAAGCCGTGTATCCCGATCCGACTACTGG	CARTSLRWSTYYYDSSGYWVPSRVSRSDYW	IGHV7-4-1	IGHJ4
TGTGCGAGATCCAATAGCTACGGTGACTACGTGGGGACAAAGGGAAGCTCGGGGGCGGATGCTTTTGATATCTGG	CARSNSYGDYVGTKGSSGADAFDIW	IGHV3-11	IGHJ3
TGTGCGAGAGATCTTTGGTCTGATAGTAGTGGTTATCTCTTTGACTACTGG	CARDLWSDSSGYLFDYW	IGHV3-66	IGHJ4
TGTTCTTACCCATTTGGGGGAGTTATCGTTATACCGGAAACGTTCCGGTACTACTTTGACTACTGG	CSYPFGGVIVIPETFRYYFDYW	IGHV3-30-3	IGHJ4
TGTGCGGGATATGACTACGGTGACTACGACCCGACAGACTGG	CAGYDYGDYDPTDW	IGHV3-66	IGHJ4
TGTGCCGAAGTTGCCTACCGACCCTCAGATGGGGGGGGTCCGCCCATAGGTGAGTATTGTAGTAGTACCAGCTGCTATAAGCTGGTGTTAACCCTGTGCTTTGACTACTGG	CAEVAYRPSDGGGPPIGEYCSSTSCYKLVLTLCFDYW	IGHV1-45	IGHJ4
TGTAGTGGCGGCACATATTGTACTGGTGGTGTATGCTATAGCCCTGGACTAGGGTACAACTGGTTCGACCCCTGG	CSGGTYCTGGVCYSPGLGYNWFDPW	IGHV1-18	IGHJ5
TGTGCGAGAAGTCGGCGGATCCCCAACCCTGGTATAGCAGCAGCTGGTACAAAAAGTTACTACTACTACTACTACATGGACGTCTGG	CARSRRIPNPGIAAAGTKSYYYYYYMDVW	IGHV4-38-2	IGHJ6
TGTGCGAAAGCCCCTCGGGGGCATATTGTGGTGGTGACTGCTATTCCGAGGTCTGCTTTTGATATCTGG	CAKAPRGHIVVVTAIPRSAFDIW	IGHV3-23	IGHJ3
TGTGCGAGAGCCCATACTATGATAGTAGTGGTTAAACCGCGTAGCTACTGG	CARAHTMIVVVKPRSYW	IGHV4-34	IGHJ4
TGTGCGAAAGATCTTATTCCTGGCTCTTGTGTTGCGTGCCACTTTGACTACTGG	CAKDLIPGSCVACHFDYW	IGHV3-NL1	IGHJ4
TGTGCGAGACGGAGATATTGTAGTGGTGGTAGCTGCTACTCGAACTACTTTGACTACTGG	CARRRYCSGGSCYSNYFDYW	IGHV5-10-1	IGHJ4
TGTGCGAGAGAGCGTATAGCAGCTCGTCCACCGACCTACTTTGACTACTGG	CARERIAARPPTYFDYW	IGHV4-61	IGHJ4
TGTGCGAGACGGATTGTAGTGGTGGTAGCTGCTACGCAGTACGGTGACCGCGACAACTGGTTCGACCCCTGG	CARRIVVVVAATQYGDRDNWFDPW	IGHV3-11	IGHJ5
TGTGGGTATTGTAGTAGTACCAGCTGCTATGACCCTTACTACTTTGACTACTGG	CGYCSSTSCYDPYYFDYW	IGHV3-30-3	IGHJ4
TGTGCGAAGTATTACTATGATAGTAGTGGTTATTATTCATGTGCCTCCTTCACCTCGGTTGACTACTGG	CAKYYYDSSGYYSCASFTSVDYW	IGHV3-NL1	IGHJ4
TGTGCAAGAGGAACGTATTACTATGGTTCAGGGAGTTTGCGAATTGACTACTGG	CARGTYYYGSGSLRIDYW	IGHV3-13	IGHJ4
TGTGCGAGAGCGACCTCCTGTGGCTCCCTAGGATATTGTAGTAGTACCAGCTGCTATAAAACCCATTTGAGTAGCTTAAGTATTGACTACTGG	CARATSCGSLGYCSSTSCYKTHLSSLSIDYW	IGHV4-34	IGHJ4
TGTGCGAGTATTTTTGGAGTGGTTATTATCTTGGGGCACTGG	CASIFGVVIILGHW	IGHV3-53	IGHJ4
TGTGCGAGAGAACCCCGTCAATATTACGATTTTTGGAGTGGTTATTTCTGG	CAREPRQYYDFWSGYFW	IGHV4-34	IGHJ3
TGTGCGAGAGTCGCTATAGTGGCTACGATTCCTGACTACTGG	CARVAIVATIPDYW	IGHV4-59	IGHJ4
TGTGCGAGACGGCCTAGCAGCAGCCACTCGTACTTTGACTACTGG	CARRPSSSHSYFDYW	IGHV5-51	IGHJ4
TGTACTAGAGCCCAAGAGATGGCTACAACTCGGTGTGACCGTCGAGGCTTTGACTACTGG	CTRAQEMATTRCDRRGFDYW	IGHV3-49	IGHJ4
TGTGCGAGAGAGGGTAGCCCGATTATTGTAGTAGTACCAGCTGCTACTCACTGGTTCGACCCCTGG	CAREGSPIIVVVPAATHWFDPW	IGHV1-69	IGHJ5
TGTGCGAGAGAGAGCGGTGATTTGGGTTTTGACTACTGG	CARESGDLGFDYW	IGHV3-53	IGHJ4
TGTGCGAAAGATCCAAGAAGAACCTTTTACTACTGG	CAKDPRRTFYYW	IGHV3-NL1	IGHJ4
TGTGCGAGATCAGTTAATAGCAGTGGCTGGTACGGGGTCAGCACTCGCTACTACTACTACTACATGGACGTCTGG	CARSVNSSGWYGVSTRYYYYYMDVW	IGHV1-3	IGHJ6
TGTGGGGGAGTAGGATATTGTAGTAGTACCAGCTGCGGTGTTCGGAACGAGGAAGCAGGTGACTACTGG	CGGVGYCSSTSCGVRNEEAGDYW	IGHV1-3	IGHJ4
TGTGCGAGAGGCGGGGTCACCCCTCACAGTAACTTGGCCAAGGTCCGTGCCTTTGACTACTGG	CARGGVTPHSNLAKVRAFDYW	IGHV4-34	IGHJ4
TGTGCGAGAGGCCTAAAGGGATATTGTAGTAGTACCAGCTGCTTGAATTACTACTACTACTACATGGACGTCTGG	CARGLKGYCSSTSCLNYYYYYMDVW	IGHV1-2	IGHJ6
TGTGCGAGACGAAATTTAGGCCGGGGAAGGGTCGGGGCCCATAGTAGTGGTGTAATTGATGCTTTTGATATCTGG	CARRNLGRGRVGAHSSGVIDAFDIW	IGHV4-38-2	IGHJ3
TGTGCGAACAACCATCCCATGATACATTTGGGGGAGTTATCGTTATCATCTTTTTACCGTGACTACTGG	CANNHPMIHLGELSLSSFYRDYW	IGHV3-23	IGHJ4
TGTTACATTCGAAGTATTACTATGACTGATGCTTTTGATATCTGG	CYIRSITMTDAFDIW	IGHV3-30-3	IGHJ3
TGTGCGAAAGGCGGCCTAACTGGAACTACGCTACGTCTCAATGACTACTGG	CAKGGLTGTTLRLNDYW	IGHV3-NL1	IGHJ4
TGTGCGAGCATAGCGTCATTACGATATTTTGACTGGTTAGGCAACATTTACTACTACTACTACATGGACGTCTGG	CASIASLRYFDWLGNIYYYYYMDVW	IGHV3-21	IGHJ6
TGTGCGAGAGATTCCTACTACAAGTTTTGGAGTGGTTCTAAAACCCAGCTTTTCTGG	CARDSYYKFWSGSKTQLFW	IGHV1-2	IGHJ4
TGTGCGAGGAAGGGGGTCATCTATAGCAGCTCGTCCGGGCTTGACTACTGG	CARKGVIYSSSSGLDYW	IGHV1-3	IGHJ4
TGTACCACATGTTGTCCTACGTATTACTATGATAGTAGTGGTTATTTACGCTGG	CTTCCPTYYYDSSGYLRW	IGHV3-15	IGHJ4
TGTCCGTACTATGGTTCGGGGAGTTATTATTCCTCAGGTGAAGTGTATGGATACTGGTTCGACCCCTGG	CPYYGSGSYYSSGEVYGYWFDPW	IGHV3-30-3	IGHJ5
TGTGCGAAAGTTCCGACACGGATACAGCTATGGCGAATTAAAGACTACTGG	CAKVPTRIQLWRIKDYW	IGHV3-NL1	IGHJ4
TGTGCGAGAGATCTGGCAGCAGCTGGTATCGCACTGCTTGACTACTGG	CARDLAAAGIALLDYW	IGHV1-46	IGHJ4
TGTGCGAAAGATATTTTTTTATATTGTAGTGGTGGTAGAAGCTTGGTCGACTACTGG	CAKDIFLYCSGGRSLVDYW	IGHV3-23	IGHJ4
TGTGCGAAAAAGCAGTGGCTGGGGGGGCCGTCCCCCCTTGACTACTGG	CAKKQWLGGPSPLDYW	IGHV3-NL1	IGHJ4
TGTGCGTTAATTACGTATTACTATGATAGTAGTGGTTATGAGGGGGGCCCGTCCCTTGACTACTGG	CALITYYYDSSGYEGGPSLDYW	IGHV7-4-1	IGHJ4
TGTGCGAGACTGTTATCCCCAGACACACGCAGTGGCTGGGGGGATGCGGACTACTGG	CARLLSPDTRSGWGDADYW	IGHV1-18	IGHJ4
TGTGCGAGAGCCCAGGGGGTCGGTCTTATATACAACTGGTTCGACCCCTGG	CARAQGVGLIYNWFDPW	IGHV3-21	IGHJ5
TGTGCGAGATGCGGCCGGGCGTATTACGATATTTTGACTGGTTATTTGGGCCCGGGAGGAAGGTACTACTTTGACTACTGG	CARCGRAYYDILTGYLGPGGRYYFDYW	IGHV4-59	IGHJ4
TGTGCGAGACCCCCCGCCGATTGCGTGCGGCCCGATAGTAGTGGTTATTACACCTGG	CARPPADCVRPDSSGYYTW	IGHV4-34	IGHJ5
TGTGCGAAAGATTCCCTCGCCGTGACCAACCGGCAGCAGCTGGTTTGTTCTCGGTCGGGGGGGTTTGACTACTGG	CAKDSLAVTNRQQLVCSRSGGFDYW	IGHV3-NL1	IGHJ4
TGTGCGAGAGAAACTCCGTGCCTAGGATATTGTAGTGGTGGTAGCTGCTACGCTCAAGACGACGCTGAATACTTCCAGCACTGG	CARETPCLGYCSGGSCYAQDDAEYFQHW	IGHV3-66	IGHJ1
TGTGCGAGACCACGGTTGGAGGATATTGTACTAATGGTGTATGCTATACTGGGGTACTGG	CARPRLEDIVLMVYAILGYW	IGHV1-2	IGHJ4
TGTGCAAAAGATTTCCGGGGCCCATCGGGAGCGTCCACTACGGTGAGCGCCTACGAGTACAACTGGTTCGACCCCTGG	CAKDFRGPSGASTTVSAYEYNWFDPW	IGHV3-43	IGHJ5
TGTACTAGAGGGCACGGGGCTACGATTACGGGGGACTACTGG	CTRGHGATITGDYW	IGHV3-49	IGHJ4
TGTGCGAGACCCCTCAAGGATGATCTCCCAGATGTAGCCCCGAGGTATAGCAGTGGCTGGTACGGCTTTGACTACTGG	CARPLKDDLPDVAPRYSSGWYGFDYW	IGHV4-38-2	IGHJ4
