TGTGCGAGACCAGGATTTTTGGAGTGGTTATTACCGGTCCGCGGCATGGACGTCTGG	CARPGFLEWLLPVRGMDVW	IGHV5-10-1	IGHJ6
TGTGCGAGAGCATTCCTTACTATGATAGGGGCCTGCTGGTTCGACCCCTGG	CARAFLTMIGACWFDPW	IGHV1-2	IGHJ5
TGTGGAGTATTACGATATTTTGACTGGTTATTATACGCCCTCTACTTTGACTACTGG	CGVLRYFDWLLYALYFDYW	IGHV1-2	IGHJ4
TGTGCGAGAGCACATTGTAGTAGTACCAGCTGCTATGGGGACTACTACTACTACATGGACGTCTGG	CARAHCSSTSCYGDYYYYMDVW	IGHV1-46	IGHJ6
TGTGCGAGACCGAAATTTTTTGGAGTGGTTATGATTAGAGCCAGCAAGTGTAAGGTGTCTGACCGCTACTACTACTACATGGACGTCTGG	CARPKFFGVVMIRASKCKVSDRYYYYMDVW	IGHV4-38-2	IGHJ6
TGTGCACGGATGGGGGGGCGGGAGTTTTGGAGTGGTTATTTTGACTACTGG	CARMGGREFWSGYFDYW	IGHV2-70	IGHJ4
TGTGCGAAAGATCTGGAGGATATTGTAGTGGTGGTAGCTGCCCGACTCACTGCTTTTGATATCTGG	CAKDLEDIVVVVAARLTAFDIW	IGHV3-23	IGHJ3
TGTGCGAAAGGATTAGCAGTGGCTGGTAGTCATAGCCCGGACTACTTTGACTACTGG	CAKGLAVAGSHSPDYFDYW	IGHV3-NL1	IGHJ4
TGTGCGAGAGCCAAGTGGTTATTACAGGGCACATGGTTCGACCCCTGG	CARAKWLLQGTWFDPW	IGHV3-7	IGHJ5
TGTGCGAGAAAGTACGGTGACTACCTTGACTACTGG	CARKYGDYLDYW	IGHV5-51	IGHJ4
TGTGCGAGAGACTTGCGTAGCAGTGGCTGGGCCATTCCGTTCGTGCCCTTTGACTACTGG	CARDLRSSGWAIPFVPFDYW	IGHV4-59	IGHJ4
TGTGCGAGAAAGGACGTTGGATATTGTAGTGGTGGTAGCTGCTACTCGTATTACTACTACTACTACTACATGGACGTCTGG	CARKDVGYCSGGSCYSYYYYYYYMDVW	IGHV3-66	IGHJ6
TGTGCGAGAGGGGATATTGTAGTGGTGGTAGCTGCTATTGCCGCCTATTACTACTACTACTACTACATGGACGTCTGG	CARGDIVVVVAAIAAYYYYYYYMDVW	IGHV4-38-2	IGHJ6
TGTGCGAGAAAAGGGGTTGTAGTGGTGGTAGCTGCTACACAGGCGATCCCCTACTACTACTACTACTACATGGACGTCTGG	CARKGVVVVVAATQAIPYYYYYYMDVW	IGHV4-34	IGHJ6
TGTGCGAGAGGGCTATTACGTTTGGGGGAGTTTGATTCGATTGACTACTGG	CARGLLRLGEFDSIDYW	IGHV3-21	IGHJ4
TGTGCGAAACGTCGGAGTCAGAAAGGGGCTTCCCTTGGTACCAGCTGCTGTAGCCCCTGGCAACGATGTCCCCTTGACTACTGG	CAKRRSQKGASLGTSCCSPWQRCPLDYW	IGHV3-NL1	IGHJ4
TGTGCGAGAAAAAGCTACCCGCAGCAGCTGGCGGGCGCCCCCGGCTACTGG	CARKSYPQQLAGAPGYW	IGHV4-38-2	IGHJ4
TGTGCGAGAGGTTTAGATGGCTACAATTGGGGGGCTTTTGATATCTGG	CARGLDGYNWGAFDIW	IGHV1-2	IGHJ3
TGTGCACACAGTTGGGCTTTCGTTTCAGTGGTGGTAGCTGCTATGGGCGGAGACTGG	CAHSWAFVSVVVAAMGGDW	IGHV2-5	IGHJ4
TGTGCGAGATCAGGTACCCCCGAGATGGAGTGGGAGCTACTCCCCCCACATTATATCGGAAACTGG	CARSGTPEMEWELLPPHYIGNW	IGHV4-59	IGHJ4
TGTGCACGGCCCTCATGGTTCAGGGAGTTATTGGAGGCTTTTGATATCTGG	CARPSWFRELLEAFDIW	IGHV2-26	IGHJ3
TGTGCGAGATCGGAAACGGGCGATAGTAGTGGGTGGGTTGACTACTGG	CARSETGDSSGWVDYW	IGHV3-21	IGHJ4
TGTGCGAGATTCTTGGCAATAGCAGTGGCTGGCCCCTTTGACTACTGG	CARFLAIAVAGPFDYW	IGHV1-46	IGHJ4
TGTGCGTGGGGCCGATATTGTAGTGGTGGTAGCTGCTACACCCACGTAGGGGGCTCCCGGACCTTCTTTGACTACTGG	CAWGRYCSGGSCYTHVGGSRTFFDYW	IGHV1-3	IGHJ4
TGTGCGAGAGCGGCTAGAGAGTTCCCAGGCAAGTGGCTACATGATGCTTTTGATATCTGG	CARAAREFPGKWLHDAFDIW	IGHV1-3	IGHJ3
TGTGCGAGAGCGGGATATTGTAGTAGTACCAGCTGCTTTTTTGACTACTGG	CARAGYCSSTSCFFDYW	IGHV1-3	IGHJ4
TGTGCGAGAGGGGGGTCTATTGTAGTAGTACCAGCTGCTGAAAGGTACTACTACTACTACATGGACGTCTGG	CARGGSIVVVPAAERYYYYYMDVW	IGHV1-69	IGHJ6
TGTGCGAGATGTCCCACTAGTTACGTTTGGGGGAGTTATCGGGAAGACTACTTTGACTACTGG	CARCPTSYVWGSYREDYFDYW	IGHV1-2	IGHJ4
TGTACTAGAGGAAGGTCCTCCGGGAATTGGGATGCACTGGACATAGCAGCAGCTGGTAACCTACGAGGTCAAACCCCCTTTGACTACTGG	CTRGRSSGNWDALDIAAAGNLRGQTPFDYW	IGHV3-49	IGHJ4
TGTGCAAGAGATCACTTCGTGGATACAGCTATGGACCACTGG	CARDHFVDTAMDHW	IGHV3-13	IGHJ4
TGTGCGAGAGATCCGGATATTGTAGTGGTGGTAGCTGCTACGGACTTTGACTACTGG	CARDPDIVVVVAATDFDYW	IGHV3-53	IGHJ4
TGTGCGAGAGCCTCGACGGCTGAGGGATATTGTAGTAGTACCAGCTGCTATGGGGACTACTGG	CARASTAEGYCSSTSCYGDYW	IGHV1-3	IGHJ4
TGTGCGAGAGACGGAAATGATATTGTAGTAGTACCAGCTGCTATGCCTATCTCCTGGTTCGACCCCTGG	CARDGNDIVVVPAAMPISWFDPW	IGHV1-69	IGHJ5
TGTGCGAGAGATAGAGGCTCCTTATTGTACTGGTTCCTATGGAGCTTAAATCTCAGGTCCTTTGACTACTGG	CARDRGSLLYWFLWSLNLRSFDYW	IGHV1-3	IGHJ4
TGTGCGAAAGAGCGCGAACGATATTGTAGTGGTGGTCCAACCAAAGTTGACTACTGG	CAKERERYCSGGPTKVDYW	IGHV3-NL1	IGHJ4
TGTGCGAAAGAGGCTCGTGGAACGACGCGGATGGAGACCGAGTACTACTTTGACTACTGG	CAKEARGTTRMETEYYFDYW	IGHV3-NL1	IGHJ4
TGTGCAAAAGGGGCGACTACGGTGGTAACTCCGTGGGTTTATTACTACTACTACTACTACATGGACGTCTGG	CAKGATTVVTPWVYYYYYYYMDVW	IGHV3-43D	IGHJ6
TGTGCGAGAGCCACTTTACTATGGTTCAGGGAGTTATTGGGGGACTGGTTCGACCCCTGG	CARATLLWFRELLGDWFDPW	IGHV1-46	IGHJ5
TGTACCACAGGATGTCGTATTACTATGATAGTAGTGGTTACGGCGTTTGACTACTGG	CTTGCRITMIVVVTAFDYW	IGHV3-15	IGHJ4
TGTGTACCTGCGGTGGTAACTCACAGCTACTTTGACTACTGG	CVPAVVTHSYFDYW	IGHV3-72	IGHJ4
TGTGCGAGAGAGGGCTGCTTCGTGTATTACGATTTTTGGAGTGGTTATTATACCGGTAAGCGGCGGGGCAGTTTGGGGCATTATGCTTTTGATATCTGG	CAREGCFVYYDFWSGYYTGKRRGSLGHYAFDIW	IGHV1-3	IGHJ3
TGTACTAGACGGGGATTAGATATTGTAGTAGTACCAGCTGCGGCCTTTAGATACTACTACTACTACATGGACGTCTGG	CTRRGLDIVVVPAAAFRYYYYYMDVW	IGHV3-73	IGHJ6
TGTGCGAAAGAGTATAGCAGCGGACGGCCCTTCTGG	CAKEYSSGRPFW	IGHV3-23	IGHJ3
TGTGCACACGTCTATGATATTGTAGTAGTACCAGCAGTCTGGTTCGACCCCTGG	CAHVYDIVVVPAVWFDPW	IGHV2-5	IGHJ5
TGTGCACGGATCATGGGGTGTAGGGCGCTTGGTACCAGGGCTGACTACTGG	CARIMGCRALGTRADYW	IGHV2-26	IGHJ4
TGTGCGATGGTGGGGCCCGGGTATTACGATTTTTGGAGTGGTTATCGACTGTGGCCGTTCTACTACTACTACTACTACATGGACGTCTGG	CAMVGPGYYDFWSGYRLWPFYYYYYYMDVW	IGHV3-20	IGHJ6
TGTGCAAAAGAATATTACTATGGTTCAGGGAACTTTGACTACTGG	CAKEYYYGSGNFDYW	IGHV3-43D	IGHJ4
TGTGCGAAAGCTCAGTGCGGTTTCCAGTGGCTGGTACGAACCCCGTTTGACTACTGG	CAKAQCGFQWLVRTPFDYW	IGHV3-23	IGHJ4
TGTGCGAGAGATAGACCTATTACTATGATAGTAGTGGTTATTTTGGACCCATCTGACTACTGG	CARDRPITMIVVVILDPSDYW	IGHV3-7	IGHJ4
TGTGCGAGAGATTCCCCGTCAGCTATGGTTTTTGACTACTGG	CARDSPSAMVFDYW	IGHV3-21	IGHJ4
TGTACCACAGGGCCTATCGGAAGACCTCCCGAGTTTATAGTGGGATGCGGGGGGAAATTTGATATCTGG	CTTGPIGRPPEFIVGCGGKFDIW	IGHV3-15	IGHJ3
TGTGCGAAAGACCCTCTTACGGCCCGTGGCTACGATTGCCAAGTCTACTGG	CAKDPLTARGYDCQVYW	IGHV3-23	IGHJ4
TGTGCGAGAGATCTCCACCCCAATATAGTGGCTACGATTAGCCCTTATCGGCCCACTCCGCGCTGG	CARDLHPNIVATISPYRPTPRW	IGHV3-7	IGHJ4
TGTGCAGGGCCACGAGACGATTTTTGGAGTGGTTATTATACTCCCCAATACTTTGACTACTGG	CAGPRDDFWSGYYTPQYFDYW	IGHV3-7	IGHJ4
TGTGCACACAGGCTTTGGGATTTAGGGTATAGCAGTGTGGATCTTGACTACTGG	CAHRLWDLGYSSVDLDYW	IGHV2-5	IGHJ4
TGTGCGAAAGAAATAGTGGTTATGAACTACTTTGACTACTGG	CAKEIVVMNYFDYW	IGHV3-23	IGHJ4
TGTGCAAAAGATCCGGTACACAGCTATGGTTATTCCTTCTTCATCAGGCCACACTTTGACTACTGG	CAKDPVHSYGYSFFIRPHFDYW	IGHV3-43	IGHJ4
TGTGCGAGAATCCCCCCCGATGCTTTTGATATCTGG	CARIPPDAFDIW	IGHV4-38-2	IGHJ3
TGTGCAAGAGCTCCGAAATTTTGGAGTGGTTATTATTGGTGGAATGACTACTGG	CARAPKFWSGYYWWNDYW	IGHV3-74	IGHJ4
TGTGCGAAAGATATTGTAGTAGTACCAGCTGCTATTTACTACTACTACATGGACGTCTGG	CAKDIVVVPAAIYYYYMDVW	IGHV3-23	IGHJ6
TGTGCGAGACACACCGGGCGGCGCCATGCGGTCGAGTATTACTATGATAGTAGTGGTTATGCCACCGGCCGGGCGGTACGGGATAAGTCCTTTGACTACTGG	CARHTGRRHAVEYYYDSSGYATGRAVRDKSFDYW	IGHV4-4	IGHJ4
TGTGCGAGGGGGAGGGATATTGTAGTGGTGGTAGCTGCTACTGTCCCCCCCTACTACTACTACTACATGGACGTCTGG	CARGRDIVVVVAATVPPYYYYYMDVW	IGHV4-39	IGHJ6
TGTGCGAGAGATGGGATCCAGTGGCTGGTACGCTTCTTTGACTACTGG	CARDGIQWLVRFFDYW	IGHV3-7	IGHJ4
TGTGCAGATAAACAGCTGGGTGGCTGGCAGTACTGG	CADKQLGGWQYW	IGHV6-1	IGHJ4
TGTGCGAGACGTCCCCCCATGGGACTGGTTCGGGGAATTCCCTGGTACAACTGGTTCGACCCCTGG	CARRPPMGLVRGIPWYNWFDPW	IGHV1-46	IGHJ5
TGTGCACGACATCCAGGTAATTGTACTATAAGTGATCGATTGGATATTGTAGTGGTGGTAGCTGCTAGGCACTACTACTACTACATGGACGTCTGG	CARHPGNCTISDRLDIVVVVAARHYYYYMDVW	IGHV2-26	IGHJ6
TGTGCGCATATCCGCAGTGGCTGGTGCGGTAACGCTTTTGATATCTGG	CAHIRSGWCGNAFDIW	IGHV3-13	IGHJ3
TGTGCGAGAGATGCTCCTAGGGCCGGCGATATTGTAGTAGTACCAGCTGCTAGGACGGTCCATTACTACTACTACTACTACATGGACGTCTGG	CARDAPRAGDIVVVPAARTVHYYYYYYMDVW	IGHV3-20	IGHJ6
TGTGCGAAAGATAGGGATAGACTAATAGCAGCAGCTGGTAGGCTGCTTTGCTACTGG	CAKDRDRLIAAAGRLLCYW	IGHV3-NL1	IGHJ4
TGTGCGAAAGATGGGACAATACGAATACTCAAGGATATTGTAGTAGTACCAGCTGCCTTCTTTGACTACTGG	CAKDGTIRILKDIVVVPAAFFDYW	IGHV3-23	IGHJ4
TGTGCGAAAGATATCCGGTTTCGGGGAGTTATTATCACCCAGTCCCCATTTGACTACTGG	CAKDIRFRGVIITQSPFDYW	IGHV3-NL1	IGHJ4
TGTGCGAGAGATGCTATTCGTCTCGTAGTAGTACCAGCTGCTATGACTTACTTTGACTACTGG	CARDAIRLVVVPAAMTYFDYW	IGHV1-46	IGHJ4
TGTGCGAGCGAGAATGGTACAGTGGCTGCTTGGAAAGAGGGCTGGTACTTCGATCTCTGG	CASENGTVAAWKEGWYFDLW	IGHV3-7	IGHJ2
TGTGCAAAAACCCGTGGTGTATGCGGGGCTCCGATCTGG	CAKTRGVCGAPIW	IGHV3-43D	IGHJ4
TGTGCGAGCCCAGTTTCTAGTATTACTATGATAGTAGTGGTTATTACTCTTGACTACTGG	CASPVSSITMIVVVITLDYW	IGHV3-48	IGHJ4
TGTACCACAGATCGGTGTCTACCCATAGCAGTGGCTGGTGCACGGAATCACGGTGGGGTGAACATTGGATGGATGTTTGACTACTGG	CTTDRCLPIAVAGARNHGGVNIGWMFDYW	IGHV3-15	IGHJ4
TGTGCGACCCCTCCGCTTCGGTGCAAAGGATATTGTACTGGTGGTGTATGCTACCGTTGTGACTACTGG	CATPPLRCKGYCTGGVCYRCDYW	IGHV1-69	IGHJ4
TGTGCGAGAGAAGGACCTCCGGACTTATGGTTCAGGGAGTTATTATGTCAAGACCGCTGG	CAREGPPDLWFRELLCQDRW	IGHV3-20	IGHJ4
TGTGCACACACTACGGTGACTACGTCGGACCCCCTGAAAGGGAACGAGAGACAAGGTCCCCTGTGGTTCGACCCCTGG	CAHTTVTTSDPLKGNERQGPLWFDPW	IGHV2-5	IGHJ5
TGTGCGAGACCCTACAGGGAGTGGAAAAAGAGCGAATCATGGTACTACTTTGACTACTGG	CARPYREWKKSESWYYFDYW	IGHV7-4-1	IGHJ4
TGTGCGAGAGATTATCTCATTGTAGTAGTACCAGCTGCTATTCCCTTTGACTACTGG	CARDYLIVVVPAAIPFDYW	IGHV3-11	IGHJ4
TGTGCGAAAGATATTAAGGGATTGCAGCAGCTGATTAAATACTTCCAGCACTGG	CAKDIKGLQQLIKYFQHW	IGHV3-23	IGHJ1
TGTGCGAGAGATAACGGGGATATTGTAGTAGTACCAGCTGCTATAGGGACTCAGAACTGGTTCGACCCCTGG	CARDNGDIVVVPAAIGTQNWFDPW	IGHV1-2	IGHJ5
TGTGCGAAAGATGTTGGAGGCGCGGGTATAGCAGCAGCTGGACCTGTTTTCGACCCCTGG	CAKDVGGAGIAAAGPVFDPW	IGHV3-23	IGHJ5
TGTGCACAGGGAAGAGCAGTGGCTGGTACTTCTGACTACTGG	CAQGRAVAGTSDYW	IGHV3-30-3	IGHJ4
TGTGCGAGAGAAAGATATAGTGGCTACGATTGCCTGTGGCGTTGCCCCTACTGG	CARERYSGYDCLWRCPYW	IGHV1-2	IGHJ4
TGTGCGAGCATAGCAGTGGCTGGACGCGATTGTGGCCAAGGGGCACGGTTCGACCCCTGG	CASIAVAGRDCGQGARFDPW	IGHV1-3	IGHJ5
TGTGCGAGAGATGCTCCCCCCGCAATTGTAGTAGTACCAGCTGCTATTCCAACCTCCTTCGGGGCCCCGGCCGGGTTCGACCCCTGG	CARDAPPAIVVVPAAIPTSFGAPAGFDPW	IGHV1-46	IGHJ5
TGTGCGAAAGCACGTAGGAATCTCTTCATTCATGCTTTTGATATCTGG	CAKARRNLFIHAFDIW	IGHV3-NL1	IGHJ3
TGTGCGAAAGGGGTGCCGGATTACGATTTTTGGAGTGGTTCCTACTACTACTACTACATGGACGTCTGG	CAKGVPDYDFWSGSYYYYYMDVW	IGHV3-23	IGHJ6
TGTGCGAAGCCCGGTGAACCAGCTGCTATTGACTACTGG	CAKPGEPAAIDYW	IGHV3-23	IGHJ4
TGTGCGAGACTAATTACGATTTTTGGAGTGGTTATTGGTTCCCGAGGCAGGGACTGGCACCCTTTGGATCTGAGGGTCTACTACATGGACGTCTGG	CARLITIFGVVIGSRGRDWHPLDLRVYYMDVW	IGHV1-3	IGHJ6
TGTGCGAGACATCCCGGGCATATTGTGGTGGTGATTGCTATTCTGGACTTTGACTACTGG	CARHPGHIVVVIAILDFDYW	IGHV5-51	IGHJ4
TGTGCCGAATCTCACCTCCTTACGGGGTTAGCAGTGGCTGGTCCGCGTCCCTACTGG	CAESHLLTGLAVAGPRPYW	IGHV3-30	IGHJ4
TGTACTAGAGATCTTTCCGTGATAGCAGTGGCTGCCGGTGACTACTGG	CTRDLSVIAVAAGDYW	IGHV3-49	IGHJ4
TGTGCGAGAGCCCCCCGTAGTATAGCAGTGGCTGCGTACTTTGACTACTGG	CARAPRSIAVAAYFDYW	IGHV3-20	IGHJ4
TGTACTAGAGCCGTTACCGGTCCGCGATTTTTGGAGTGGTTATACCCCCCGTACTACTACTACTACATGGACGTCTGG	CTRAVTGPRFLEWLYPPYYYYYMDVW	IGHV3-49	IGHJ6
TGTGCGAGAGCTTCTTTCAATACGTATTACGATTTTTGGAGTGGTTATTATGACTACTGG	CARASFNTYYDFWSGYYDYW	IGHV3-7	IGHJ4
TGTGCGAGAGATAGACAGGATACTATGGTTCAGCCTACTGCAATTGCGGGCTGGTTCGACCCCTGG	CARDRQDTMVQPTAIAGWFDPW	IGHV3-66	IGHJ5
TGTGACAATTACTATGATAGTAGTGGTTCCTGCTACTGG	CDNYYDSSGSCYW	IGHV4-61	IGHJ4
