TGTGCGAGAGGCTTGGGGGGGTGGTATAGTGGGAGCTCTGACTACTGG	CARGLGGWYSGSSDYW	IGHV4-34	IGHJ4
TGTGCGAGAGATTCCGGGACCCTTGTAGTAGTACCAGCTGCTAGACACTACTACTACTACTACATGGACGTCTGG	CARDSGTLVVVPAARHYYYYYMDVW	IGHV3-21	IGHJ6
TGTGCGGGGTCCGGGGGTTTTGGATATTGTAGTGGTGGTAGCTGCTACACATCGGAAGCTTACTACTACTACTACTACATGGACGTCTGG	CAGSGGFGYCSGGSCYTSEAYYYYYYMDVW	IGHV4-39	IGHJ6
TGTGCGAGAGATGGGATTGAGCCGGCCCCACTCACTGACTACGGTGACTACCCGGGGTCCGATGCTTTTGATATCTGG	CARDGIEPAPLTDYGDYPGSDAFDIW	IGHV1-18	IGHJ3
TGTGGAATTGTAGTAGTACCAGCTGCGACTACCTATGATGCTTTTGATATCTGG	CGIVVVPAATTYDAFDIW	IGHV3-30	IGHJ3
TGTACTAGAGATAAGGATTACTATGATAGTAGTGGGTCGGCTTTGTATTCATGGTTCGACCCCTGG	CTRDKDYYDSSGSALYSWFDPW	IGHV3-49	IGHJ5
TGTGCGAGAGCGGGTTTGACAAAACGCCCCCACCAAGGCTACTACATGGACGTCTGG	CARAGLTKRPHQGYYMDVW	IGHV1-46	IGHJ6
TGTGCGAGAGCACCACTATGTATAGCAGCAGCTGGTATACTCGAGGGCAGGAGAGGGGGCTTGTATGATGCTTTTGATATCTGG	CARAPLCIAAAGILEGRRGGLYDAFDIW	IGHV3-11	IGHJ3
TGTGCGAAAGATGAAGGTGTTTATTACGATTTTTGGAGTGCGTCTAGTTCCCGCAGGAGCTACTGG	CAKDEGVYYDFWSASSSRRSYW	IGHV3-23	IGHJ4
TGTGCGAAAGATGTGCCTGGAGGCCGTGGATATAGTGGCTACGATTCTATCTACTGG	CAKDVPGGRGYSGYDSIYW	IGHV3-NL1	IGHJ4
TGTGCGAGGAGGTCCACTATGATAGTAGTGGTTATTACTAATTGGTACTACTTTGACTACTGG	CARRSTMIVVVITNWYYFDYW	IGHV5-51	IGHJ4
TGTGCGAGAACGATAGTGGCTGGTACGCGGGCTCTCCGGGCGTACTACTTTGACTACTGG	CARTIVAGTRALRAYYFDYW	IGHV4-38-2	IGHJ4
TGTGCAAGACTTCGGAGCAGTGGCTGCCCCCTTCCAACATACTACTACTACTACATGGACGTCTGG	CARLRSSGCPLPTYYYYYMDVW	IGHV6-1	IGHJ6
TGTGCGAGAGAACTGGGGCACATGGACGTCTGG	CARELGHMDVW	IGHV3-7	IGHJ6
TGTGCAAGAGTCCCCAACCTGTTATGGAGGCGGATTACATTTGGGGGAGTTATCGTTATACCCTATCTCTACTGG	CARVPNLLWRRITFGGVIVIPYLYW	IGHV6-1	IGHJ4
TGTGCAAGAGCCGCTTTTGATTCCGGATATTGTAGTGGTGGTAGCTGCTACTCCCCCCGTTGCTACTACTACTACATGGACGTCTGG	CARAAFDSGYCSGGSCYSPRCYYYYMDVW	IGHV3-13	IGHJ6
TGTGCGAAGGAATCATGGTTTGGGCCTGCCTACGGTGGTAACCTGGGATCCGATGCTTTTGATATCTGG	CAKESWFGPAYGGNLGSDAFDIW	IGHV3-23	IGHJ3
TGTGCGAAACCCGTGGTTGACTACGGTGACCAGTTTGACTACTGG	CAKPVVDYGDQFDYW	IGHV3-23	IGHJ4
TGTGCGAGAGGAAATGACTCGTATTACTATGATAGTAGTGGTTATTACGCCCAACCTTGTGACTACTGG	CARGNDSYYYDSSGYYAQPCDYW	IGHV3-7	IGHJ4
TGTGCGAAAGATCCCTTTTTAGTTCAGTACATTGTAGTGGTGGTAGCTGCTACTCCTGCGCGGGATGACTGG	CAKDPFLVQYIVVVVAATPARDDW	IGHV3-23	IGHJ5
TGTGCGAAAACTGGGGGCCGAATATCAGTGGTTATTCGGACGCACTACTTCGATCTCTGG	CAKTGGRISVVIRTHYFDLW	IGHV3-23	IGHJ2
TGTGCGAGAGTCTTAGCAGTGGCTGGTCCGGGAACTCCCATACGCCGTGCCGTCTACTGG	CARVLAVAGPGTPIRRAVYW	IGHV3-53	IGHJ4
TGTGCGTTCACGAGGCCGCATTTCATTGTAGTAGTACCAGCTGCTCCCGTCTCCTACTACTACTACATGGACGTCTGG	CAFTRPHFIVVVPAAPVSYYYYMDVW	IGHV1-3	IGHJ6
TGTGCACGGATACCTTTTTCTCTTCCGCAGCAGCTGGGTTGCGGAGAAAGGGTGGACTGG	CARIPFSLPQQLGCGERVDW	IGHV2-26	IGHJ5
TGTGCGAGCGCCGGGTATAGCAGCAGCTGGCTATATTACTACTACTACTACTACATGGACGTCTGG	CASAGYSSSWLYYYYYYYMDVW	IGHV3-53	IGHJ6
TGTGCGAAAGATGTATCATTGATCTGGTGGTCCTTTGACTACTGG	CAKDVSLIWWSFDYW	IGHV3-NL1	IGHJ4
TGTACCACAAAGCCCCGTACGATTTTTGGAGTGCACCTATACTACTACTACATGGACGTCTGG	CTTKPRTIFGVHLYYYYMDVW	IGHV3-15	IGHJ6
TGTGCGAGTCCTAACTGGCATATTGTAGTGGTGGTAGTTGACTACTGG	CASPNWHIVVVVVDYW	IGHV1-69	IGHJ4
TGTGCGAGAGATCTAAAGAGTACTACAGTAACTAAATACTACTACTACTACATGGACGTCTGG	CARDLKSTTVTKYYYYYMDVW	IGHV3-7	IGHJ6
TGTGCGACGGGGGAGGGCGCAAAAGTAACTACGGTTCTTGTCGTCTACTACTACTACATGGACGTCTGG	CATGEGAKVTTVLVVYYYYMDVW	IGHV7-4-1	IGHJ6
TGTGCACGGTCGGGAGCTTCGTTTCACTGG	CARSGASFHW	IGHV2-26	IGHJ4
TGTACCACCTGCCTCCCGATCTATTGTAGTGGTGGTAGCTGCTACTCTTCCTACTTTGACTACTGG	CTTCLPIYCSGGSCYSSYFDYW	IGHV3-15	IGHJ4
TGTGCGAGTCGGCAGCTGAACCGAACCCTCCCCGACTACTGG	CASRQLNRTLPDYW	IGHV3-48	IGHJ4
TGTGCGAGAGATCGCACCCTTATGTTTCACACAATTGTAGTAGTACCAGCTGCTCCTATCCGGTGGTTCGACCCCTGG	CARDRTLMFHTIVVVPAAPIRWFDPW	IGHV3-11	IGHJ5
TGTGCGAGAGGCGTACCCGTCGAGCCACACAAGACGAAATTGTATAGTCTCTTTGACTACTGG	CARGVPVEPHKTKLYSLFDYW	IGHV4-34	IGHJ4
TGTGCGAAACGCCCTGGCCTTTTCTTTGACTACTGG	CAKRPGLFFDYW	IGHV3-23	IGHJ4
TGTGCACACAGGGGGAGGTACCAGCTGCTATCGGTTGAAAAGAGGTTCGACCCCTGG	CAHRGRYQLLSVEKRFDPW	IGHV2-5	IGHJ5
TGTGCGAGAGAGTATCCGAAAGGAATTTGCAGTGGCTGGTGGCTTGCTTTTGATATCTGG	CAREYPKGICSGWWLAFDIW	IGHV3-7	IGHJ3
TGTGCGAAAAGGACCCGAAACCGGATACAGCTATGGGGGTACTACTACTACATGGACGTCTGG	CAKRTRNRIQLWGYYYYMDVW	IGHV3-23	IGHJ6
TGTGCGAGAGACAAAAGTATTACTATGATAGTAGTGGTTATGAACTGGTTCGACCCCTGG	CARDKSITMIVVVMNWFDPW	IGHV3-21	IGHJ5
TGTGCGAGAAAGCGGCGGATTGTAGTAGTACCAGCTGCTATAAACAATAACTACTGG	CARKRRIVVVPAAINNNYW	IGHV3-7	IGHJ4
TGTGCGAAACTAGCCATACGAATTGATTACTACTACTACTACTACATGGACGTCTGG	CAKLAIRIDYYYYYYMDVW	IGHV3-23	IGHJ6
TGTGCGAGACTTTCTGCCCGGGTACAGCAGCTCTTTCCTGACTACTGG	CARLSARVQQLFPDYW	IGHV7-4-1	IGHJ4
TGTGCGAGATCCCAGTGGCTGGTACATCTTAATCCACCAAGGTTCGACCCCTGG	CARSQWLVHLNPPRFDPW	IGHV4-61	IGHJ5
TGTGCGAGAGATCGCGGGTTGGTTATTACTATGATAGTAGTGGTTATTATGGTGATGACCGGCTACTGGTACTTCGATCTCTGG	CARDRGLVITMIVVVIMVMTGYWYFDLW	IGHV1-69	IGHJ2
TGTGCGAGAGAGGAAAAGTGCGTCCCGCAGCTCGTTGATTACTACTACTACTACTACATGGACGTCTGG	CAREEKCVPQLVDYYYYYYMDVW	IGHV4-61	IGHJ6
TGTGCGAGAGAGGGGGATGATGCTTTTGATATCTGG	CAREGDDAFDIW	IGHV1-46	IGHJ3
TGTGCGAAAGATCCTCCGAGAGTACCAGCTGCTATCCCGACTTATGACTACTGG	CAKDPPRVPAAIPTYDYW	IGHV3-NL1	IGHJ4
TGTGCGAGATATAACTGGAACTCGCACTACTACTACTACATGGACGTCTGG	CARYNWNSHYYYYMDVW	IGHV4-59	IGHJ6
TGTGCGAGAGAGCGGCCGGGTACGGTGACTACGACCGCTGACTACTGG	CARERPGTVTTTADYW	IGHV3-7	IGHJ4
TGTGCGAAAACACTTCATAGGAGGACGGGAACAGAAGGGCTGTGGTATAGCAGCAGCTGTGGGCAGCTTGACTACTGG	CAKTLHRRTGTEGLWYSSSCGQLDYW	IGHV3-23	IGHJ4
TGTGCGAGAGATCTTGGCTACGGTGACTACGACACCCCTTTACTTTGGACTCCCCCTATTGACTACTGG	CARDLGYGDYDTPLLWTPPIDYW	IGHV1-46	IGHJ4
TGTGCGAGGGTTCTAACGGGGGATAGCAGTGTAAACTGGTTCGACCCCTGG	CARVLTGDSSVNWFDPW	IGHV1-2	IGHJ5
TGTGCACACAGACGTAGTATTACGATTTTTGGAGTGGTTCTTGACTACTGG	CAHRRSITIFGVVLDYW	IGHV2-5	IGHJ4
TGTGCGAGATGGAGGGAGACATTGTCGAGGCCCATACCCACTATGGTTCAGGGAGGGGCTAATTTGGAGTGGTTGATCGACTACTGGTTCGACCCCTGG	CARWRETLSRPIPTMVQGGANLEWLIDYWFDPW	IGHV7-4-1	IGHJ5
TGTGCGAATATTTATGATTTCTACGGTGACTACGTCAACCCCCTGCCGAGCGTTCCAGCGGATAGTCTCTACTACTACTACATGGACGTCTGG	CANIYDFYGDYVNPLPSVPADSLYYYYMDVW	IGHV3-23	IGHJ6
TGTGCGAAATGCCAAGAGTGGAGTATTACTATGATAGTAGTGGTTATTCATCCAAATAGGCATCTTGACTACTGG	CAKCQEWSITMIVVVIHPNRHLDYW	IGHV3-23	IGHJ4
TGTGCGAGAGCTCGGGCAACCTCGCAGCAGCTGGGGCCGGTTGACTACTGG	CARARATSQQLGPVDYW	IGHV4-59	IGHJ4
TGTGCGAGAGTATCCGCTATAACTGGAACGACGCCCTCAAAGTTACAGGCCGTCTTTGATGCTTTTGATATCTGG	CARVSAITGTTPSKLQAVFDAFDIW	IGHV4-59	IGHJ3
TGTGCGAGGGTGTTGGCCTACGGTGACTACGTCCTCCATCTCATCCCCTGG	CARVLAYGDYVLHLIPW	IGHV3-7	IGHJ5
TGTGCAAGAGACGAGTATAGCAGCTCGTGGCGCGATGCTTTTGATATCTGG	CARDEYSSSWRDAFDIW	IGHV3-13	IGHJ3
TGTGCGAGAGCCTATGACTACGGTGACTACTCCAACCCATACACGGTGCACTACTGG	CARAYDYGDYSNPYTVHYW	IGHV3-7	IGHJ4
TGTACTAGCCCAATTGTAGTGGTGGTAGCTGCTACCCTAGGTGCTTTTGATATCTGG	CTSPIVVVVAATLGAFDIW	IGHV3-49	IGHJ3
TGTGCGAGGGCAACCCAGTGGCTACGATCCTGTTCCTACTGG	CARATQWLRSCSYW	IGHV3-53	IGHJ4
TGTGCGAGAGGCGGGGTTGGTAGTAGTACCAGCTGCGTCCGGGAACCATCCGTTGACTACTGG	CARGGVGSSTSCVREPSVDYW	IGHV3-20	IGHJ4
TGTGCAAGATTTCTCCTATTACTATGGTTCAGGGCTTCGACTTTCGTTGACTACTGG	CARFLLLLWFRASTFVDYW	IGHV1-45	IGHJ4
TGTGCAAAAGATATCCCGGATATTGTAGTGGTGGTAGCTGCCAAGGAGGTTCGAATATACTTTGACTACTGG	CAKDIPDIVVVVAAKEVRIYFDYW	IGHV3-43	IGHJ4
TGTACTAGAGGAAATATTGTAGTAGTACCAGCTGCTATCTACTGG	CTRGNIVVVPAAIYW	IGHV3-73	IGHJ4
TGTGCGAGAGCTTTACGATTTTTGGAGTGGTTAGCCCCTCGAGGCCCACCCGTGGCAGTTGGTCGTCCTGCTTTTGATATCTGG	CARALRFLEWLAPRGPPVAVGRPAFDIW	IGHV3-11	IGHJ3
TGTGCGAAACCGGGGGCTACGTATTACGATTTTTGGAGTGGTTACCGAAAAACCGTTTATACGTACTACTTTGACTACTGG	CAKPGATYYDFWSGYRKTVYTYYFDYW	IGHV3-NL1	IGHJ4
TGTGCAAGAGTCGGCCGATTGTATAGTGGGAGCTATACCCTCCCAGACTACTGG	CARVGRLYSGSYTLPDYW	IGHV3-13	IGHJ4
TGTGCGAGAGCCTCTATTACGATTTTTGGAGTGGTTATTAAAGACTACTGG	CARASITIFGVVIKDYW	IGHV1-3	IGHJ4
TGTGCGAGACACATTACTATGGTTCGGGGGCTGGCCCTGTGG	CARHITMVRGLALW	IGHV1-46	IGHJ5
TGTGCGAAAGATAGGTATTGTAGTAGTACCAGCTGCTGGAGGACGGAATTTCACTGG	CAKDRYCSSTSCWRTEFHW	IGHV3-NL1	IGHJ4
TGTGCGAGAGATCCCCTTCTGCCATATTACTATGATAGTAGTGGTTATTACACTATATATGCTTTTGATATCTGG	CARDPLLPYYYDSSGYYTIYAFDIW	IGHV3-64	IGHJ3
TGTGCGAGAGGCCCCTCCTTACGTATTACGATTTTTGGAGTGGTTTTGATGGACGTCTGG	CARGPSLRITIFGVVLMDVW	IGHV1-3	IGHJ6
TGTACTAAGCCTGCAGCTCGTCCTAGTCCTGCGTACTGG	CTKPAARPSPAYW	IGHV3-49	IGHJ4
TGTGCGAGAGGAGGGTGTACAGTAACTACGCTGGACCGACGCCATTACTACTACTACATGGACGTCTGG	CARGGCTVTTLDRRHYYYYMDVW	IGHV1-3	IGHJ6
TGTGCAAGAGAGGTGAGTATAGCAGCTCGCCGTAAACTAGACTACTGG	CAREVSIAARRKLDYW	IGHV3-74	IGHJ4
TGTGCGAGAGCGGATTTCGCGATTGTAGTAGTACCAGCTGCTAGGATCAACTGGTTCGACCCCTGG	CARADFAIVVVPAARINWFDPW	IGHV3-7	IGHJ5
TGTGCAAGAGACCCCACTGGGAGTAGTACCAGCTGCTATGCTAACATTTACTACTACTACTACTACATGGACGTCTGG	CARDPTGSSTSCYANIYYYYYYMDVW	IGHV3-74	IGHJ6
TGTGCGAGAACCTACAGCCCCGATATTGTAGTGGTGGTAGCTGCTACGGAAAACTTTGACTACTGG	CARTYSPDIVVVVAATENFDYW	IGHV4-34	IGHJ4
TGTGCGAGAGAACTGTGGAGCCGTACTCACCCCTTCCTTAGTGGCTACGAAAACTGGTTCGACCCCTGG	CARELWSRTHPFLSGYENWFDPW	IGHV1-69	IGHJ5
TGTGCAAAAGATATCCCAATTGTACTGGTGGTGTATGCTATACGCTACTGG	CAKDIPIVLVVYAIRYW	IGHV3-43	IGHJ4
TGTGCGAGAGACACTCTCATGTATTTATTACTATGGTTCGGGGAGTTAGTTGACTACTGG	CARDTLMYLLLWFGELVDYW	IGHV4-4	IGHJ4
TGTGCGGGATACTCCAAGGTTGTGCACCGACGAATGGCGGTCAACTGGTTCGACCCCTGG	CAGYSKVVHRRMAVNWFDPW	IGHV3-20	IGHJ5
TGTACTAGAGGTGGGAGCTACATTCTACTATTTGACTACTGG	CTRGGSYILLFDYW	IGHV3-49	IGHJ4
TGTGCGAGAGACCTGAGCCCTTGTTTCGCCGTATGGTTCAGGGAGTTATTATCGGTCAAAAAGATGGACGTCTGG	CARDLSPCFAVWFRELLSVKKMDVW	IGHV4-61	IGHJ6
TGTACTAGACATCGGGACTTCAACTATGATAGTAGTGGTTATTACTATTTTTGGTTCGACCCCTGG	CTRHRDFNYDSSGYYYFWFDPW	IGHV3-73	IGHJ5
TGTGCGAAAGATCGGGCTGCTATACTCCTAGGAGACTACTGG	CAKDRAAILLGDYW	IGHV3-NL1	IGHJ4
TGTGCGAGAGTTCGCCACCCCGCTATGATAGTAGTGGTTATGAACGAGCCCTACTGG	CARVRHPAMIVVVMNEPYW	IGHV3-21	IGHJ4
TGTGCTAGAGGGATGGGGGTACATCCCGACTACTGG	CARGMGVHPDYW	IGHV3-72	IGHJ4
TGTGCGAGCGTGGCCGTAACCCGAGATATTGTAGTAGTACCAGCTCGTATTATGGCTTACTACTACTACTACATGGACGTCTGG	CASVAVTRDIVVVPARIMAYYYYYMDVW	IGHV1-46	IGHJ6
TGTGCGAAAGCCCAGGACCATTGTACTAATGGTGTATGCTACATAACGCACTGGTTCGACCCCTGG	CAKAQDHCTNGVCYITHWFDPW	IGHV3-NL1	IGHJ5
TGTGCGAAAGGAAGGGTTGTCCTCCGCGAAACCTACTGG	CAKGRVVLRETYW	IGHV3-23	IGHJ4
TGTGCGAGGAAGTATAGCAGTGGCTGGTATTTCCCTGGACCCTTCCTGGGCTGG	CARKYSSGWYFPGPFLGW	IGHV1-2	IGHJ4
TGTGCGAGAGCGGAAAAAGGTATTGTACTAATGGTGTATGCTAATAGATTTGGTTTTGACTACTGG	CARAEKGIVLMVYANRFGFDYW	IGHV3-7	IGHJ4
TGTGCGAGAGATGACGGGATTTCTCCAAGCAGTGGCTGGTACAGGCAGAAATACTTTGACTACTGG	CARDDGISPSSGWYRQKYFDYW	IGHV1-2	IGHJ4
TGTGCGAGAGATGGCTCGACCTTTGATATCACTATTGACTACTGG	CARDGSTFDITIDYW	IGHV4-59	IGHJ4
TGTGCGAGAGGTAAGCCCCCAAAGTACGATTTTTGGAGTGGTACGGGTGGGCTGGCCTTTGACTACTGG	CARGKPPKYDFWSGTGGLAFDYW	IGHV3-66	IGHJ4
