TGTGCGAAACCGTATAGTGGCTACGATTTTTGTCCGCCACGGCAGCCTGGGCCCTGGGCCTACTACTACTACATGGACGTCTGG	CAKPYSGYDFCPPRQPGPWAYYYYMDVW	IGHV3-NL1	IGHJ6
TGTGCGAGAGATGAGCACCGTGTGGCTGTAAGGAACAACGACTTGGTCGAATACGTTAACCTAAAAAACTGGTTCGACCCCTGG	CARDEHRVAVRNNDLVEYVNLKNWFDPW	IGHV3-66	IGHJ5
TGTGCGAGAGATAAGCAATGTATAGCAGCAGCTGGTAACCTTCTGAATTCCTGG	CARDKQCIAAAGNLLNSW	IGHV3-30	IGHJ4
TGTGCGAGAGATTCTATAGCAGTGGCTGTGAACAAGAGATACGGGTGG	CARDSIAVAVNKRYGW	IGHV1-3	IGHJ4
TGTGCGAGACGGAAGGGACCGGGGTTTGACTACTGG	CARRKGPGFDYW	IGHV3-7	IGHJ4
TGTGCGCTCAGAATTAAAATTACTATGATAGTAGTGGTTATTACTACGTTATACTTTGACTACTGG	CALRIKITMIVVVITTLYFDYW	IGHV3-23	IGHJ4
TGTGCGAGAGCAGTAAACCGATGCGTATTACGATTTTTGGAGTGGTTACCCGGATCCTCCGACTACTGG	CARAVNRCVLRFLEWLPGSSDYW	IGHV3-30	IGHJ4
TGTACTAGAGTACGGGGCAAATATTGTAGTAGTACCAGCTGTCGGAATTACTACATGGACGTCTGG	CTRVRGKYCSSTSCRNYYMDVW	IGHV3-49	IGHJ6
TGTGCGAGACTTGCCGGAGACGGTTACGGCATAGCAGCAGCTGGTACCCGTTACCCGAGGGGGGTCCTATCCTTCCAGCACTGG	CARLAGDGYGIAAAGTRYPRGVLSFQHW	IGHV1-46	IGHJ1
TGTACTAGACATGGCGATAGCAGTGGCTGGACCCTCCACTGGTTCGACCCCTGG	CTRHGDSSGWTLHWFDPW	IGHV3-73	IGHJ5
TGTGCGAGACATAGACCTTGGGTAGCTGCTACCCATTGCGTGAAGGTCCCGTACCTCTACAACTGGTTCGACCCCTGG	CARHRPWVAATHCVKVPYLYNWFDPW	IGHV5-51	IGHJ5
TGTGCGAGTGCGTTCCAGCCCAAGGGGGAAAGTTTAGTAGTACCAGCTGCTATGGTACTTGGGTACTACTTTGACTACTGG	CASAFQPKGESLVVPAAMVLGYYFDYW	IGHV3-20	IGHJ4
TGTGCGAGAGAGGATATAGTGGCTACGATATTCGGCCAGTACTACTTTGACTACTGG	CAREDIVATIFGQYYFDYW	IGHV4-38-2	IGHJ4
TGTGCGAGAGCTATAATTGTAGTAGTACCAGCTGCTATGAGACCACCTGACTACTGG	CARAIIVVVPAAMRPPDYW	IGHV1-2	IGHJ4
TGTACCACAATTATAGCAGTGGCGCCTCCCTTCTCCCACTACTTTGACTACTGG	CTTIIAVAPPFSHYFDYW	IGHV3-15	IGHJ4
TGTGCAAGAGAGTTGCATATTGTGGTGGTGACTCGTCGGGACGTTGACTTTGACTACTGG	CARELHIVVVTRRDVDFDYW	IGHV3-74	IGHJ4
TGTGCGAGATTGATTACTATGATAGTAGTGGTTATTTTTGACTACTGG	CARLITMIVVVIFDYW	IGHV4-34	IGHJ4
TGTGCACGTTTCTCACTAATTCGTTTGGAGTGGTTATTACAGGGCAATGGATTCGATCTCTGG	CARFSLIRLEWLLQGNGFDLW	IGHV2-26	IGHJ2
TGTGCGAGTGGGCGGTTGCCTTCAGGGGGAGTCAACGTCGTTGACTACTGG	CASGRLPSGGVNVVDYW	IGHV1-2	IGHJ4
TGTGCGAGCTGTCCACACTGG	CASCPHW	IGHV3-53	IGHJ4
TGTGCGAAAGAAAATAATCATTGTATGATAGTAGTGGTTATTGTGGCTGACTACTGG	CAKENNHCMIVVVIVADYW	IGHV3-23	IGHJ4
TGTGCGAGAGTTGGCTATGATTACGTTTGGGGGAGTTATCGTTATGGGAACGATTTGTTCCACTTTGACTACTGG	CARVGYDYVWGSYRYGNDLFHFDYW	IGHV1-18	IGHJ4
TGTGCGAAAGATCGCAGGGTAGTAGTACCAGCTGCATTTGACTACTGG	CAKDRRVVVPAAFDYW	IGHV3-NL1	IGHJ4
TGTGAAGCCTATTGTAGTGGTGGTAGCTGCGGGGTGTGGTTCGACCCCTGG	CEAYCSGGSCGVWFDPW	IGHV3-30	IGHJ5
TGTGCAAGACCAAATTCGGGAGGACGTGCAAGGAGTGACTACTGG	CARPNSGGRARSDYW	IGHV3-74	IGHJ4
TGTGCAAGAGTTCGGGGACCGCAGGGCGTATTACTATGGTTCGGGGAGTTTTTGGATTGG	CARVRGPQGVLLWFGEFLDW	IGHV6-1	IGHJ4
TGTGCGAGATATAGTCTGCCAGCCACTGACTACTACTACATGGACGTCTGG	CARYSLPATDYYYMDVW	IGHV1-3	IGHJ6
TGTACTAGAGATCGGGGTAAATCCCGGGGGGGGTATATTGTAGTAGTACCAGCTGCCTCTTGGTTCGACCCCTGG	CTRDRGKSRGGYIVVVPAASWFDPW	IGHV3-49	IGHJ5
TGTGCGAGAGGCCCCGTGGATACAGCTATGGTTAAGAACTCCCTTTGTTACTACTTTGACTACTGG	CARGPVDTAMVKNSLCYYFDYW	IGHV4-34	IGHJ4
TGTGCGAGCGATTTTACGATTTTTGGAGTGGTTATTATGTGTAAGAACTACTACTACTACTACATGGACGTCTGG	CASDFTIFGVVIMCKNYYYYYMDVW	IGHV4-38-2	IGHJ6
TGTACCACCGTCTATTACGATTTTTGGAGTGGTTATAGGGGCTTTGACTACTGG	CTTVYYDFWSGYRGFDYW	IGHV3-15	IGHJ4
TGTGCGAGAGACCCTGTTTTCGGCGATTTTTGGAGTGGTTATTCTTCATATCAGTACTGG	CARDPVFGDFWSGYSSYQYW	IGHV4-38-2	IGHJ4
TGTGCGAGAGACCAGGTGGGAGCTACTACAAGCGGCTGGTTCGACCCCTGG	CARDQVGATTSGWFDPW	IGHV4-59	IGHJ5
TGTGCGAGAGGGTACATAGGAATTTATGACTACGGTGGTAACTCCCCTAGGGACTTTGACTACTGG	CARGYIGIYDYGGNSPRDFDYW	IGHV3-48	IGHJ4
TGTGCACGGATGCCTTTTGTAGTAGTACCAGCTGCCGGACCTGGTTACAACTGGTTCGACCCCTGG	CARMPFVVVPAAGPGYNWFDPW	IGHV2-70	IGHJ5
TGTGCGAGAGAGTTATACCGATACTTCCAGCACTGG	CARELYRYFQHW	IGHV3-66	IGHJ1
TGTGCGAAAGGCGGTATAGCAGCAGCTGCGCTTCAGGACCACTGG	CAKGGIAAAALQDHW	IGHV3-23	IGHJ4
TGTGCGAGAGAAGTCCACTATGGTTCGGGGAGGGACTGGTACTTCGATCTCTGG	CAREVHYGSGRDWYFDLW	IGHV1-69	IGHJ2
TGTGCGAGTAACCGGGCGCGAGATGGAAAAGAGATGATAGCTGGGATAGCCCACGTATTACTATGGTTCAGGGAGTTATTATTAACCCTCATCCGTCGCACTTACTACTACTACTACTACATGGACGTCTGG	CASNRARDGKEMIAGIAHVLLWFRELLLTLIRRTYYYYYYMDVW	IGHV5-51	IGHJ6
TGTACTAGACATAAGCCCCCTACGGTGAGAACGCCGTGGTACTTCGATCTCTGG	CTRHKPPTVRTPWYFDLW	IGHV3-73	IGHJ2
TGTGCGAGAAGGGAGACCGTCGCAGTGGCGGGCAACTGGTTCGACCCCTGG	CARRETVAVAGNWFDPW	IGHV3-20	IGHJ5
TGTGCGAAAGATCGTCTTTGTTACGATTTTTGGAGTGGTTATTATCTGACCATGACGCAATTTGACTACTGG	CAKDRLCYDFWSGYYLTMTQFDYW	IGHV3-NL1	IGHJ4
TGTGCAAGAGATTGGGCAAGATATTGTAGTAGTACCAGCTGCTATGAAGGCGCGAGTATGTCCTTATACTTTGACTACTGG	CARDWARYCSSTSCYEGASMSLYFDYW	IGHV3-74	IGHJ4
TGTGCGAGAGTCTATCCACGGGAACCCCCAGAACACTTACGATATTTTGACTGGTTATATCCTGCTTTTGATATCTGG	CARVYPREPPEHLRYFDWLYPAFDIW	IGHV1-3	IGHJ3
TGTACTAGAGATCTTGCAAGTGCGGTATTGTACTGGTGGTGTATGCTATATGGTGTAGCCACCTTTGACTACTGG	CTRDLASAVLYWWCMLYGVATFDYW	IGHV3-49	IGHJ4
TGTGCGAGATTGAGTACCGGTCCATATTGTAGTGGTGGTAGCTGCTACTCGGTTTTGGCGCCCATCAACTTTGACTACTGG	CARLSTGPYCSGGSCYSVLAPINFDYW	IGHV5-10-1	IGHJ4
TGTGCGAAAGTCAAGAAGATTCTCAAATGGGATGACTACTGG	CAKVKKILKWDDYW	IGHV3-NL1	IGHJ4
TGTGCGAGAGTGAATTACGATTTTTGGAGTGGTTCCCACTACTACTACTACATGGACGTCTGG	CARVNYDFWSGSHYYYYMDVW	IGHV4-4	IGHJ6
TGTGCGAGACTCCCCGATATTGTAGTAGTACCAGCTGCTAACTTTGACTACTGG	CARLPDIVVVPAANFDYW	IGHV5-51	IGHJ4
TGTGCGAAAGTGAAACTATATTGTAGTAGTACCAGCTTTGATGGCTACTACTACTACTACATGGACGTCTGG	CAKVKLYCSSTSFDGYYYYYMDVW	IGHV3-23	IGHJ6
TGTGCGAGTCCCTCCCTTGATTTGGGAGCTAGATCTTTTGATATCTGG	CASPSLDLGARSFDIW	IGHV1-2	IGHJ3
TGTGCACAGAGCTCCAAGGATATTGTACTGGTGGTGTATGCTATAGCTCCGGGCCCTCCATTTGACTACTGG	CAQSSKDIVLVVYAIAPGPPFDYW	IGHV2-5	IGHJ4
TGTGCGAGAGATCATCTACTTTCAAATATAGCAGCAGCTGGTACATCCGGGGTATACTACTACTACTACATGGACGTCTGG	CARDHLLSNIAAAGTSGVYYYYYMDVW	IGHV4-61	IGHJ6
TGTGCGAGACTTTCTATTGTAGTAGTACCAGCTGCCTTTTTAAAGGGCTGGTTGGCCTCGGTTAATATTCGACCCTGTACGACAGAATACTTCCAGCACTGG	CARLSIVVVPAAFLKGWLASVNIRPCTTEYFQHW	IGHV4-38-2	IGHJ1
TGTGCGAAGGGGGGTACGGTGACTAGAACCAGGCGCAATTTCGATGCTTTTGATATCTGG	CAKGGTVTRTRRNFDAFDIW	IGHV3-23	IGHJ3
TGTGAGTTTCTTGACTACTGG	CEFLDYW	IGHV1-69	IGHJ4
TGTGCGACTTTCCATATTACTATGATAGTAGTGGTTATTACCCCTGACTACTGG	CATFHITMIVVVITPDYW	IGHV1-3	IGHJ4
TGTGCGAGATTGTATTACGATATTTTGACTGGTAATCCCTCTTACTGG	CARLYYDILTGNPSYW	IGHV7-4-1	IGHJ4
TGTACCACAGATCCTCCTAGGGAAAGAGGGATTGTAGTGGTGGTAGCTGCTACTGCGTACTGG	CTTDPPRERGIVVVVAATAYW	IGHV3-15	IGHJ4
TGTGAGAAGATGCGGCGGAGGGGCGATTTCTGGTACTTCGATCTCTGG	CEKMRRRGDFWYFDLW	IGHV3-30-3	IGHJ2
TGTGCGAGAGATCTACCTTGGAACTTTCCCGACGGTTATTGTAGTGGTGGTAGCTGGGACTTGCTAATTGACTACTGG	CARDLPWNFPDGYCSGGSWDLLIDYW	IGHV3-21	IGHJ4
TGTGCGAGAGATCTGGGCGCTGCCTACGGTGACTACCAAGTTGACTACTGG	CARDLGAAYGDYQVDYW	IGHV3-20	IGHJ4
TGTGCAGAAGCCATAGCAGCAGCTGGTACTACGGGACACTTTGACTACTGG	CAEAIAAAGTTGHFDYW	IGHV2-70	IGHJ4
TGTGCCCGAAATAGTGGCTACGATAACTACTTTGACTACTGG	CARNSGYDNYFDYW	IGHV3-30	IGHJ4
TGTGCGAGAGGGCCCCGTATTACGATTTTTGGAGTGGCCCGTTGG	CARGPRITIFGVARW	IGHV4-4	IGHJ4
TGTGCGAGAGGTTATAGCAGCTCGGCCTACTACTACATGGACGTCTGG	CARGYSSSAYYYMDVW	IGHV3-20	IGHJ6
TGTGCACACAGACAGCTATGGCGGGTATATCCGTACTACTTTGACTACTGG	CAHRQLWRVYPYYFDYW	IGHV2-5	IGHJ4
TGTGCAAAAGATAAGTTGTACTGGTGGTGTATGCTATTTAACAACTGGTTCGACCCCTGG	CAKDKLYWWCMLFNNWFDPW	IGHV3-43D	IGHJ5
TGTGCGAGAGATCGTGGCGGGGGATATTGTAGTGGTGGTAGCTGCTACTCGATCTACCCGGACTACTTTGACTACTGG	CARDRGGGYCSGGSCYSIYPDYFDYW	IGHV4-61	IGHJ4
TGTGCAAGAGTAGCTATTGTAGTAGTACCAGCTGCTAAGGTACCCGATGCTTTTGATATCTGG	CARVAIVVVPAAKVPDAFDIW	IGHV3-13	IGHJ3
TGTGCGAGAGGCACTGACTCCATCCTAGGATATTGTAGTGGTGGTAGCTGCTACTCCGTCCCGCATGATGCTTTTGATATCTGG	CARGTDSILGYCSGGSCYSVPHDAFDIW	IGHV4-34	IGHJ3
TGTGCGAAAGATGCCCGAACGTACAGTAACTACGTGTTAGCCTGG	CAKDARTYSNYVLAW	IGHV3-23	IGHJ5
TGTGCGAAAGATCGTCGAAGGGGAGTTGCCTTTTCCGAAATTGACTACTGG	CAKDRRRGVAFSEIDYW	IGHV3-NL1	IGHJ4
TGTGCGAAAGAAATCCCCCAGCCGTGGATACAGCTATGGTCCGGTGACTACTGG	CAKEIPQPWIQLWSGDYW	IGHV3-NL1	IGHJ4
TGTACTAGCGCCCGGCTCGCGGAAGTTGACTACTGG	CTSARLAEVDYW	IGHV3-49	IGHJ4
TGTGCGAGAGATACGTACCCGTATAGCAGCAGCTGGTACGCCTCTATGGTTGGTTTGTTAGACTTTGACTACTGG	CARDTYPYSSSWYASMVGLLDFDYW	IGHV1-69	IGHJ4
TGTGCGAGCGGAAACCGTATTATGATTACATTTGGGGGAGTTATCGCCTGGTTCGACCCCTGG	CASGNRIMITFGGVIAWFDPW	IGHV4-38-2	IGHJ5
TGTGCACACTCGAGTAGTGTAGTAGTACCAGCTGCTATACTTGCTCATGACTACTGG	CAHSSSVVVPAAILAHDYW	IGHV2-5	IGHJ4
TGTGCGAAAGATGGCGGCTATAGTACCTCCCGATATTGTAGTGGTGGTAGCTGCTACTATTTTTGTCCTGGCTACTACTACATGGACGTCTGG	CAKDGGYSTSRYCSGGSCYYFCPGYYYMDVW	IGHV3-NL1	IGHJ6
TGTGCGAGCGCCCCAGAAAGGAGGTTTTGGAGTGGTCTGTACTTTGACTACTGG	CASAPERRFWSGLYFDYW	IGHV4-59	IGHJ4
TGTGCGAGTGTACTCCCCAACTGGAACTCCACTGACTACTGG	CASVLPNWNSTDYW	IGHV3-20	IGHJ4
TGTGCGAGAAACGTGGATATAGTGGCTACGCTCTTTGACTACTGG	CARNVDIVATLFDYW	IGHV5-10-1	IGHJ4
TGTGCGAGAGTATGTGGTTCGAATTTTTGGAGTGGTTATTGGCTCTACTACATGGACGTCTGG	CARVCGSNFWSGYWLYYMDVW	IGHV1-8	IGHJ6
TGTGCGAGAGTAGGTATAGCAGCAGCTGGTTACTACTGG	CARVGIAAAGYYW	IGHV1-2	IGHJ4
TGTGCGAGAGAAAGAAAGCACCTCCCGGGGGGCTACGATCTTAGTTACTACTACTACTACATGGACGTCTGG	CARERKHLPGGYDLSYYYYYMDVW	IGHV1-2	IGHJ6
TGTGCAACGAACCAGACTAGGAGGTATAGCAGTGGGTCTCCGCGCTGGTTCGACCCCTGG	CATNQTRRYSSGSPRWFDPW	IGHV1-24	IGHJ5
TGTGCAAGAGATAGGCTTACAGTAACTACGTTTGACTACTGG	CARDRLTVTTFDYW	IGHV3-74	IGHJ4
TGTGCGAGCGGGCAAACGAACTTGATAGAGCGAGCGTATGGTTCGGGGAGTTATTCGATAGGCTTTGACTACTGG	CASGQTNLIERAYGSGSYSIGFDYW	IGHV7-4-1	IGHJ4
TGTGCGAGGACCGGGGATATTGTAGTGGTGGTAGCTGCTACGTTGTACAACTGGTTCGACCCCTGG	CARTGDIVVVVAATLYNWFDPW	IGHV1-46	IGHJ5
TGTGCGAAAGGTACGACCGCTGGGCGTATACTGGAATTTGGAGGAGCCGGTGGTAGCTGCTACTCTTTAGGGGCGTTTGACTACTGG	CAKGTTAGRILEFGGAGGSCYSLGAFDYW	IGHV3-23	IGHJ4
TGTGCGACCGGAGGGGAATGTATTACGATTTTTGGAGTGGTTATCACCGAAATGAGGAACCCCTCTCCTCTTGACTACTGG	CATGGECITIFGVVITEMRNPSPLDYW	IGHV3-NL1	IGHJ4
TGTGCAAGAGCGGAGGTGGGTTCATATAGTGGGAGCTCAGGGGACCAACGGAAAGGCGACCGAAACTACTGG	CARAEVGSYSGSSGDQRKGDRNYW	IGHV6-1	IGHJ4
TGTGCAAGAGTTGGCCTTATAGTGGGAGCTACCGGGTCTCCGGACGGTTGCATTAAGGAGGTTGACTACTGG	CARVGLIVGATGSPDGCIKEVDYW	IGHV3-13	IGHJ4
TGTGCGAAAGATTGTAGGGATCTATTACGATTTTTGGAGTGGTTATTAGGGGGGTTCGACCCCTGG	CAKDCRDLLRFLEWLLGGFDPW	IGHV3-NL1	IGHJ5
TGTGCACGGATACTGGATGTAACGCAGCTCGTCAGGATATATGTCCCCTACTACTACTACATGGACGTCTGG	CARILDVTQLVRIYVPYYYYMDVW	IGHV2-26	IGHJ6
TGTGCGAGAGGCCCCGTATTACGATTTTTGGAGTGGTTATTATTAACTGTTGACTACTGG	CARGPVLRFLEWLLLTVDYW	IGHV4-34	IGHJ4
TGTGCGAGAGCGGGATTGACCCCGTGGATACAGCTATGGTTGCTGGAACACGCTCAGCCCACCGTAGTGGAGTTCCTTCTGGATATAGACTTTGACTACTGG	CARAGLTPWIQLWLLEHAQPTVVEFLLDIDFDYW	IGHV3-20	IGHJ4
TGTGCGAAAGATCCAGGGGATCTACTATGGTTCAGGGAGTTATTGTTTTGGGGGGATGACTACTGG	CAKDPGDLLWFRELLFWGDDYW	IGHV3-23	IGHJ4
TGTGCGACTGGACCTATGATAGTAGTGGTTATTACTACATTTAGGCCGCATTTTCATTGGGACGACTGG	CATGPMIVVVITTFRPHFHWDDW	IGHV3-NL1	IGHJ4
TGTGCGAGGAACTCCCGGAGGGTCATTCATATTGTAGTGGTGGTAGCTGCTACTCGCCACTACTTTGACTACTGG	CARNSRRVIHIVVVVAATRHYFDYW	IGHV3-7	IGHJ4
