TGTGCGAGAGTGTACCGCGCAGCTGGTATGAACTGGTTCGACCCCTGG	CARVYRAAGMNWFDPW	IGHV3-21	IGHJ5
TGTGCGAAAGTCCCAGATTACGGTGACTACGTAGCCGGGGGCTGGTTCGACCCCTGG	CAKVPDYGDYVAGGWFDPW	IGHV3-NL1	IGHJ5
TGTGCAACATCGAGCTCAAACTGGAAAATAGCAGCAGCTGGTACCCCTTATAATTTTTACTACTTTGACTACTGG	CATSSSNWKIAAAGTPYNFYYFDYW	IGHV3-74	IGHJ4
TGTGCGAGAGCTCGGGGATATTGTAGTAGTACCAGCTGCGTTTACTACTTTGACTACTGG	CARARGYCSSTSCVYYFDYW	IGHV7-4-1	IGHJ4
TGTGCGAGAGATGGCCTCTATTGTAGTGGTGGTAGCTGCTACTCGAGGTTTGACTACTGG	CARDGLYCSGGSCYSRFDYW	IGHV4-59	IGHJ4
TGTGCGAGAGAATGGGAAGCAGTGGAGTACTACTTTGACTACTGG	CAREWEAVEYYFDYW	IGHV3-7	IGHJ4
TGTGCCTACAAGCCCACAAGGAACAGGCCCCCTGATGCTTTTGATATCTGG	CAYKPTRNRPPDAFDIW	IGHV3-30	IGHJ3
TGTGCGAGAGATGGGGCCCCCTTGAACGAAGGTAATGACTACTGG	CARDGAPLNEGNDYW	IGHV3-21	IGHJ4
TGTGCAAGAGATCGGGGGATCCCAGCAGCTGGTAAAGTTACTACCGACTGGTTCGACCCCTGG	CARDRGIPAAGKVTTDWFDPW	IGHV3-13	IGHJ5
TGTGCGAGCCCGCTTGTAGTGGTGGTAGCTGCTACTCCGGCCCGAATCTACTGG	CASPLVVVVAATPARIYW	IGHV4-34	IGHJ4
TGTGCGAGAAATGATGCTTCATTACTATGGTTCAGGGAGTTATTAGATACCACGGGAACCCTTACCCTTTGTAACTGGTTCGACCCCTGG	CARNDASLLWFRELLDTTGTLTLCNWFDPW	IGHV4-39	IGHJ5
TGTGCGAAAGCCTCCTTGAAGGCACCATTGTACTGGTGGTGTATGCACGAATACTTCCAGCACTGG	CAKASLKAPLYWWCMHEYFQHW	IGHV3-23	IGHJ1
TGTGCGAAAGAGGACGCGGCTACACGTATTACTATGATAGTAGTGGTTATTACTTCAGGCTCCGCCCTAGGGTGGGACCAAATAAACTGGTTCGACCCCTGG	CAKEDAATRITMIVVVITSGSALGWDQINWFDPW	IGHV3-NL1	IGHJ5
TGTGCGAGAAAAGTATTACGATTTTTGGAGTGGTTATTTTGTTACTGG	CARKVLRFLEWLFCYW	IGHV1-2	IGHJ4
TGTGCACACAGAGGTTGTTTTCCCACGGCATATTGTAGTGGTGGTAGCTGCACAAGGGGGGGGTTTGACTACTGG	CAHRGCFPTAYCSGGSCTRGGFDYW	IGHV2-5	IGHJ4
TGTACTAGTCGGGGTTATGATTACATTTGGGGGAGCCCTGACTACTGG	CTSRGYDYIWGSPDYW	IGHV3-49	IGHJ4
TGTGCGAGAGGAACACTTGTATCATATTGTAGTAGTACCAGCGGGTTTGACTACTGG	CARGTLVSYCSSTSGFDYW	IGHV4-34	IGHJ4
TGTGCAAGAGTGTTCGCGACTGGTTACATAAAGGAACCGCGACCCAACTGGTTCGACCCCTGG	CARVFATGYIKEPRPNWFDPW	IGHV6-1	IGHJ5
TGTGCAAGAGGGTTCTATTGTAGTAGTACCAGCTGCTTCGGATTCTACTGG	CARGFYCSSTSCFGFYW	IGHV3-74	IGHJ4
TGTGCAACAGCTGAGGGGCACAGAACTGGAACCTTTGACTACTGG	CATAEGHRTGTFDYW	IGHV3-13	IGHJ4
TGTGCGAAAGACATGAGGTCTATTGTAGTAGTACCAAGAAGCTGGTTCGACCCCTGG	CAKDMRSIVVVPRSWFDPW	IGHV3-NL1	IGHJ5
TGTGCGAAAGATGCCCTCTGGAACTACCCCGACAACTGGTTCGACCCCTGG	CAKDALWNYPDNWFDPW	IGHV3-23	IGHJ5
TGTGCGAGACTTACATTACTATGGTTCGGGGAGTTATATATATCCTTCGACCCCTGG	CARLTLLWFGELYISFDPW	IGHV7-4-1	IGHJ5
TGTGCGAGACCCGATCATCGGATACAGCTATGGTCGGGGGGAAAGACTCCGTCCCTAACTGACTACTGG	CARPDHRIQLWSGGKTPSLTDYW	IGHV4-38-2	IGHJ4
TGTTATCTGATTACATTTGGGGGAGTTATCGTGCGGGTAGGTTATTACTACTACTACTACTACATGGACGTCTGG	CYLITFGGVIVRVGYYYYYYYMDVW	IGHV3-13	IGHJ6
TGTGCAAGCTATAGCAGCTCGACTGTCTACTGG	CASYSSSTVYW	IGHV3-13	IGHJ4
TGTGCAAGAGATCAGCCTCCGCATATTGTGGTGGTGACTGCTATTCTTGCTGCGTACACCTACTGG	CARDQPPHIVVVTAILAAYTYW	IGHV3-13	IGHJ4
TGTGCGGCGGGGGGATATTGTAGTGGTGGTAGCTGCAGAAGAACCTGG	CAAGGYCSGGSCRRTW	IGHV1-58	IGHJ4
TGTGCGAGGGGTCCCGAGTGGCTGGTAAATGCCTTCTCCGAGCTCTTTGACTACTGG	CARGPEWLVNAFSELFDYW	IGHV1-46	IGHJ4
TGTGCAAGAGTAGACATTACTATGATAGTAGTGGTTATTACGGCTTGGCCCCCCTACTGG	CARVDITMIVVVITAWPPYW	IGHV6-1	IGHJ4
TGTGCGAGAGATCACGGATTTACTAGGACTACGGTGACTACGGGAAGGTGG	CARDHGFTRTTVTTGRW	IGHV4-59	IGHJ4
TGTGCGAGAGATGCCAGGCTACTATGGTTCGGGGAGTTATACCTGCAGGCCTACTACTTTGACTACTGG	CARDARLLWFGELYLQAYYFDYW	IGHV1-3	IGHJ4
TGTGCGAGAGATCTGGCGGGGTCTAGCAGCTCGTCCGGACGGGGCTACTGG	CARDLAGSSSSSGRGYW	IGHV3-53	IGHJ4
TGTAGGCAACGGGTCTGGTTCCAATATTGTAGTAGTACCAGCTGCTATGAAAGTCGGCACTGGTTCGACCCCTGG	CRQRVWFQYCSSTSCYESRHWFDPW	IGHV3-15	IGHJ5
TGTGCAAGAGATTCGATAGCAGCAGCTGGTACGTGCGGGAAAGGGCCACTTGATCAGACAGACTGGTTCGACCCCTGG	CARDSIAAAGTCGKGPLDQTDWFDPW	IGHV6-1	IGHJ5
TGTGCGAGAAGCAGCTCGTCCGACTACTGG	CARSSSSDYW	IGHV3-72	IGHJ4
TGTGCGAGAGGTATAGTGGGAGCTACTGCCACAACAGGGCAGGGTCCTGCTTTTGATATCTGG	CARGIVGATATTGQGPAFDIW	IGHV1-46	IGHJ3
TGTGCGAGACATCTCCGTATAGCAGCAGCTGGTACTGATGCTTTTGATATCTGG	CARHLRIAAAGTDAFDIW	IGHV5-51	IGHJ3
TGTGCGAGAGATGGGAGCAGCAGCTGGTACTGGGTCTTTCTTTCGTACTACTTTGACTACTGG	CARDGSSSWYWVFLSYYFDYW	IGHV3-53	IGHJ4
TGTGCGAAATGGCCATTTCCCCGGAACCGGACTAGCCCCGGACCCGGTAGTTCTCTATCTCACAACTGGTTCGACCCCTGG	CAKWPFPRNRTSPGPGSSLSHNWFDPW	IGHV3-NL1	IGHJ5
TGTGCGAAAGATGGGGTGATTGTAGTGGTGGTAGCTGCTACTCCGAGCCGCGCCTATCCTTTGAACTACTACTACTACTACATGGACGTCTGG	CAKDGVIVVVVAATPSRAYPLNYYYYYMDVW	IGHV3-NL1	IGHJ6
TGTGCGAGAGATCCGTTACGATATTTTGACTGGTTAGTCCCAACCTGGTTCGACCCCTGG	CARDPLRYFDWLVPTWFDPW	IGHV1-46	IGHJ5
TGTGCGAAAGATCGTAAGCGGCAAAAGTCCCCGGATTTGGAGTGGTTAAATACCTACTACTACTACTACTACATGGACGTCTGG	CAKDRKRQKSPDLEWLNTYYYYYYMDVW	IGHV3-NL1	IGHJ6
TGTGCGAGAATATTGTACTGGTGGTGTATGCGCTGGTACTACTACTACTACTACATGGACGTCTGG	CARILYWWCMRWYYYYYYMDVW	IGHV1-2	IGHJ6
TGTGCGAGAGGGGCCCACCGAGATGGCTACAATTGGTCAAATGCTTTTGATATCTGG	CARGAHRDGYNWSNAFDIW	IGHV1-18	IGHJ3
TGTGCGAGAACGACGGTAGGTTGTATTACTATGATAGTAGTGGTTATTAAGCCATATGACGTTGACTACTGG	CARTTVGCITMIVVVIKPYDVDYW	IGHV7-4-1	IGHJ4
TGTGCGAGTAGATTACTTGTAGTGGTGGTAGCTGCTACGATTTCCGACCCCGGGCTCTTTGACTACTGG	CASRLLVVVVAATISDPGLFDYW	IGHV1-69	IGHJ4
TGTGCGAGTAGTTCTATAAATGTAGTAGTACCAGCTGCTATCCTCTACTGG	CASSSINVVVPAAILYW	IGHV3-7	IGHJ4
TGTGCGAGACGGGCCAGATTGTATTACGATTTTTGGAGTGGTTATTATTTCACCCGGTGTTTTGACTACTGG	CARRARLYYDFWSGYYFTRCFDYW	IGHV4-59	IGHJ4
TGTGCGATTTACTCTAATGTAGACTACTGG	CAIYSNVDYW	IGHV3-21	IGHJ4
TGTGCGAAGTTTGAAATTAGCAGCAGCCCCCCTGGAGAGGGTTTTATCTGGGGAGCTCGTGATGCTTTTGATATCTGG	CAKFEISSSPPGEGFIWGARDAFDIW	IGHV3-23	IGHJ3
TGTACTACAAAGTGGCTACGATTACGGGCTTACTACATGGACGTCTGG	CTTKWLRLRAYYMDVW	IGHV3-49	IGHJ6
TGTGCAAAAGATAGGGGATGGGGGTCTCACCACTACTGG	CAKDRGWGSHHYW	IGHV3-43	IGHJ4
TGTGCGGTCAGTGGCGAGATCCCATTTGGGGGAGTTATCGTTAACCGTATTATGCCGTTTGACTACTGG	CAVSGEIPFGGVIVNRIMPFDYW	IGHV4-39	IGHJ4
TGTGCGAAGCTCCCTTTATGTGCCTACTACTACTACATGGACGTCTGG	CAKLPLCAYYYYMDVW	IGHV3-23	IGHJ6
TGTGCGAATAGTTTCGACCGAATTCCGTATGATTACATTTGGGGGAGTTATCGTTATAAGTCGGTCTGTATTTGGTGGGGAGGTGTTCGCTACTTTGACTACTGG	CANSFDRIPYDYIWGSYRYKSVCIWWGGVRYFDYW	IGHV3-NL1	IGHJ4
TGTGCGAACCCTGGACACGGGGGTCTAGGCTGGCCCCGGCTAGGATATTGTAGTAGTACCAGCTGCTTGTTTGACTACTGG	CANPGHGGLGWPRLGYCSSTSCLFDYW	IGHV3-NL1	IGHJ4
TGTGCAAAAGATGGGTCCGGTCTTTGTGGACGTATAGTGGCTACGATTAAACGGGGGTGGGAAGATACTACTATTGACTACTGG	CAKDGSGLCGRIVATIKRGWEDTTIDYW	IGHV3-43	IGHJ4
TGTGGACCTAGATCGTACTATGATAGTACCCGTTTCGAATACTTCCAGCACTGG	CGPRSYYDSTRFEYFQHW	IGHV6-1	IGHJ1
TGTGCGAGAGACGGGATTCGTTTTCCGGTTAACTTTGACTACTGG	CARDGIRFPVNFDYW	IGHV1-3	IGHJ4
TGTGCGAGGAACGTCCTGATTCTGTCTGATAGCAGCTCGATAGCTTTTGATATCTGG	CARNVLILSDSSSIAFDIW	IGHV4-34	IGHJ3
TGTGCGAGAGATCTGGAGGTGGTTATTACGTCTACCCGGAGTCGCTTTGACTACTGG	CARDLEVVITSTRSRFDYW	IGHV1-3	IGHJ4
TGTGCGAGAGCTTTGGGCCCAGCGACTTACCGGCTCAACTGGTTCGACCCCTGG	CARALGPATYRLNWFDPW	IGHV3-53	IGHJ5
TGTGCCCCCGGGAAAATAATTGTAGTAGTACCAGCTGCATTCGGGAAATCGGCCTACTACTACTACATGGACGTCTGG	CAPGKIIVVVPAAFGKSAYYYYMDVW	IGHV1-2	IGHJ6
TGTCCGGCAGTACCTTTTTGGAGTGGTAAAGGACAAAGGGGCTGG	CPAVPFWSGKGQRGW	IGHV3-64	IGHJ5
TGTGCGAGAGGGGTTGTGGTCTTTTGGAGTGGTTATTGTCATGACTGG	CARGVVVFWSGYCHDW	IGHV3-11	IGHJ4
TGTGCGAGACATGGGCCAGTCCACTATAGCAGCAGCTGGTACAATGGGCGGTACTACTTTGACTACTGG	CARHGPVHYSSSWYNGRYYFDYW	IGHV4-39	IGHJ4
TGTGCGAGAGATTTGTACTGGTGGTGTATGCTATGGTCCTACTGG	CARDLYWWCMLWSYW	IGHV7-4-1	IGHJ4
TGTGCGAGGGGTCCTTGTCTCAAAATTAACTGGTTCGACCCCTGG	CARGPCLKINWFDPW	IGHV4-59	IGHJ5
TGTGCGAGAGAGAAGTATTACTATGATAGTAGTGGTTACCTTATGGTTGACTACTGG	CAREKYYYDSSGYLMVDYW	IGHV4-38-2	IGHJ4
TGTGCGAGAGACGGCCGAATTCAATTATTTGACTACTGG	CARDGRIQLFDYW	IGHV1-3	IGHJ4
TGTACCTACTATGGTTCAGGGACCCCGGATGTCCCTTATTCCTTGCGAAACTACTACTACTACATGGACGTCTGG	CTYYGSGTPDVPYSLRNYYYYMDVW	IGHV3-15	IGHJ6
TGTGTTTATTACGATTTTTGGAGTGGTTATTATAGGGCAAAATCAAGGGGAGAAGGTGGAACTGGGAGGTACTACTACATGGACGTCTGG	CVYYDFWSGYYRAKSRGEGGTGRYYYMDVW	IGHV3-30	IGHJ6
TGTGCGAGAGCACTTATTGTAGTGGTGGTAGCTGCTACTCGCTGTCCTCGTTCCCTCAAACAGTACTTCCAGCACTGG	CARALIVVVVAATRCPRSLKQYFQHW	IGHV4-38-2	IGHJ1
TGTGCAAGAGATCTTCATGCTATGGTTAACGACTACTGG	CARDLHAMVNDYW	IGHV3-13	IGHJ4
TGTGCGAGAGGCCTTACGATTTTTGGAGTGGTTATTATTATGTTCGACCCCTGG	CARGLTIFGVVIIMFDPW	IGHV3-21	IGHJ5
TGTGCGAGAGCCTTAGCCCCTTATGTAGGCAATATTGTAGTAGTACCAGCTGCTCGAACGGACTGGTTCGACCCCTGG	CARALAPYVGNIVVVPAARTDWFDPW	IGHV1-2	IGHJ5
TGTACTAGAAATTACGATTTTTGGAGTGGTTATCCCCACTTTGACTACTGG	CTRNYDFWSGYPHFDYW	IGHV3-73	IGHJ4
TGTGCGAGCAGAGGAAATACAAGTAGTGGTGGGGTTGTGTACAACTGGTTCGACCCCTGG	CASRGNTSSGGVVYNWFDPW	IGHV4-59	IGHJ5
TGTGCGAGAGATGATCGACTTGTAGGTATTACGATTTTTGGAGTACGGTCCCTTGACTACTGG	CARDDRLVGITIFGVRSLDYW	IGHV4-61	IGHJ4
TGTGCGAGAGAGCAGGAAGGGGATAGCAGTGGCTGGTACGACGTTGCTGAATACTTCCAGCACTGG	CAREQEGDSSGWYDVAEYFQHW	IGHV1-3	IGHJ1
TGTGTTACGTGTATTACTATGATAGTAGTGGTTAAAGCCAACGACTACTGG	CVTCITMIVVVKANDYW	IGHV3-30	IGHJ4
TGTGCGAGAGGGTGGCCGTATTACTATGATAGTAGTGGTTATTACTATCTAAGCTGG	CARGWPYYYDSSGYYYLSW	IGHV3-30	IGHJ5
TGTGCGAGAGGATTGGGGCTTACCGGCGTTTCGGGTAGGCCGAGAACCAGGGAATATGTGTTCGACCCCTGG	CARGLGLTGVSGRPRTREYVFDPW	IGHV4-61	IGHJ5
TGTGCGAGAGGACCATGGTGTATGCTATACGGCAACTGGTTCGACCCCTGG	CARGPWCMLYGNWFDPW	IGHV3-66	IGHJ5
TGTGCGAGAGGCTATTGTAGTGGTGGTAGCTGCTACTCAGTCCTACTTCACAACTGGTTCGACCCCTGG	CARGYCSGGSCYSVLLHNWFDPW	IGHV4-34	IGHJ5
TGTACCACAAAACCCGGTGACTACGTAATCGGGGCCTTTGACTACTGG	CTTKPGDYVIGAFDYW	IGHV3-15	IGHJ4
TGTGCGAAAGACCAAACTTTCTGCTGGGAGTATAGCAGCTCGTGGACCTACTGG	CAKDQTFCWEYSSSWTYW	IGHV3-NL1	IGHJ4
TGTGCGAGAGCTCGTAAAGCAGTGGCCCGGAACTGGTTCGACCCCTGG	CARARKAVARNWFDPW	IGHV4-59	IGHJ5
TGTGCGAGAGATCTCCGTTCGAATATACGATATTTTGACTGGTTCACCGCATATCCAGGGGGAGGGGAGAATGCTTTTGATATCTGG	CARDLRSNIRYFDWFTAYPGGGENAFDIW	IGHV3-11	IGHJ3
TGTGCACGGATTAGTGGTGGTAGCTGCTACATGTCATTCTGGTTCGACCCCTGG	CARISGGSCYMSFWFDPW	IGHV2-26	IGHJ5
TGTGCGAGAGAAGTCAATGAAGGGGGTAAGGGGGGGTCTATTCATGATCGGCGCTACTGG	CAREVNEGGKGGSIHDRRYW	IGHV4-61	IGHJ4
TGTGCGAGACCTGGGCAGTGGCTGGCAAACCGAATAGACTACTGG	CARPGQWLANRIDYW	IGHV7-4-1	IGHJ4
TGTACCACAGATCCGGACCCCCTCACAGAAATAATCAATGACTACGGTGACTACGTCCCGCTTGACTACTGG	CTTDPDPLTEIINDYGDYVPLDYW	IGHV3-15	IGHJ4
TGTGCGAAAGATGTTTTCTGGCGCGGGATACAGCTATGCGGTCTCGGCCGCGACTACTGG	CAKDVFWRGIQLCGLGRDYW	IGHV3-NL1	IGHJ4
TGTGCGAGAAGAACCGGTGGGAGCTACCCCAAGTCTGACTACTGG	CARRTGGSYPKSDYW	IGHV4-4	IGHJ4
TGTGCGAAAGATGCCCCTTGCTGCAGTGGCTGTTCGGTAATACCTTCGGACTGGTTCGACCCCTGG	CAKDAPCCSGCSVIPSDWFDPW	IGHV3-NL1	IGHJ5
TGTGTAACCCGGCAAGGTCTAGCAGCAGCTGGGGACTGGTTCGACCCCTGG	CVTRQGLAAAGDWFDPW	IGHV1-3	IGHJ5
TGTGCGAATATGGTTCAGGGAGTTATTACATTTAGGTACTTCGATCTCTGG	CANMVQGVITFRYFDLW	IGHV3-NL1	IGHJ2
TGTGCGAGACCCTATAGCAGCAGCTGGTACGCGGACCCTCACCCGTTTGACTACTGG	CARPYSSSWYADPHPFDYW	IGHV4-39	IGHJ4
