TGTGCGAAAGAGACGTATTACGATTTTTGGAGTGGTTATTATACACGGGCGACTGGATACTACTTTGACTACTGG	CAKETYYDFWSGYYTRATGYYFDYW	IGHV3-23	IGHJ4
TGTGCGAGAGTGAGTATAGCAGCTCGTCCTTTTGATATCTGG	CARVSIAARPFDIW	IGHV3-53	IGHJ3
TGTGCGAGAGGTATAGTAGTGGTTATTACCAGGTCCCAGTACTACTTTGACTACTGG	CARGIVVVITRSQYYFDYW	IGHV1-69	IGHJ4
TGTGCGAGAGGCCCTTATGAAACCACTAACTGCTACTGG	CARGPYETTNCYW	IGHV5-51	IGHJ4
TGTGCACGGATTAAGCCTCCCAAGCTGCTACTGTCCGACTACTGG	CARIKPPKLLLSDYW	IGHV2-70	IGHJ4
TGTGCGAAAATCTGGAGGCCTGGGATAGGATATTGTAGTGGTGGTAGCTGCTACCAGGATCTAATAATAGCAAACCTCCCTTTTGACTACTGG	CAKIWRPGIGYCSGGSCYQDLIIANLPFDYW	IGHV3-NL1	IGHJ4
TGTGCGAAAAATGTCCCCGCCGCTACATTTGGGGGAGTTATCGATCCACCCCTTGACTACTGG	CAKNVPAATFGGVIDPPLDYW	IGHV3-23	IGHJ4
TGTGCGAGAGATCGTTCTATGATAGCAGTGGCTGGTATCCCAGCAAAACCGTACTACTTTGACTACTGG	CARDRSMIAVAGIPAKPYYFDYW	IGHV3-21	IGHJ4
TGTGCGAGAGGGGGGGGGTTACGATATTTTGACTGGTTATTATCCATCGGCTACTACTACATGGACGTCTGG	CARGGGLRYFDWLLSIGYYYMDVW	IGHV3-21	IGHJ6
TGTGCGAGAGTTGGTACGGTGACTACTCACTACTGG	CARVGTVTTHYW	IGHV1-2	IGHJ4
TGTGCGAAAGCTGCCCTCGATCCGACCTCCGGGGGTCTACTATGGTTCAGGGAGTTACTGGGCCGCGCCTACTACTACTACTACATGGACGTCTGG	CAKAALDPTSGGLLWFRELLGRAYYYYYMDVW	IGHV3-NL1	IGHJ6
TGTGCGAGACAAGTGGTACTGGTGGTGTATGCTATATCGAAAAGGGCGTTCGACCCCTGG	CARQVVLVVYAISKRAFDPW	IGHV5-51	IGHJ5
TGTGCGAGCGATTACTATGATAGTAGTGGTTATCCTTTTTACCTCAACTTTGACTACTGG	CASDYYDSSGYPFYLNFDYW	IGHV4-39	IGHJ4
TGTGCAAGAGGTTATTTGAAGCATATTGTAGTAGTACCAGCTGCTATGGGAGTCCGGCTCTACTACTACTACTACATGGACGTCTGG	CARGYLKHIVVVPAAMGVRLYYYYYMDVW	IGHV3-74	IGHJ6
TGTGCGAGAGGTGCAGTAGTACCAGCTGCTATATTCTTTGACTACTGG	CARGAVVPAAIFFDYW	IGHV4-59	IGHJ4
TGTGCGAGAGTAGTGAGGGTTGTCGCTGCCGGGGTGATTGCTCCTGGCTCGCGGATTTTGACAAACCTTGACTACTGG	CARVVRVVAAGVIAPGSRILTNLDYW	IGHV3-53	IGHJ4
TGTGCGAGAGACCCTACGCCCTTCCTACGGGGTGTGTTTGACTACTGG	CARDPTPFLRGVFDYW	IGHV4-59	IGHJ4
TGTGCGAGAGAGTCTGATCGCCGGTATGGTTCAGGGACAGCAATGTGTAAACCGTACTACTACTACTACATGGACGTCTGG	CARESDRRYGSGTAMCKPYYYYYMDVW	IGHV3-7	IGHJ6
TGTGCGAGAGACGCTAGAGATTTACCAAAGTTGAGTTACGGTGACTACTTCCTCCTGTTTGATGCTTTTGATATCTGG	CARDARDLPKLSYGDYFLLFDAFDIW	IGHV5-10-1	IGHJ3
TGTGCGGACCGCATGGTTCAGGGAGTTATTAGGGGAGTGGCTGCTTTTGATATCTGG	CADRMVQGVIRGVAAFDIW	IGHV3-21	IGHJ3
TGTGCGAGAGATTTCGTTGTTCTGGAGTATAGCAGCTCGTCATGGGATGCTTTTGATATCTGG	CARDFVVLEYSSSSWDAFDIW	IGHV3-48	IGHJ3
TGTGCGAGAGATCAGTCCGATTCCAAACTCACCCAGCGATATTGTAGTAGTACCAGCTGCTATCCGGGTCGATTGTGG	CARDQSDSKLTQRYCSSTSCYPGRLW	IGHV1-2	IGHJ5
TGTGCGAGAGTCCCCGGGGGCTACGGTGACGAAGGAGACCACTTTGACTACTGG	CARVPGGYGDEGDHFDYW	IGHV3-21	IGHJ4
TGTGCGAGACCGGAGCCCTATGGTTCAGGGAGTTATTATGCCCCCCGCCGTGACTACTGG	CARPEPYGSGSYYAPRRDYW	IGHV1-46	IGHJ4
TGTGCGAAAGCGGTGGACGTGTACAGCTACTGG	CAKAVDVYSYW	IGHV3-NL1	IGHJ4
TGTGCGAGAGATTATAGCAGCTGTGTGAAGTTTGAAATACACTACTGG	CARDYSSCVKFEIHYW	IGHV3-53	IGHJ4
TGTGCAAGAAGAATGAGGCACCAGCAGCTGGTCCGAAAAGCTTTGTCGACAGGTATCCCTCCCGCCAGAAAGTGGGGTACACTGGGCAGGAGCAACTGGTTCGACCCCTGG	CARRMRHQQLVRKALSTGIPPARKWGTLGRSNWFDPW	IGHV1-45	IGHJ5
TGTGCGAAGGCTATCTATTATGATTACGTTTGGGGGAGTGGAACTTGGGTAATGGGCTGGTTCGACCCCTGG	CAKAIYYDYVWGSGTWVMGWFDPW	IGHV3-NL1	IGHJ5
TGTGCAAGACGTAGAGATGGCTACAATTACGTCTTTGACTACTGG	CARRRDGYNYVFDYW	IGHV3-74	IGHJ4
TGTGCGAGAGGGACGTTCGGGGAGTTATTAGGCTGCTACTTTGACTACTGG	CARGTFGELLGCYFDYW	IGHV3-53	IGHJ4
TGTGCGAAAGGGCCCGGGACCATAGTGGCTACGGCAACCGTGGCTGACTACTGG	CAKGPGTIVATATVADYW	IGHV3-23	IGHJ4
TGTGCGAGACCGAACTATAGCAGTGGCAAATACTTTGACTACTGG	CARPNYSSGKYFDYW	IGHV5-51	IGHJ4
TGTACCACAGATCAGGTTTATGGGGTGGTGATTGCTATACGGGAGGACAAATACTTCCAGCACTGG	CTTDQVYGVVIAIREDKYFQHW	IGHV3-15	IGHJ1
TGTGCGAGAGGTCTAGTACGATTTTTGGAGTGGTTACGGCCCCCCTACTGG	CARGLVRFLEWLRPPYW	IGHV3-21	IGHJ4
TGTGCGAGAGTTGAACTGATTTTGGAGTGGTTACTTCCCTTTGACTACTGG	CARVELILEWLLPFDYW	IGHV3-66	IGHJ4
TGTGCGAGAGTTCCCGGCCCAAGACGCGCAGCTCGGATTTACTGG	CARVPGPRRAARIYW	IGHV1-46	IGHJ4
TGTGCGAGAGATCGCAAATATTGTAGTGGTGGTAGCTGCTACTCAAGTGAGGAAATTAATGGGTACTACTACTACATGGACGTCTGG	CARDRKYCSGGSCYSSEEINGYYYYMDVW	IGHV3-7	IGHJ6
TGTGCGAGAGATGTCCGGAGTAGTATTGTAGTAGTACCAGCTGCTATGATGTACGACAACCTCTACTACTACTACATGGACGTCTGG	CARDVRSSIVVVPAAMMYDNLYYYYMDVW	IGHV1-3	IGHJ6
TGTGCACACAGACGGGGACGTCATTGTAGTGGTGGTAGCTGCTACGCTTCCTACTTTGACTACTGG	CAHRRGRHCSGGSCYASYFDYW	IGHV2-5	IGHJ4
TGTGCGAGATCCTTACATAGCAGTGGCTGGTACCAATCCGGACCTTACTACTACTACTACATGGACGTCTGG	CARSLHSSGWYQSGPYYYYYMDVW	IGHV3-11	IGHJ6
TGTGCGAGACGGAATATTGTAGTGGTGGTAGCTGCTACGGGCCTGGGGGGCAACGACTACTGG	CARRNIVVVVAATGLGGNDYW	IGHV3-23	IGHJ4
TGTGCGATCCCGGATAGAGCAGCTGGCATGTACAACTGGTTCGACCCCTGG	CAIPDRAAGMYNWFDPW	IGHV3-NL1	IGHJ5
TGTGCGAGACCGGAAGGATATAACTGGAACGACATCTGGTTCGACCCCTGG	CARPEGYNWNDIWFDPW	IGHV3-48	IGHJ5
TGTGCGAGAGATAGGGTTACGATTTTTGGAGTGGTTATTATACTCCCGGACTACTACTACTACTACATGGACGTCTGG	CARDRVTIFGVVIILPDYYYYYMDVW	IGHV3-53	IGHJ6
TGTGCGTTACGGGGGAGATTACTATGGTTCAGGGAGTTATTATCCGGGCCCTCTGGGTGCTTCGGGTACTACTACTACTACATGGACGTCTGG	CALRGRLLWFRELLSGPSGCFGYYYYYMDVW	IGHV4-61	IGHJ6
TGTGCGAGGGGTATATATTGTAGTAGTACCAGCTGCGGCTACTACTACTACTACATGGACGTCTGG	CARGIYCSSTSCGYYYYYMDVW	IGHV1-69	IGHJ6
TGTGCGAAAATGGCTTTTGACTGGTTATTACTCGTGCACGGAAGTGACTACTGG	CAKMAFDWLLLVHGSDYW	IGHV3-NL1	IGHJ4
TGTGCGACCCCGTATAGCAGCTCGTCCACTCTCCACTGGTTCGACCCCTGG	CATPYSSSSTLHWFDPW	IGHV4-59	IGHJ5
TGTGCGAGACCTGTTATGACTACGGTGACTACGTTGGTTTCATACTACTACTACTACATGGACGTCTGG	CARPVMTTVTTLVSYYYYYMDVW	IGHV3-11	IGHJ6
TGTGCGAGAGGCTTTGTGGTGGTAGCTGCTACTCGAGTTGACTACTGG	CARGFVVVAATRVDYW	IGHV3-53	IGHJ4
TGTGCGAGACATGGTCCGCGCCTTGTAGTAGTACCAGCTGCTATATGGGGCTCCTACTGG	CARHGPRLVVVPAAIWGSYW	IGHV4-39	IGHJ4
TGTGCGAGAGATGGTGGACCGGAAGTAAGGGGGCGATATTTTGACTGGTTATGCAACTGGTTCGACCCCTGG	CARDGGPEVRGRYFDWLCNWFDPW	IGHV1-46	IGHJ5
TGTGCGAGAGATAGGGCCGCCGTCCTATTACGATATTTTGACTGGTTATTATCCGCAGTCCGCTACTACTACTACATGGACGTCTGG	CARDRAAVLLRYFDWLLSAVRYYYYMDVW	IGHV3-30	IGHJ6
TGTGCGAGAGACCCTCCATATATTGTAGTGGTGGTAGCTGCTACTCCGTTCCCGTTTGGAGGGAGCGGAAGTCGGACATACTACTACTACATGGACGTCTGG	CARDPPYIVVVVAATPFPFGGSGSRTYYYYMDVW	IGHV4-38-2	IGHJ6
TGTGCGTGTATTGTAGTAGTACCAGCTAGCTCAGGCGGAGAGTACTACTTTGACTACTGG	CACIVVVPASSGGEYYFDYW	IGHV3-30-3	IGHJ4
TGTACTAGAGGAGGGATTTTCCGCATAGCAGCAGCTGGTACGACCTTCCTTCTATTGGCCGGGTACTACTACTACTACTACATGGACGTCTGG	CTRGGIFRIAAAGTTFLLLAGYYYYYYMDVW	IGHV3-73	IGHJ6
TGTGCGAGACGCATAGTGGCTGGTAACTTTGACTACTGG	CARRIVAGNFDYW	IGHV5-51	IGHJ4
TGTGCGAAAAGAGTGAGGGCGTCTCAATATTGTAGTGGTGGTAGCTGCTACGTTAAGGGAGTCCTTAAGGTCTACTTTGACTACTGG	CAKRVRASQYCSGGSCYVKGVLKVYFDYW	IGHV3-23	IGHJ4
TGTGCGAAAGTTTCGAGTATTACTATGATAGTAGTGGTTATTACTGCGTTCGACCCCTGG	CAKVSSITMIVVVITAFDPW	IGHV3-NL1	IGHJ5
TGTGCTAGAGATCGAGCAGCTGGTAGCTACTTTGACTACTGG	CARDRAAGSYFDYW	IGHV3-72	IGHJ4
TGTGCGAGAAACCCGGGTAGCCCGGATTACGTATTACGATTTTTGGAGTGGTTATTATACGGAAGGTCTTGGGACTACTGG	CARNPGSPDYVLRFLEWLLYGRSWDYW	IGHV7-4-1	IGHJ4
TGTGCGAGGAACTATTCCATACAGCTATGGTTACGTGATTTCCGCTACTGG	CARNYSIQLWLRDFRYW	IGHV3-21	IGHJ4
TGTGCACACAGGGGGTTATTAGGCTGGTCACGGGTGAGAGTTTGCAGTATAGTGGGAGCTACTATCTACTGG	CAHRGLLGWSRVRVCSIVGATIYW	IGHV2-5	IGHJ4
TGTGCGAGAGCTTCGGACTACGGTGACTCTGGGGTGTTTGACTACTGG	CARASDYGDSGVFDYW	IGHV4-61	IGHJ4
TGTGCGAGGATTCAGGTGAATATAGCAGCTTCGGATAAGGGTCACTACTTTGACTACTGG	CARIQVNIAASDKGHYFDYW	IGHV1-18	IGHJ4
TGTGCGAGATATATTACTATGGTTCAGGGAGCAATAACCTACTACTACATGGACGTCTGG	CARYITMVQGAITYYYMDVW	IGHV4-34	IGHJ6
TGTACCACAGATACCCCGATGATAGTAGTGGAAATACCTTCCGGTTTCGGGATCTTCGATTCGGGAGATCTCGGCGCTTTTGATATCTGG	CTTDTPMIVVEIPSGFGIFDSGDLGAFDIW	IGHV3-15	IGHJ3
TGTGCGAGAGAGACCCCCGGGTATAGCAGTGGCTGGCCCTCCTACTACTACATGGACGTCTGG	CARETPGYSSGWPSYYYMDVW	IGHV3-21	IGHJ6
TGTGCGAGAGGGGGGTATAGCAGTGGCTGGTACGTCAGGCGATTCTGG	CARGGYSSGWYVRRFW	IGHV4-34	IGHJ5
TGTGCGAAATTGCAGTATTACTATGATAGTAGTGGTTATTGTATTGACTACTGG	CAKLQYYYDSSGYCIDYW	IGHV3-23	IGHJ4
TGTACTTGTAGTGGTGGTAGCTGCTACGGAGGGACTTGG	CTCSGGSCYGGTW	IGHV3-9	IGHJ4
TGTGCGAGATATATCTATATCGAGTATAGCAGCTCGTCCGGACAAAAATTTGACTACTGG	CARYIYIEYSSSSGQKFDYW	IGHV4-38-2	IGHJ4
TGTGAGGCTCCGGGTTCAGGGAGTTATTATGTCATCACCTTTTACTACTACTACTACATGGACGTCTGG	CEAPGSGSYYVITFYYYYYMDVW	IGHV3-30	IGHJ6
TGTGGCCATTATGATTACATTTGGGGGAGTTATCGTGGCCATTACTACTACTACTACTACATGGACGTCTGG	CGHYDYIWGSYRGHYYYYYYMDVW	IGHV5-51	IGHJ6
TGTGCGAGAAGCCTACAATTATGTGTACAGCTCGTCCCAACGGTAAGCTACTACTACTACTACATGGACGTCTGG	CARSLQLCVQLVPTVSYYYYYMDVW	IGHV4-38-2	IGHJ6
TGTGCGAGAGCAGCCGTCTACTGG	CARAAVYW	IGHV1-69	IGHJ4
TGTGCGAGGGGCCGTCCAGGGCAGGGGGACTATGGTTCAGGGAGTTATTATGGGTTAGGTGATGCTTTTGATATCTGG	CARGRPGQGDYGSGSYYGLGDAFDIW	IGHV3-7	IGHJ3
TGTGCGAGAGATCCCCATAGTGGTGGTAGCTGCTACGGAACCAACTACTACTACTACATGGACGTCTGG	CARDPHSGGSCYGTNYYYYMDVW	IGHV1-18	IGHJ6
TGTGCGAGAGATCCCCCCTGCCTTGACTACTGG	CARDPPCLDYW	IGHV3-53	IGHJ4
TGTGCGAGACCGTCCGTATTACGATTTTTGGAGTGGTTAGACGACCACTACTACTACATGGACGTCTGG	CARPSVLRFLEWLDDHYYYMDVW	IGHV4-38-2	IGHJ6
TGTGCACGGATTATCCCTTTCGATTTTTGGAGTGCCAACGGGCTCTACACCTACTACTACTACTACATGGACGTCTGG	CARIIPFDFWSANGLYTYYYYYMDVW	IGHV2-26	IGHJ6
TGTGCGAAAGATCTAGTAGAGGTTGACTACTGG	CAKDLVEVDYW	IGHV3-NL1	IGHJ4
TGTGCGAAAGAAGCACAGTACGGTGACTACGTGAACGATGCTTTTGATATCTGG	CAKEAQYGDYVNDAFDIW	IGHV3-23	IGHJ3
TGTGCTAGAGATTACAGTAAAGATAGCAGTGGCTGGTACTTTGACTACTGG	CARDYSKDSSGWYFDYW	IGHV3-72	IGHJ4
TGTGCGAAAGCCGCGCCACGAAGGCCGTTGATGGCTACAATTAGGATTGCTTTTGATATCTGG	CAKAAPRRPLMATIRIAFDIW	IGHV3-NL1	IGHJ3
TGTGCGAGAGCCTTGCGGTGTATTACGATTTTTGGAGTGGTTATTCTTCCTTCCGTGTACTACTACTACTACTACATGGACGTCTGG	CARALRCITIFGVVILPSVYYYYYYMDVW	IGHV3-53	IGHJ6
TGTGCGAATGGAATTTTGGAGTGGTTATTCGGATACGGAATTTCCCAATACTACTACTACATGGACGTCTGG	CANGILEWLFGYGISQYYYYMDVW	IGHV3-NL1	IGHJ6
TGTGCGAAACCGCCCGAGGGTTTATATTGTAGTAGTACCAGCTGCTACCCCATTATGGACGTCTGG	CAKPPEGLYCSSTSCYPIMDVW	IGHV3-23	IGHJ6
TGTGCGAGTTTCAGGCAGTGGCTGGTAACCGAGTACTACTTTGACTACTGG	CASFRQWLVTEYYFDYW	IGHV4-59	IGHJ4
TGTACCACAGATCGTCCCATGGGCCGTATAGCAGTGGTGCCCTACTGG	CTTDRPMGRIAVVPYW	IGHV3-15	IGHJ4
TGTGCGAGAGATACCCAACCGGGGGGGATTGTACTGGTGGTGTATGCTATACCAGGGCTTCTGTGGGAAGTCCCCGTTACCTTTGACTACTGG	CARDTQPGGIVLVVYAIPGLLWEVPVTFDYW	IGHV1-18	IGHJ4
TGTGCGAGAGATCATTTTGTCATGGTTCAGGGAGTTGGAAATTACTACTACTACTACTACATGGACGTCTGG	CARDHFVMVQGVGNYYYYYYMDVW	IGHV4-4	IGHJ6
TGTGCGAGAGATGGGGATATAGTTTACGTTTGGGGGAGTTATCGTTATACTCCACGTCTGGGCTACTACTACTACTACATGGACGTCTGG	CARDGDIVYVWGSYRYTPRLGYYYYYMDVW	IGHV4-59	IGHJ6
TGTGCAAGAGATTCTGGTTATAGCAGCAGCTGCCACCTTAGAGGTAGGATTTCGACCTACTACTACTACATGGACGTCTGG	CARDSGYSSSCHLRGRISTYYYYMDVW	IGHV3-13	IGHJ6
TGTGCAAGAGGCACTGCCGGTAGTAGTACCAGCTGCGAGGCCCGATATTACTACTACTACTACTACATGGACGTCTGG	CARGTAGSSTSCEARYYYYYYYMDVW	IGHV1-45	IGHJ6
TGTGCGAGAGGTCCCGGGTCACTGTATTACTATGATAGTAGTGGTTGGGACTACTGG	CARGPGSLYYYDSSGWDYW	IGHV4-59	IGHJ4
TGTGCGAGGAAATATTACGATTTTTGGAGTGGTTATTATAGTAGGCCGCTCGCTGTTTACTACTACTACATGGACGTCTGG	CARKYYDFWSGYYSRPLAVYYYYMDVW	IGHV4-38-2	IGHJ6
TGTGCGAGAGTCGGGATCGGGGGTCCCCTCAGCAGCTCGGGTAACTGGTTCGACCCCTGG	CARVGIGGPLSSSGNWFDPW	IGHV4-59	IGHJ5
TGTGCGATCTTCGATATAGTGGCTACGATCACCCGTAGTGCTTTTGATATCTGG	CAIFDIVATITRSAFDIW	IGHV3-23	IGHJ3
TGTGCGAGAGGGCCTGGGCCCTCTTACTACTACTACTACTACATGGACGTCTGG	CARGPGPSYYYYYYMDVW	IGHV1-2	IGHJ6
