TGTGCGAGAGGTGTACGAACAGTGGTGGTAGCCGTGAGTTATTGCTGCTTCCAGCACTGG	CARGVRTVVVAVSYCCFQHW	IGHV3-66	IGHJ1
TGTGCGAGAGATCGGCTTAGCAGCTGGTCTTATTGCTACTACTTTGACTACTGG	CARDRLSSWSYCYYFDYW	IGHV3-48	IGHJ4
TGTGCGAGCATCGAGAAGACGGGGTATAGCAAGGGTCACTACTACTACTACATGGACGTCTGG	CASIEKTGYSKGHYYYYMDVW	IGHV3-21	IGHJ6
TGTGCGAGAGGATGTCAGGGTAGTAGATTCAACACCTCCTTTGACTACTGG	CARGCQGSRFNTSFDYW	IGHV3-7	IGHJ4
TGTGCGAAATACAACACTGGCCATGATGCTTTTGATATCTGG	CAKYNTGHDAFDIW	IGHV1-3	IGHJ3
TGTGCACACAGACCCCGCGTAATTGTAGTGGTGGTAGCTGCTACTTGCACTCTGCGGCAGATATACTACTACTACTACTACATGGACGTCTGG	CAHRPRVIVVVVAATCTLRQIYYYYYYMDVW	IGHV2-5	IGHJ6
TGTGCGAGACTAAAGTACGGTGGTAACTCCGGAGGGTTTCGGTACTACTTTGACTACTGG	CARLKYGGNSGGFRYYFDYW	IGHV4-39	IGHJ4
TGTGCGAGTTGTGCTGGCCCCCCGGACTTGTTGGGGGGTGAAACGTATTACGATTTTTGGAGTGGGTTCACCTGGGACTACTGG	CASCAGPPDLLGGETYYDFWSGFTWDYW	IGHV3-21	IGHJ4
TGTGCGAGACATGTCTTCTATTACGATTTTTGGAGTGGTTATTATCACGACGTTACTCCCTGCCGTCACTGG	CARHVFYYDFWSGYYHDVTPCRHW	IGHV5-51	IGHJ4
TGTGCAAGAGCCACGTATTATGATTACGTTTGGGGGAGTTATCGTTATACGCTTATCCCGTACTACTTTGACTACTGG	CARATYYDYVWGSYRYTLIPYYFDYW	IGHV3-13	IGHJ4
TGTGCGAGAGACGGGGGATTACTATGGTTCAGGGAGTTATTACCTTACTACTTTGACTACTGG	CARDGGLLWFRELLPYYFDYW	IGHV3-53	IGHJ4
TGTGCGAGCCTACCTGGAATACGTATTACGATTTTTGGAGTGGTTATCCTAGTAAGTGGCGAGGGGGGGATGGGTTCAGGTGACTACTGG	CASLPGIRITIFGVVILVSGEGGMGSGDYW	IGHV1-46	IGHJ4
TGTGCGAGAGATCGTTTCCGGGGTATAGCAGTGGCGGTCCACTACTACATGGACGTCTGG	CARDRFRGIAVAVHYYMDVW	IGHV3-7	IGHJ6
TGTGCGAGATCGCATATTGTGGTGGTGACTGTAGCCCGCTTTGACTACTGG	CARSHIVVVTVARFDYW	IGHV4-59	IGHJ4
TGTGCACACAGACACTTTGGAGCAGCAGCTGGATGGGGTCCGGGGCGGAAATCTCCGCACTTAGGGGACTTTGACTACTGG	CAHRHFGAAAGWGPGRKSPHLGDFDYW	IGHV2-5	IGHJ4
TGTGCACGGTATGAGTCAACTCGGCCACTTCGTAGGGTTTGGAGTGGTTATTATTCCCCCACTAGATATAGGGGTGGAGTTCAACCGAAGCCTTACTACTACTACTACTACATGGACGTCTGG	CARYESTRPLRRVWSGYYSPTRYRGGVQPKPYYYYYYMDVW	IGHV2-26	IGHJ6
TGTGCGAGATTGCAAAGCAGCAGCTGGTACGTGCGTTTGACAAGATCCTACTGG	CARLQSSSWYVRLTRSYW	IGHV5-10-1	IGHJ4
TGTGCGAGACGTGGCTCTAGTTATTACGATTTTTGGAGTGGTTATTATTCCTACTACTACTACATGGACGTCTGG	CARRGSSYYDFWSGYYSYYYYMDVW	IGHV4-39	IGHJ6
TGTGCGAGAGACCGGTGGCGATTAGGATATTGTAGTAGTACCAGCTGCTATGGACGTGCCAGGGAGCCCGAATGCATGATTGGGGTTGAAGTAACCGCCTGGTTCGACCCCTGG	CARDRWRLGYCSSTSCYGRAREPECMIGVEVTAWFDPW	IGHV1-18	IGHJ5
TGTGCGAAAGTAGGGTGGTATAGCAGCAGCTGGTACGTAGGGCACTTTGACTACTGG	CAKVGWYSSSWYVGHFDYW	IGHV3-NL1	IGHJ4
TGTACTAGAGGGCCGATTTTTGGAGTGGTTAACCGGGCACACTGGTTCGACCCCTGG	CTRGPIFGVVNRAHWFDPW	IGHV3-49	IGHJ5
TGTGCGAGAGAAAACCCGGCGAAGATTTGTGTATTACGATTTTTGGAGTGGTTAAAGGGGGGGAACTACTTTGACTACTGG	CARENPAKICVLRFLEWLKGGNYFDYW	IGHV3-66	IGHJ4
TGTGCGAAAGTTTGTCATGAAGTACCAGCTGCTATCCGGAATGTCTACACGTACAACTGGTTCGACCCCTGG	CAKVCHEVPAAIRNVYTYNWFDPW	IGHV3-23	IGHJ5
TGTGCGAGAATCAGCGGATATTGTAGTAGTACCAGCTGCTATAACTGG	CARISGYCSSTSCYNW	IGHV4-38-2	IGHJ4
TGTGCGAGAGCTACGGTGGTAGCTGCTAGCCCGAACTACTTTGACTACTGG	CARATVVAASPNYFDYW	IGHV4-59	IGHJ4
TGTGCGAGAGTTAGGAAGGAAATAAGCAGTGGCTGTTGGTGG	CARVRKEISSGCWW	IGHV4-34	IGHJ4
TGTGCGAGAGAGACGCAAGCTCCCTCCTCGGGTGGATACAGCTATGGTTCGCCCTACTACTACATGGACGTCTGG	CARETQAPSSGGYSYGSPYYYMDVW	IGHV3-20	IGHJ6
TGTGCGAGACGGATTACGATTTTTGGAGTGGTTATTATACGGTACTACATGGACGTCTGG	CARRITIFGVVIIRYYMDVW	IGHV1-46	IGHJ6
TGTGCGAGAGATATCCAAGGTTGCAACATGTTCTCCTTGTTTGACTACTGG	CARDIQGCNMFSLFDYW	IGHV1-46	IGHJ4
TGTGCGATCAAGTGGCGTAGTAGTACCAGCTGCTATGGTTCCCGAGGGGAGAACATGACTAGAAGGTTTGTATTGAACTGGTTCGACCCCTGG	CAIKWRSSTSCYGSRGENMTRRFVLNWFDPW	IGHV1-3	IGHJ5
TGTGCGAGCTCGAGCCTACGGGGGGTTTCGACCTGG	CASSSLRGVSTW	IGHV3-64	IGHJ5
TGTGCGAGAGGGGTGGATATTGTAGTAGTACCAGCTGCTCCCTTTGACTACTGG	CARGVDIVVVPAAPFDYW	IGHV7-4-1	IGHJ4
TGTGCGAGAGATACCTTTGGGTTATCACCGTATTACTATGATAGTAGTGGTTATTACAACTGG	CARDTFGLSPYYYDSSGYYNW	IGHV1-46	IGHJ5
TGTGCGAAAGTGTATGGCAGTGGCTGGTCAGCTCCCGACTACTACTACTACATGGACGTCTGG	CAKVYGSGWSAPDYYYYMDVW	IGHV3-NL1	IGHJ6
TGTGCAAGAGCGGCCTGGTTCGACCCCTGG	CARAAWFDPW	IGHV3-74	IGHJ5
TGTGCGAAAGATCGTGGACTAGGGTATAGCAGCAGCTCCGTATACTGG	CAKDRGLGYSSSSVYW	IGHV3-NL1	IGHJ4
TGTGCAAGAGATCGCATGCCAGTGGTGGTAGCTGCTCTATTATGCTACTACTACATGGACGTCTGG	CARDRMPVVVAALLCYYYMDVW	IGHV3-13	IGHJ6
TGTGCGAGAATCCCCCGGGTCAACTACGATTTTTGGAGTGGTTACCCCGTGCGTAAGGTTCCATATTACTACTACTACTACTACATGGACGTCTGG	CARIPRVNYDFWSGYPVRKVPYYYYYYYMDVW	IGHV5-10-1	IGHJ6
TGTGCGAGCCAGTACATAGCAGTGGCTGGTTGG	CASQYIAVAGW	IGHV4-38-2	IGHJ4
TGTGCACACAGTCTCCAGGGATTGGCTAGGCAAGGCCCAAAGTGTATAGCAGTGGCTGGTACCCGGTACTTTGACTACTGG	CAHSLQGLARQGPKCIAVAGTRYFDYW	IGHV2-5	IGHJ4
TGTGCGAAAGATCTTTTGCGAGAGGGTCCCAATCACTATAGCAGCTCGTCGGCCTCCCTCTACTACTACATGGACGTCTGG	CAKDLLREGPNHYSSSSASLYYYMDVW	IGHV3-23	IGHJ6
TGTGCGACCGCGCGCGGAGTGCGAACCGTTCCGGGTATAGCAGTGGCTGGTACGCCGGAGGACTACTGG	CATARGVRTVPGIAVAGTPEDYW	IGHV3-23	IGHJ4
TGTGCGAGAGATCAGGAGCAAACTAATTACTATGATAGTAGTGGTCGTGGCCTATTCTGG	CARDQEQTNYYDSSGRGLFW	IGHV1-3	IGHJ3
TGTGCACGGATCCTTAGGATGGTTGTACTGGTGGTGTATGCTATACATACTCCTGGGTACTACTACTACATGGACGTCTGG	CARILRMVVLVVYAIHTPGYYYYMDVW	IGHV2-26	IGHJ6
TGTGCGAGAGATGTCTACGATTTTTGGAGTGGTTATTACTTTGACTACTGG	CARDVYDFWSGYYFDYW	IGHV3-21	IGHJ4
TGTGCGAGACGAATCCCACGGATACAGCTATGGGATCACACAAGCCGTCCAGGTAAATTCGACTTTGACTACTGG	CARRIPRIQLWDHTSRPGKFDFDYW	IGHV4-38-2	IGHJ4
TGTGCGAGACCTTCCGCCATTGTAGTGGTGGTAGCTGCTATTGATGATGCTTTTGATATCTGG	CARPSAIVVVVAAIDDAFDIW	IGHV5-10-1	IGHJ3
TGTGCGAGACATGTATTACGATATTTTGACTGGTTATCGGAAGATTGGTACTGG	CARHVLRYFDWLSEDWYW	IGHV5-51	IGHJ4
TGTGCGAAAGATCCGATTACGATTTTTGGAGTGGTTATTATTGTTTGG	CAKDPITIFGVVIIVW	IGHV3-NL1	IGHJ5
TGTGCGACAGAAAACTGGACCTCCGGCTGGTACTTCGATCTCTGG	CATENWTSGWYFDLW	IGHV1-3	IGHJ2
TGTGCGAAAGAAGTACTTGATGATAGTAGTGGTTATTACTACTCTGGCCGTGACTACTGG	CAKEVLDDSSGYYYSGRDYW	IGHV3-23	IGHJ4
TGTGCGAGCTATGGGGTAGTACCAGCTGCGCAGGTCTCGAAGTACTACTTTGACTACTGG	CASYGVVPAAQVSKYYFDYW	IGHV1-2	IGHJ4
TGTGCGAGAGATGGGAGGATTATTGTAGTAGTACCAGCTGCTATTAGATCTTCCGACTACTACTACTACTACATGGACGTCTGG	CARDGRIIVVVPAAIRSSDYYYYYMDVW	IGHV1-46	IGHJ6
TGTGCGAAAGATGGGGCCAAAGGAGGGTTCTGTATTGTAGTAGTACCAGCTGCTAAATTTGACTACTGG	CAKDGAKGGFCIVVVPAAKFDYW	IGHV3-NL1	IGHJ4
TGTGCGAGAGATCCGAACGTAGCAGCTCGTCGGAATAAGGGTTACTACTTTGACTACTGG	CARDPNVAARRNKGYYFDYW	IGHV4-59	IGHJ4
TGTGCGAAAGATGGCAGACATTACTATGGTTCAGGGAGTTACTGG	CAKDGRHYYGSGSYW	IGHV3-NL1	IGHJ4
TGTGCGAGAGGGCAAGATGATAGTAGCTTCGGGGTTCAGTTTGACTACTGG	CARGQDDSSFGVQFDYW	IGHV4-34	IGHJ4
TGTGCGAGAGGCCTAACCCTGTATTACGATTTTTGGAGTGGTTATAGGTACTACTACTACTACATGGACGTCTGG	CARGLTLYYDFWSGYRYYYYYMDVW	IGHV1-2	IGHJ6
TGTGCGAAAGTCGATATTGTAGTGGTGGTAGCTCCACTGTCTTGGCGTACATTAATCTACTGG	CAKVDIVVVVAPLSWRTLIYW	IGHV3-23	IGHJ4
TGTGCAAGAGGGGGTACTATGATAGTAGTGGTTATTATAGGGTTGGCTCCCGGCCCCCCACTCTGG	CARGGTMIVVVIIGLAPGPPLW	IGHV3-13	IGHJ3
TGTGCGAAAGATATAGTAGAGGGGGATATTGTAGTGGTGGTAGCTGCTAAAAGGTCCCGTCCGTCCGGCTGGTTCGACCCCTGG	CAKDIVEGDIVVVVAAKRSRPSGWFDPW	IGHV3-NL1	IGHJ5
TGTGCGAGAGATCCGTATCTTGAGGGGACGTATTACTATGGTTCAGGGAGTTATGGCGTGTGCTACTGG	CARDPYLEGTYYYGSGSYGVCYW	IGHV1-69	IGHJ4
TGTGCACGGATACCCTTCCACTGTATTGTACTGGTGGTGTATGCTATAGTTTTGCGGGGTTACTACTACATGGACGTCTGG	CARIPFHCIVLVVYAIVLRGYYYMDVW	IGHV2-26	IGHJ6
TGTGCGAAAGGCGTGGGGAGGCGTTATATAGCAGTGGCTGGACGCTACTTTGACTACTGG	CAKGVGRRYIAVAGRYFDYW	IGHV3-23	IGHJ4
TGTGCGAGACGCCTCCTGCGACCGGTAGCTGCTACCGTACGGAACTGGTTCGACCCCTGG	CARRLLRPVAATVRNWFDPW	IGHV1-18	IGHJ5
TGTGCGAGAGGGCTCCCCGTAGTAGTACCAGCTGCTATGGTAAGGGCTCCTATGGACTGGTTCGACCCCTGG	CARGLPVVVPAAMVRAPMDWFDPW	IGHV1-69	IGHJ5
TGTGCGAGAGATCCGGTTAGTCGCGCAGCAGCTGGTACGTACGGGTCCAGCTCCCCAGCCTTTGACTACTGG	CARDPVSRAAAGTYGSSSPAFDYW	IGHV1-69	IGHJ4
TGTGCGAGAGTAAGCAGCAGCTGGTACGAAGAAGACTTTGACTACTGG	CARVSSSWYEEDFDYW	IGHV3-53	IGHJ4
TGTGCGAGAGGCGGGGGGGGTGGTGACTGCTATTCGCTTAGTTACTGG	CARGGGGGDCYSLSYW	IGHV3-53	IGHJ4
TGTGCGAGTGAGATGGGTTTTTGGAGTGGTTATCCTGACTACTGG	CASEMGFWSGYPDYW	IGHV3-21	IGHJ4
TGTACCACAGGAAACCAGGATATTGTAGTGGTGGTAGCTCGTGACTACTGG	CTTGNQDIVVVVARDYW	IGHV3-15	IGHJ4
TGTGCGAGAGGGGCGATGGGATACTACTTTGACTACTGG	CARGAMGYYFDYW	IGHV1-18	IGHJ4
TGTGCGAACTATAGCAGCAGCTGGCTCCCCTACTACTACTACTACTACATGGACGTCTGG	CANYSSSWLPYYYYYYMDVW	IGHV3-23	IGHJ6
TGTGCTAGAGATATGACTGATATTGTAGTGGTGGTAGCTGCCAAAAAGCTTCTCCCGTACCCTTCTGACTACTGG	CARDMTDIVVVVAAKKLLPYPSDYW	IGHV3-72	IGHJ4
TGTGCGAAAGATAAGCCTCCACCCCAGCTGTACAACTGGTTCGACCCCTGG	CAKDKPPPQLYNWFDPW	IGHV3-23	IGHJ5
TGTGCAAGAGATCATATTGGGGTCCTCCCGGGTCTCCGAGCATACTACTACTACTACATGGACGTCTGG	CARDHIGVLPGLRAYYYYYMDVW	IGHV3-74	IGHJ6
TGTGCGAAAGAATTCTCGGGTGGTAGCTGCTACATATTGGCCGAAGACTTTGACTACTGG	CAKEFSGGSCYILAEDFDYW	IGHV3-NL1	IGHJ4
TGTGCACACAGAAGCAAGCAAATTACTATGATAGTAGTGGGCCGGTTTGACTACTGG	CAHRSKQITMIVVGRFDYW	IGHV2-5	IGHJ4
TGTTCCCCGGGACGCGAAACTGACTACTGG	CSPGRETDYW	IGHV1-2	IGHJ4
TGTGCGAGAAGGCCTTATAGCAGCTCGTCCTGCCCACTTGTT	CARRPYSSSSCPLV	IGHV5-10-1	IGHJ5
TGTGCGAGACATTCATGCTACGGTGACTACGTGAGTCCTGTGGGGAACTGGTTCGACCCCTGG	CARHSCYGDYVSPVGNWFDPW	IGHV5-51	IGHJ5
TGTGCGAGAGAGCAGTGGCTGGGCTCCTGG	CAREQWLGSW	IGHV4-4	IGHJ3
TGTGCGAGAATCATTGTACTGGTGGTGTATGACTGGTTCGACCCCTGG	CARIIVLVVYDWFDPW	IGHV7-4-1	IGHJ5
TGTACCACAGGTCACCGTATTACGATTTTTGGAGTGGTTATTGACTACTACTACATGGACGTCTGG	CTTGHRITIFGVVIDYYYMDVW	IGHV3-15	IGHJ6
TGTGCGAGAACCCTGTCGCATTGTACTGGTGGTGTATGCTATATCCTTGGCAACTCAGCAGGGAGGAAGTCGACCCACTTTGACTACTGG	CARTLSHCTGGVCYILGNSAGRKSTHFDYW	IGHV3-53	IGHJ4
TGTGCGAGAGACCTACAGCTATGGTTACCCGTTAACCTAGTAGGATTGGACTGG	CARDLQLWLPVNLVGLDW	IGHV3-7	IGHJ4
TGTGCGAGGGCCCTATTACGATTTTTGGAGTGGTCCTACTACTACTACTACATGGACGTCTGG	CARALLRFLEWSYYYYYMDVW	IGHV5-51	IGHJ6
TGTGCGAGAGACTATATAGCAGTGGCTGGTACCGTTGACTACTGG	CARDYIAVAGTVDYW	IGHV1-18	IGHJ4
TGTGCGAGAGGGACCCTCAGGGCTCGGTTGTATGATTACATTTGGGGGAGTTATCGCCGGTACTACTTTGACTACTGG	CARGTLRARLYDYIWGSYRRYYFDYW	IGHV1-2	IGHJ4
TGTGCGAAACTCGAGGGTATAGCAGTGGCTGGTTCTCTGGCCTTTGACTACTGG	CAKLEGIAVAGSLAFDYW	IGHV3-NL1	IGHJ4
TGTGCGAAGGGCACTACCGTCGTGATAGTAGTGGTTATTAGTCTTTTGCCGGAAGTGAGATACTTTGACTACTGG	CAKGTTVVIVVVISLLPEVRYFDYW	IGHV3-NL1	IGHJ4
TGTGCGAGAGATCTCTGGATGACGACCCGAAAGGCCGTAACTACGGGGGCCTACTACTACTACTACATGGACGTCTGG	CARDLWMTTRKAVTTGAYYYYYMDVW	IGHV3-7	IGHJ6
TGTGCGAGACCCCAGATAGCGTATAGCAGTGGCTGTCTTGACTACTGG	CARPQIAYSSGCLDYW	IGHV5-51	IGHJ4
TGTGCGAGGAGTTTCACTATTGTAGTGGTGGTAGCTGCTACCACCCGTGACTACTGG	CARSFTIVVVVAATTRDYW	IGHV1-3	IGHJ4
TGTGCGAGAGACTTCCGGCTATGGTTCAGGGAGTTAGGGGTTGACTACTGG	CARDFRLWFRELGVDYW	IGHV3-66	IGHJ4
TGTGCAAGAGATCGGGGTTCCTATGATTACATTTGGGGGAGTTATCGTATAAGGAACTTTGACTACTGG	CARDRGSYDYIWGSYRIRNFDYW	IGHV3-13	IGHJ4
TGTACTAGAGGGGCCTATAGAGATGGCTCACCCTACTACTTTGACTACTGG	CTRGAYRDGSPYYFDYW	IGHV3-49	IGHJ4
TGTGCGAGACATCTTGATGTTATAACTGGAACGACCCGGACGTTTGACTACTGG	CARHLDVITGTTRTFDYW	IGHV1-18	IGHJ4
TGTGCGAGAGATCGGAATCCAGCTCCGTGGACCTACTCCATACTATGGTTTCATCGAACCGTTGACTACTGG	CARDRNPAPWTYSILWFHRTVDYW	IGHV3-48	IGHJ4
TGTGCGAGAGATCTACCTATCACCCCCGTCGCGCTGGAGGGGGTAAGTATAGCAGCAGCTGGTACGCGCCCTGATGCTTTTGATATCTGG	CARDLPITPVALEGVSIAAAGTRPDAFDIW	IGHV3-21	IGHJ3
