TGTGCGAGACCCCACACCCTGGTTCAGGGAGTTTTCCCCTTCAAGGGGGCAAACTGGTTCGACCCCTGG	CARPHTLVQGVFPFKGANWFDPW	IGHV4-39	IGHJ5
TGTGCACGTCCTGCCGCTACTATGGTTCAGGGAGTTACCGGTGACTACTGG	CARPAATMVQGVTGDYW	IGHV2-5	IGHJ4
TGTGCGAGATCGAGTCCCAGCAGCAGCTGGTGGTACTACTTTGACTACTGG	CARSSPSSSWWYYFDYW	IGHV1-69	IGHJ4
TGTGCGAGAGATATATTACGATATTTTGACTGGTTATTCTCCAGTGAGTACAACTGGTTCGACCCCTGG	CARDILRYFDWLFSSEYNWFDPW	IGHV3-7	IGHJ5
TGTGCGAGACCTTATAACGCAGTGGCAGGGGGGTTTGACTACTGG	CARPYNAVAGGFDYW	IGHV5-51	IGHJ4
TGTGCGAGAGACTTACGCAACCGGTGGAAAACTGATATTGTACTAATGGTGTATGCTATACCCTCAAGAGACTGG	CARDLRNRWKTDIVLMVYAIPSRDW	IGHV4-61	IGHJ4
TGTGCGAGAGAGCCCGCCTATGAAGCGGGACGCTCGGGGCCGTCCCGGACCCCCTATGGTTCAGGGAGTTATTATAACCTACCGGAGTACTACTACTACTACATGGACGTCTGG	CAREPAYEAGRSGPSRTPYGSGSYYNLPEYYYYYMDVW	IGHV3-7	IGHJ6
TGTGCGAGAGCCGGTCGTTATAGCAGCTCGTTAGTGTACTTTGACTACTGG	CARAGRYSSSLVYFDYW	IGHV1-18	IGHJ4
TGTGCGAGAGGGGCAGTATTACTATGGTTCGGGGGCCCCGCCTTGGCCCTCTGGTTCGACCCCTGG	CARGAVLLWFGGPALALWFDPW	IGHV4-59	IGHJ5
TGTGCGAGAGTAGGGGTTGTAGTAGTACCAGCTGCTACCGACTACTGG	CARVGVVVVPAATDYW	IGHV4-59	IGHJ4
TGTGCGAGAGGGGTTGGTCGGTCTAGTAGTGGTTATTACGTCTGTGCCTTATGGTTCGACCCCTGG	CARGVGRSSSGYYVCALWFDPW	IGHV3-21	IGHJ5
TGTACCGCGAAATTTGATAGCGGATATTGTAGTAGTACCAGCTGCGGTCCGAACTGGTTCGACCCCTGG	CTAKFDSGYCSSTSCGPNWFDPW	IGHV3-15	IGHJ5
TGTGCGAGCGGAGGTATAGCAGCAGCTGGTGTCGCCCGGCTCTACTGG	CASGGIAAAGVARLYW	IGHV3-7	IGHJ4
TGTGCACACATGTATCCGGACGTGGCTACGACCTCGAATGACTACTGG	CAHMYPDVATTSNDYW	IGHV2-5	IGHJ4
TGTGCGGTAAGCCTGCTAGTTCTTATCTCTATTACGATTTTTGGAGTGGTTATTATAAGACGCAAGACGGGGACAGCGTTTGACTACTGG	CAVSLLVLISITIFGVVIIRRKTGTAFDYW	IGHV3-20	IGHJ4
TGTGCGAGGGAGGTGTATTACTATGATAGTAGTGGACCCGACTGG	CAREVYYYDSSGPDW	IGHV3-23	IGHJ4
TGTGCGAGGTTCGCGGTTCCTTATAGCAGCAGCTGGTACGAATACAATCTACCTATGTTGAACATCGAGAACTGGTTCGACCCCTGG	CARFAVPYSSSWYEYNLPMLNIENWFDPW	IGHV1-2	IGHJ5
TGTGCGAGAGGCAGCAGCTGGTACATTGAATTTGACTACTGG	CARGSSWYIEFDYW	IGHV1-46	IGHJ4
TGTGCGAAAGGGGAGTCCTATTGTAGTAGTACCAGCTGCCACTTTGACTACTGG	CAKGESYCSSTSCHFDYW	IGHV3-NL1	IGHJ4
TGCCGCCCCTCGATATTGTACTGGTGGTGTATGCTATTTTCTTCGTTACGTGACTACTGG	CRPSILYWWCMLFSSLRDYW	IGHV3-20	IGHJ4
TGTGCACGGATACGGTTATTACACAGCTACTACTACTACTACATGGACGTCTGG	CARIRLLHSYYYYYMDVW	IGHV2-70	IGHJ6
TGTGCGAGAAGGGTCAGAAGGGAACTCCATCCTAGGATTCTAGTGTACTTTGACTACTGG	CARRVRRELHPRILVYFDYW	IGHV7-4-1	IGHJ4
TGTGCAAGAAGGGATATTGTAGTGGTGGTAGCTGCTAATGCTTTTGATATCTGG	CARRDIVVVVAANAFDIW	IGHV3-13	IGHJ3
TGTGCAAGATCCTCTGATAGCAGCAGAAAGTCGAGATTTGACTACTGG	CARSSDSSRKSRFDYW	IGHV1-45	IGHJ4
TGTGCGAAATTGTCCGACTCAGGGCTCGTAGTAGTACCAGCTGCTATGCCGTTTTACTACTACTACTACTACATGGACGTCTGG	CAKLSDSGLVVVPAAMPFYYYYYYMDVW	IGHV3-NL1	IGHJ6
TGTGCGAAAGATCTACCCACCTTAAGTCAAGGCCCTTTTGACTGGTTATTGTACTACTACTACTACTACATGGACGTCTGG	CAKDLPTLSQGPFDWLLYYYYYYMDVW	IGHV3-23	IGHJ6
TGTGCGAGACTCCCTTCGGATATTGTAGTGGTGGTAGCTGCAAAACCCAACTGGTTCGACCCCTGG	CARLPSDIVVVVAAKPNWFDPW	IGHV4-34	IGHJ5
TGTTCGGTTATGATTACGTTTGGGGGAGTTATCGTTAAGGTGAGACAGTACTTTGACTACTGG	CSVMITFGGVIVKVRQYFDYW	IGHV7-4-1	IGHJ4
TGTGCGAGATTGACCGTCCATTCAGCTGCTTTCCTTGACTACTGG	CARLTVHSAAFLDYW	IGHV4-59	IGHJ4
TGTGCGAGAGGTAAGCAGCAGGAAGACTACTGG	CARGKQQEDYW	IGHV1-69	IGHJ4
TGTGCGAGAGGGACCCCGCCGGTAGTGGTGGTAGCTGCTAACCTGCACTTTGACTACTGG	CARGTPPVVVVAANLHFDYW	IGHV1-46	IGHJ4
TGTGCGAACGAAGTATTACGATTTTTGGAGTGGTTATTATACGCCCCCCGCTACATGGACGTCTGG	CANEVLRFLEWLLYAPRYMDVW	IGHV3-23	IGHJ6
TGTGCGAGAGATCACCTAGCAGTTTTTGGAGTGGTTATTATACCTCCGGCCTACTACTACTACATGGACGTCTGG	CARDHLAVFGVVIIPPAYYYYMDVW	IGHV1-69	IGHJ6
TGTGCGAGAGATGTATGTGGATATTGTAGTAGTACCAGCTGCTATAGGTGTGCTATCTACTGG	CARDVCGYCSSTSCYRCAIYW	IGHV1-2	IGHJ4
TGTGCGAGAATCCGGACGCTGGACATTACTATGGTTCGGGGAGTTATCTCTGTGGGAAACTGGTTCGACCCCTGG	CARIRTLDITMVRGVISVGNWFDPW	IGHV7-4-1	IGHJ5
TGTGCGAGAGGAGAACTAATAACGCCGGATATTGTAGTAGTACCAGCTGCTATCCTGACTCCCGTCATCTACATGGACGTCTGG	CARGELITPDIVVVPAAILTPVIYMDVW	IGHV4-39	IGHJ6
TGTACTGAGGACTCGGAGGATATTGTAGTAGTACCAGCTGCTATGCGCCTATGTGACTACTGG	CTEDSEDIVVVPAAMRLCDYW	IGHV3-49	IGHJ4
TGTGCAAGGTGTAGTCCAGGTCTAGGATATTGTAGTGGTGGTAGCTGCTACTCTTATTCCCAGGAAGACTACTGG	CARCSPGLGYCSGGSCYSYSQEDYW	IGHV3-13	IGHJ4
TGTGCGAAAGAGGGGGGACGGGTGGGAGAAAGATTTGACCCCTACTGG	CAKEGGRVGERFDPYW	IGHV3-NL1	IGHJ4
TGTGCGAGAAGAAATTGGTTGAGCAGTGGCTGGTACCCCGGGAGTCGACGACTGTACTACTTTGACTACTGG	CARRNWLSSGWYPGSRRLYYFDYW	IGHV5-10-1	IGHJ4
TGTGCAAAAGATATTTCCAATAGCAGCAGCTGGTACGACGTTAGCCACTTTGACTACTGG	CAKDISNSSSWYDVSHFDYW	IGHV3-43D	IGHJ4
TGTGCACACAGACGAAGGGGTCGAATCGAGACTTTTGATATCTGG	CAHRRRGRIETFDIW	IGHV2-5	IGHJ3
TGTGCGAAAGATGACCGTGGCTGGAACTTTGACTACTGG	CAKDDRGWNFDYW	IGHV3-23	IGHJ4
TGTGCAAGAGATGAGATATTACGATTTTTGGAGTGGTTATGTGGACCCTACTGG	CARDEILRFLEWLCGPYW	IGHV3-13	IGHJ4
TGTGCCGTATGTTGGATGGTGGAACTAGCCTGGCCCAGGGTCTTTACTTGG	CAVCWMVELAWPRVFTW	IGHV3-30-3	IGHJ4
TGTGCGAGCCCGCCCCGGGGATGTAGTAGTACCAGCTGCGGGACTTACTACTACTACTACTACATGGACGTCTGG	CASPPRGCSSTSCGTYYYYYYMDVW	IGHV3-53	IGHJ6
TGTGCGAACATTTCTTACCTTCGCGGGAGGAGAGGACATATTGTGGTGGTGATTGCGTTCGCATACTACTACTACTACATGGACGTCTGG	CANISYLRGRRGHIVVVIAFAYYYYYMDVW	IGHV3-23	IGHJ6
TGTGCGAGAGCGCCGTATTGTAGTGGTGGTAGCTGCTCCCGACGGGGAGTTGCTTTTGATATCTGG	CARAPYCSGGSCSRRGVAFDIW	IGHV4-59	IGHJ3
TGTACCACAAGGGTATTACGATTTTTGGAGTGGTTATCAACCTGGGACTACTGG	CTTRVLRFLEWLSTWDYW	IGHV3-15	IGHJ4
TGTGCAAGAAGTGGGTATTACGATATTTTGACTGGTGGCTCCTGG	CARSGYYDILTGGSW	IGHV3-74	IGHJ4
TGTGCGAAAGATATCTTAAGGAAATATTGTAGTAGTACCAGCTGCTATATATACCAGAGGGTCACCTACTACTACTACTACATGGACGTCTGG	CAKDILRKYCSSTSCYIYQRVTYYYYYMDVW	IGHV3-23	IGHJ6
TGTGCAAGAGATGTCCCGGGGGTGACTACCTACTGGTACTTCGATCTCTGG	CARDVPGVTTYWYFDLW	IGHV3-13	IGHJ2
TGTGCGAAACGATATAACTGGAACTACGTGATTTCTGACTACTGG	CAKRYNWNYVISDYW	IGHV3-23	IGHJ4
TGTGCGAAAGCGGTACTTGACGTATTACGATTTTTGGAGTGGTTATTCTGGGGTAGGCGGTTTGACTACTGG	CAKAVLDVLRFLEWLFWGRRFDYW	IGHV3-23	IGHJ4
TGTGCAAGCACAATTACGATCCTGGACTACTGG	CASTITILDYW	IGHV1-45	IGHJ4
TGTGCACACACTCCATTGATTGTAGTAGTACCAGCTGCCGGTGGGAACTACTACTACTACATGGACGTCTGG	CAHTPLIVVVPAAGGNYYYYMDVW	IGHV2-5	IGHJ6
TGTGCGAGGGAATTCATAGCAGTGGCTGGTACCCGCCAACCCCCCTTTGACTACTGG	CAREFIAVAGTRQPPFDYW	IGHV3-11	IGHJ4
TGTGCAAGAGCAAGTCCTGCCCACGTATTACGATTTTTGGAGTGGTTATTATCTCGGGCCCAGTCGTACTACTTTGACTACTGG	CARASPAHVLRFLEWLLSRAQSYYFDYW	IGHV6-1	IGHJ4
TGTGCGAGAGGAAGGAAGACCCTCCGTAAGGAGGAGGGTATTGTAGTGGTGGTAGCTGCTACTAGTGGTGTCCAGCACTGG	CARGRKTLRKEEGIVVVVAATSGVQHW	IGHV1-2	IGHJ1
TGTGGGCCCTTAGGGTGGATTACATTTGGGGGAGTTATCGTGGAGCGTGCTAACTCTAACCGAGCTTTGGAGTATTACTACTACTACTACTACATGGACGTCTGG	CGPLGWITFGGVIVERANSNRALEYYYYYYYMDVW	IGHV3-30-3	IGHJ6
TGTGCGAGACCCGTGGAGCACCAACGATTTTTGGAGTGGTGGCACTCCCCCTTACGGGGCACCGGACCTCATCGAAATCCCTGGTTCGACCCCTGG	CARPVEHQRFLEWWHSPLRGTGPHRNPWFDPW	IGHV7-4-1	IGHJ5
TGTGCGAGAGCTGACGATATTGTAGTGGTGGTAGCTGCTGTTCTAACTTTTGACTACTGG	CARADDIVVVVAAVLTFDYW	IGHV1-3	IGHJ4
TGTGCGAGAGAATGGGGTATTACTATGATAGTAGTGGGGGCCTACAACTGGTTCGACCCCTGG	CAREWGITMIVVGAYNWFDPW	IGHV3-11	IGHJ5
TGTGCGAGACAGTTCGACACCAGCTGCTATACCAAAACCTGCGACTTTGACTACTGG	CARQFDTSCYTKTCDFDYW	IGHV5-51	IGHJ4
TGTGCAAAACCCCAGTGGGAGCTACTACGGGCGCGGGTGCGAACCCTAGACGATGCTTTTGATATCTGG	CAKPQWELLRARVRTLDDAFDIW	IGHV3-43D	IGHJ3
TGTGCGAGAGATCATAGGGTATTACGATATTTTGACTGGTTATTCCCTAAGAGCTACTACTACTACTACATGGACGTCTGG	CARDHRVLRYFDWLFPKSYYYYYMDVW	IGHV3-30	IGHJ6
TGTGCGAGATCGGGATATTGTAGTAGTACCAGCTGCTTCAAGGCCCCTGATCCTACTCACGACTACTGG	CARSGYCSSTSCFKAPDPTHDYW	IGHV7-4-1	IGHJ4
TGTGCGCCCTACGATATTTTGACTGGTTACTACTGG	CAPYDILTGYYW	IGHV3-20	IGHJ4
TGTGCGAGAGATGAACTCGAGAGTAGTACCAGCTGCTATTACTACTACTACTACTACATGGACGTCTGG	CARDELESSTSCYYYYYYYMDVW	IGHV1-46	IGHJ6
TGTACGAGGGAGAGGAAGAGGCATACCAGCTGCTGTCCGTGGCGTCACTTCAGGTTCGACCCCTGG	CTRERKRHTSCCPWRHFRFDPW	IGHV3-49	IGHJ5
TGTGCAAGAGAGTGGCTAATTATGATTACATTTGGGGGAGTTATCGTTATACCGGGGCTTGACTACTGG	CAREWLIMITFGGVIVIPGLDYW	IGHV3-13	IGHJ4
TGTGCAAGAGATACCGACTACGGTGACTACGTAGTA	CARDTDYGDYVV	IGHV6-1	IGHJ5
TGTGCGAAAGACTATAGCAGCAGCTGGGGATTTGACTACTGG	CAKDYSSSWGFDYW	IGHV3-NL1	IGHJ4
TGTGCGAGAGACCAACTTACGATTTTACCGAATTGCCTGGGACCCCTTTGGGCCGAATATTACTACTACTACTACTACATGGACGTCTGG	CARDQLTILPNCLGPLWAEYYYYYYYMDVW	IGHV3-53	IGHJ6
TGTGCGAGACCGGGTCTCACGCATATTGTGGTGGTGACTGCTAGCTTTGACTACTGG	CARPGLTHIVVVTASFDYW	IGHV3-7	IGHJ4
TGTGCGAGAGTCCGAAGCAGCTCGATTGCGAAGGTTGATGCTTTTGATATCTGG	CARVRSSSIAKVDAFDIW	IGHV4-34	IGHJ3
TGTGCGAGAGATCGGAGGCACTATTACTATGATAGTAGTGGTTATTACTACCTGAACTTTGACTACTGG	CARDRRHYYYDSSGYYYLNFDYW	IGHV1-69	IGHJ4
TGTACCACACCCTTCCTATTGTACTGGTGGTGTATGCTACGGATTGACTACTGG	CTTPFLLYWWCMLRIDYW	IGHV3-15	IGHJ4
TGTGCGAGACCAGGGCACGTATTACTATGGTTCGTTCCAGCCTACTGG	CARPGHVLLWFVPAYW	IGHV5-51	IGHJ4
TGTGCGAGAGTTACTGTTACATCTAACGGAACTACCCCGTTTCCGGTTGACTACTGG	CARVTVTSNGTTPFPVDYW	IGHV3-20	IGHJ4
TGTGCGAAACAATTCAAACTTACGGTGACTTCCCCGTCGGGTCTAATTTACTACTTTGACTACTGG	CAKQFKLTVTSPSGLIYYFDYW	IGHV3-23	IGHJ4
TGTGCGAGCCCGGATACAGCTATGGTTAAAATGTTTAATTACTACTTTGACTACTGG	CASPDTAMVKMFNYYFDYW	IGHV3-20	IGHJ4
TGTGCGAGAGATCTGGAGATGGCTACAATTGGGTCGGACTACTGG	CARDLEMATIGSDYW	IGHV3-21	IGHJ4
TGTGCGAGAGATTTGGCCGTACTGGTGGTGTATGCTTTTGACTATTACTACTACTACTACTACATGGACGTCTGG	CARDLAVLVVYAFDYYYYYYYMDVW	IGHV1-3	IGHJ6
TGTGCGAAAGATGGTCTGGCTGCCCGTGGGAGCTACTCTTCCTCAGTGTACTACTTTGACTACTGG	CAKDGLAARGSYSSSVYYFDYW	IGHV3-23	IGHJ4
TGTGCGAGGAGTGTAGTGGTGGTAGCTGCTACTTCTAGCCGTCGGTACTACTACTACTACATGGACGTCTGG	CARSVVVVAATSSRRYYYYYMDVW	IGHV1-69	IGHJ6
TGTGCGAGACTTCCCCTGGATTACGATTTTTGGAGTGGTTATCCGAACTGGTTCGACCCCTGG	CARLPLDYDFWSGYPNWFDPW	IGHV4-38-2	IGHJ5
TGTACTAGACCCCCGGGGGGCAGCAGCTGGGACTACTGG	CTRPPGGSSWDYW	IGHV3-73	IGHJ4
TGTGCAAGAGATCTGTCATGGTATTACGATTTTTGGAGTGGTTACTTTACCTACTTTGACTACTGG	CARDLSWYYDFWSGYFTYFDYW	IGHV3-74	IGHJ4
TGTGCGAAAGATACAGCCTTTCGTGGCAATTACTACTACTACTACTACATGGACGTCTGG	CAKDTAFRGNYYYYYYMDVW	IGHV3-NL1	IGHJ6
TGTGCGAGGACGGTCTCCCCTAAGCTCATACAGCTATGGTACTGG	CARTVSPKLIQLWYW	IGHV3-53	IGHJ4
TGTGCGAAAGAACAAACGGTCTATGGTTCAGGGAGTTATTCACCCTACTACTACTACTACATGGACGTCTGG	CAKEQTVYGSGSYSPYYYYYMDVW	IGHV3-NL1	IGHJ6
TGTGCACGGATACCCCATTTGATAGTAGTGGTGCCACATCGATGGGAGGTAGACCCCTTTGCGTCGGCGGGCTGG	CARIPHLIVVVPHRWEVDPFASAGW	IGHV2-26	IGHJ5
TGTGCACGGATTATTACGTATTACTATGATAGTAGTGGTTATTACCGGAAGTTCTGGTTCGACCCCTGG	CARIITYYYDSSGYYRKFWFDPW	IGHV2-26	IGHJ5
TGTGAGGTCACCGGTATAGCAGCAGCTGGCTACTGG	CEVTGIAAAGYW	IGHV3-30	IGHJ4
TGTGCACAGTATAGCAGCTCGTCCACTAATAATTTTGACTACTGG	CAQYSSSSTNNFDYW	IGHV3-30-3	IGHJ4
TGTGCGAGAGATACCCTAAGCATCAACTGGTTCGACCCCTGG	CARDTLSINWFDPW	IGHV4-59	IGHJ5
TGTGCGTTAAATGACTACGGTGACTACGTCACCGGTTTTTTTGACTACTGG	CALNDYGDYVTGFFDYW	IGHV1-3	IGHJ4
TGTGCAAAAGCGGGCTGTGGTGGTCGCCCTATATTATGCCGGCCGGACTGGATCCCGCAGTTGCCAGCCCTCACGCAAATTCATGTGTTGTGGTTCGACCCCTGG	CAKAGCGGRPILCRPDWIPQLPALTQIHVLWFDPW	IGHV3-43	IGHJ5
TGTGCGAAAGTGCGCTCGCCACAGAATGGGTATAGCAGCAGCTGGTATGATCCAAAGGGTAGGGGGGGACGGGACTGGTTCGACCCCTGG	CAKVRSPQNGYSSSWYDPKGRGGRDWFDPW	IGHV3-23	IGHJ5
