TGTGCGAGCGGCGCAGCAGCAGCTGGTGTTTCCATACCCCTTTACTGGAACTTTGACTACTGG	CASGAAAAGVSIPLYWNFDYW	IGHV4-34	IGHJ4
TGTGCGGGGTTACGTCCCATTGGATATTGTAGTGGTGGTAGCTGGGACTGGTTCGACCCCTGG	CAGLRPIGYCSGGSWDWFDPW	IGHV3-48	IGHJ5
TGTGCGAGAGGGGCTGATTACTATGGTTCAGGGGGCCTTAGGGATGGACTTTCAGATGTCCCCGCGATTGGGGGCGTAGATGTGGAAATAAACTACTACTACATGGACGTCTGG	CARGADYYGSGGLRDGLSDVPAIGGVDVEINYYYMDVW	IGHV3-21	IGHJ6
TGTGCGCTAGTACCAGCTGCTACATACTACTACTACTACATGGACGTCTGG	CALVPAATYYYYYMDVW	IGHV5-10-1	IGHJ6
TGTGCGAAAGGGTGCTATGATAGTAGTGGTTATTACTCCTGCCCAATTGACTACTGG	CAKGCYDSSGYYSCPIDYW	IGHV3-23	IGHJ4
TGTGCGAGATTCTCTGGCTACGGTGGTAACTTATGCCCCTTCTCTGGACATGCTTTTGATATCTGG	CARFSGYGGNLCPFSGHAFDIW	IGHV3-7	IGHJ3
TGTGCGAAAGTTCGTATAGCAGCAGCTGGTAATTGCTCTTACTACTACTACTACTACATGGACGTCTGG	CAKVRIAAAGNCSYYYYYYMDVW	IGHV3-NL1	IGHJ6
TGTGCGAGACGACTGGGGATTGTAGTGGTGGTAGCTGCCCCTTGTGAATACTTCCAGCACTGG	CARRLGIVVVVAAPCEYFQHW	IGHV5-51	IGHJ1
TGTGCGAAAGTCCGGACTATGATAGTAGTGGTCCGAAGGTTCGACCCCTGG	CAKVRTMIVVVRRFDPW	IGHV3-23	IGHJ5
TGTACGGAGCCTTTGGTGGTAGCTGCTACACCAATTGACTACTGG	CTEPLVVAATPIDYW	IGHV3-15	IGHJ4
TGTGCGAGATCGATATTTTTGTACGATAGTAGTGGTTATTACTCCCTGCGAGCGGACCACTATGACTACTGG	CARSIFLYDSSGYYSLRADHYDYW	IGHV3-23	IGHJ4
TGTGCGAGAGGGGCCCTAGGCCAGGGAGTTATTAGGGGGGACAACTGGTTCGACCCCTGG	CARGALGQGVIRGDNWFDPW	IGHV1-46	IGHJ5
TGTGCGAAACGGTTTATAGCAGTGGCTGGGTACTACTACTACTACATGGACGTCTGG	CAKRFIAVAGYYYYYMDVW	IGHV3-NL1	IGHJ6
TGTGCGGGCATGTACCAGCTGCTACACTCGACGGCGCTCGCGTCACGTCCTGTCTACTACTACTACTACATGGACGTCTGG	CAGMYQLLHSTALASRPVYYYYYMDVW	IGHV1-18	IGHJ6
TGTGCGAGAGCGAGGGAGGTCATAGCAGCAGGCCCCTACCGTGGTCACTGG	CARAREVIAAGPYRGHW	IGHV3-64	IGHJ4
TGTGCGAGAGATTTCCGGACTGGAGTTTACGGATCGAATATTGTAGTAGTACCAGCTGCTATGTCCAGTGGGAACTACTGG	CARDFRTGVYGSNIVVVPAAMSSGNYW	IGHV1-46	IGHJ4
TGTGGAAGTATAGCAGTGGCTGGTAGGGGTATTGACTACTGG	CGSIAVAGRGIDYW	IGHV3-13	IGHJ4
TGTGCGAGACATATTGTAGTGGTGGTAGCTGCTACCCGCGGGGATGACTACTGG	CARHIVVVVAATRGDDYW	IGHV4-4	IGHJ4
TGTGCGAGATTGTCATTTACGGATATTGTACTGGTGGTGTATGCTAACCACTACAAGTTTTTCTGGTTCGACCCCTGG	CARLSFTDIVLVVYANHYKFFWFDPW	IGHV4-38-2	IGHJ5
TGTGCGAGAGATGTTACGGTTTACGGTGACCGACTATACTGG	CARDVTVYGDRLYW	IGHV1-2	IGHJ4
TGTGCGAGAGGGTTAACCAACGTCTTGGGAAAGCGGCAGCAGCTGGTACAGCGGTCCGGGCCTTTTGACTACTGG	CARGLTNVLGKRQQLVQRSGPFDYW	IGHV3-64	IGHJ4
TGTGCGAGAGATATGGCTCAGTGGCTGATACCCGGCCCTCTTTACTACTTTGACTACTGG	CARDMAQWLIPGPLYYFDYW	IGHV3-20	IGHJ4
TGTGCGAGACCGGACGTGGATATAGTGGCTACGCCTTGGGCTTTTGATATCTGG	CARPDVDIVATPWAFDIW	IGHV1-69	IGHJ3
TGTGCGAGAGCCGTCCCACGCTCCGTTTGGCTCCATTATGATTACATTTGGGGGAACTTTGGGGCCGAATACTTCCAGCACTGG	CARAVPRSVWLHYDYIWGNFGAEYFQHW	IGHV3-11	IGHJ1
TGTGCGAAAGAACGGGGACGGTCTGTGCGACCGGCCCTCCAGTCCTACTTTGACTACTGG	CAKERGRSVRPALQSYFDYW	IGHV3-NL1	IGHJ4
TGTGCGAGACATTTGAGTGGTTATTATGGGCAGCACTGG	CARHLSGYYGQHW	IGHV7-4-1	IGHJ1
TGTGCAAGAGGACACACCTGGGGGTGGTTCGACCCCTGG	CARGHTWGWFDPW	IGHV3-74	IGHJ5
TGTGCGAGACCCAAGCCATTGTACTGGTGGTGTATGCTATCCTCCCTTAGGTTCGACCCCTGG	CARPKPLYWWCMLSSLRFDPW	IGHV7-4-1	IGHJ5
TGTGCGAGACAAGTAGGATATTGTACTGGTGGTGTATGCTATTTGCTCCGCGGGCATGACTACTGG	CARQVGYCTGGVCYLLRGHDYW	IGHV4-38-2	IGHJ4
TGTGCGAGATTGAAAAAGGCTACCAGGACTCGTACGCGTTGTACTGGTGGTGTATGCTATAAGATGCTGGACTACTACTACATGGACGTCTGG	CARLKKATRTRTRCTGGVCYKMLDYYYMDVW	IGHV3-53	IGHJ6
TGTGCACTTGGCTACGGTGACTACGTCAAATACTGG	CALGYGDYVKYW	IGHV3-23	IGHJ4
TGTGTTGAGGGGGCCGTAGTGGGAGCTACTACCCCACGCGTAGACAACAACTGGTTCGACCCCTGG	CVEGAVVGATTPRVDNNWFDPW	IGHV4-38-2	IGHJ5
TGTGCGAAAGGGAGCGGTGGTAACTCCGCGAAAAGACTTGACTACTGG	CAKGSGGNSAKRLDYW	IGHV3-NL1	IGHJ4
TGTGCAAGTTGCCTGGATATTGTAGTAGTACCAGCTGCTTACTACTTTGACTACTGG	CASCLDIVVVPAAYYFDYW	IGHV3-13	IGHJ4
TGTGCGAGAGATTATTGCTTTAGGCACTTCTTTCCTAAGTTTGACTACTGG	CARDYCFRHFFPKFDYW	IGHV3-11	IGHJ4
TGTGCGAGAGATAGCATTACTATGGTTCAGGGAGTTATTATACGGGGTCTCCGTCTCGGGGACTACTGG	CARDSITMVQGVIIRGLRLGDYW	IGHV1-2	IGHJ4
TGTGCGAGACGGGATTGGCTTTGGGGTCCTATTACTATGGTTCAGGGAGTTTCCTACTACTACTACTACATGGACGTCTGG	CARRDWLWGPITMVQGVSYYYYYMDVW	IGHV7-4-1	IGHJ6
TGTGCGAGTGAATATTGTAGTAGTACCAGCTGCTTGCGGGAACACACCTTTGACTACTGG	CASEYCSSTSCLREHTFDYW	IGHV3-30	IGHJ4
TGTGCGAGACCGGATATTGTAGTGGTGGTAGCTGCTACTAGGTTGGACTGGTTCGACCCCTGG	CARPDIVVVVAATRLDWFDPW	IGHV4-34	IGHJ5
TGTGCGAAAGATCTAACTATGATAGTAGTGGTGACATGCGACTACTGG	CAKDLTMIVVVTCDYW	IGHV3-NL1	IGHJ4
TGTGCGAAAGAACCAAAATCATTACGATTTTTGGAGTGGTTATTATTGTCACCTGGAGGGGGGAGCTGGTACTTCGATCTCTGG	CAKEPKSLRFLEWLLLSPGGGSWYFDLW	IGHV3-23	IGHJ2
TGTGCGAGAGCTGGGAGTCCCGGACCTGCTATGATAGTAGTGGTTATGGTCTGGTTGGATGACTACTGG	CARAGSPGPAMIVVVMVWLDDYW	IGHV1-46	IGHJ4
TGTGCACGGATTTGTTACTACTACTACTACATGGACGTCTGG	CARICYYYYYMDVW	IGHV2-26	IGHJ6
TGTGCGAAAGTGATTTTTGGAGTGGTTATTACCCACCGAAAACCTTTCTACTGG	CAKVIFGVVITHRKPFYW	IGHV3-23	IGHJ4
TGTGCGAGAGACCGTCATTGTAGTGGTGGTAGCTGCTACCCCCGCCCCACTTATTTTGGGCGGGACTACTGG	CARDRHCSGGSCYPRPTYFGRDYW	IGHV1-69	IGHJ4
TGTGCGAGCCCCCGTATAGCAGTGGCTGGTACTGAGTACTACTTTGACTACTGG	CASPRIAVAGTEYYFDYW	IGHV4-34	IGHJ4
TGTGCCGGAGTATTACGATATCGCTCTTTGGATGATGCTTTTGATATCTGG	CAGVLRYRSLDDAFDIW	IGHV1-8	IGHJ3
TGTGCGAAAGGGGGTAAAGGTCCTCCTAGTTTGGGGGAGTTATCGCTGCTTGACTACTGG	CAKGGKGPPSLGELSLLDYW	IGHV3-23	IGHJ4
TGTGCGAGAGAGGAAAATATTGTAGTGGTGGTAGCTGCTACTCATCTCTGG	CAREENIVVVVAATHLW	IGHV1-18	IGHJ5
TGTGCGAGACATCGGACTGCCCCCCAAGCAGCAGATAACCTCTCCCAGTACTTCGATCTCTGG	CARHRTAPQAADNLSQYFDLW	IGHV5-51	IGHJ2
TGTGCGAGAGGGTCTTGTGGATGTGACTACTGG	CARGSCGCDYW	IGHV1-2	IGHJ4
TGTTGGAGATATGTTTTGCGAAGCTACGATGACGACTACTACTACTACTACATGGACGTCTGG	CWRYVLRSYDDDYYYYYMDVW	IGHV1-2	IGHJ6
TGTGCGAGAGAGCACCCAACCCGGTGTAGTGGTGGTAGCTGCTACTCCCGCCCCCGTTTTTCGTCCCCGAACTACTACTACTACTACATGGACGTCTGG	CAREHPTRCSGGSCYSRPRFSSPNYYYYYMDVW	IGHV1-69	IGHJ6
TGTGCGAAAATACTAATAGCCGGGAAAATAGCAGCAGCTGGTACCGCCTGGTTCGACCCCTGG	CAKILIAGKIAAAGTAWFDPW	IGHV3-23	IGHJ5
TGTGCGAGAGTCAGGGACCAGGGTCTGGGGGAGCTACAGTTTGACTACTGG	CARVRDQGLGELQFDYW	IGHV3-7	IGHJ4
TGTGCGAGACTCGTAGTGGTGGTAGCTGCTACTCCGGGCCCTCCTTTCGACCCCTGG	CARLVVVVAATPGPPFDPW	IGHV1-46	IGHJ5
TGTGCGAGACCCCAGCTACGGAAGTTTTCCTTAACTATATGTTGGCCGGAACCTTTCTACTACTACTACTACATGGACGTCTGG	CARPQLRKFSLTICWPEPFYYYYYMDVW	IGHV1-46	IGHJ6
TGTGCACGGGTAGATTACGATTTTTGGAGTGGTTATTATACTTGCGGTTGGTACTTCGATCTCTGG	CARVDYDFWSGYYTCGWYFDLW	IGHV2-70	IGHJ2
TGTGCGAGAGTGGGCTTCGGCTACGATGCCCTTCACCAGCAACTTCTTGACTACTGG	CARVGFGYDALHQQLLDYW	IGHV3-20	IGHJ4
TGTGCGAAAATGGTGAGGACCGCTACGGTGACGAATCGGCTGTTTGACTACTGG	CAKMVRTATVTNRLFDYW	IGHV3-23	IGHJ4
TGTGCGAGAGGGAAGCAGATAGTGGTGGTAGCTGCTAGGTACTTCGATCTCTGG	CARGKQIVVVAARYFDLW	IGHV1-2	IGHJ2
TGTGCGAGAACATTTTGGAGTGGTTATTACTGGGGAACTCCTCCCTGGTTCGACCCCTGG	CARTFWSGYYWGTPPWFDPW	IGHV1-46	IGHJ5
TGTGCGAAAGCCAATATGGTTCGGGGAGTTATGGTCTACTACTACTACATGGACGTCTGG	CAKANMVRGVMVYYYYMDVW	IGHV3-NL1	IGHJ6
TGTGCGAAAGATGGTCCATATTGTAGTAGTACCAGCTGCTATAACATCAACTGGTTCGACCCCTGG	CAKDGPYCSSTSCYNINWFDPW	IGHV3-23	IGHJ5
TGTGCGAGGTTTCGTCCTTTCGGATTAGGAATGAGAGCATATTGTGGTGGTGACTGCTATTCTGCTATGACCGAACCTGGAGAATACTTCCAGCACTGG	CARFRPFGLGMRAYCGGDCYSAMTEPGEYFQHW	IGHV1-3	IGHJ1
TGTGCGAGAGATTTTGGAGTGGTTAGGGGCTATGATGCTTTTGATATCTGG	CARDFGVVRGYDAFDIW	IGHV3-11	IGHJ3
TGTGCGAGATGGTCTGAACATTTGGGGGAGTTATCGTTCTGGCTTCTTGACTACTGG	CARWSEHLGELSFWLLDYW	IGHV1-2	IGHJ4
TGTGCGAAAGGCGGCGTGGCCCATGCTTCAGTAGTGGTGGTAGCTGCTATCCGTCTGCAGTGGTTCGACCCCTGG	CAKGGVAHASVVVVAAIRLQWFDPW	IGHV3-NL1	IGHJ5
TGTGCGAGAGGTCGTATTACGATTTTTGGAGTGGTTATTATAGTTTACTACATGGACGTCTGG	CARGRITIFGVVIIVYYMDVW	IGHV5-10-1	IGHJ6
TGTGCGAAGGTCGGTGTTGGGATACAGCTATGGTTCTGTGGCTTTGACTACTGG	CAKVGVGIQLWFCGFDYW	IGHV3-NL1	IGHJ4
TGTGCACGAGGAGGATACACTATGATAGTAGTGGCATCGGTACATAACTGGTTCGACCCCTGG	CARGGYTMIVVASVHNWFDPW	IGHV3-53	IGHJ5
TGTGCGAGAGAGAGATGGTTATTACTACTCGTGGTTCTCTACTTTGACTACTGG	CARERWLLLLVVLYFDYW	IGHV1-2	IGHJ4
TGTGCGAGAGGCACCACACCAGTAGTGGTGGTAGCTGCTACTTATCCTATCCCGTTGGGTTACAACTGGTTCGACCCCTGG	CARGTTPVVVVAATYPIPLGYNWFDPW	IGHV1-46	IGHJ5
TGTGCGAGAGGGACTACGGTGACGCAAAACTGGTTCGACCCCTGG	CARGTTVTQNWFDPW	IGHV4-4	IGHJ5
TGTGCGAGTTGGGTTCCCGGGAGTGGTGGTAGCTGCTACGATAAAGGATCAGGGTTTGACTACTGG	CASWVPGSGGSCYDKGSGFDYW	IGHV3-11	IGHJ4
TGTGCGAAAGCGCAAGCCCGCTACGGTGACTACGGGGCCGGTACCAGAAGAAGGCACCTCTATACTTATACTTGCTACTACTACTACTACATGGACGTCTGG	CAKAQARYGDYGAGTRRRHLYTYTCYYYYYMDVW	IGHV3-23	IGHJ6
TGTGCGAGAGAAAGACGTAGTACCAGCTGCTATCCCTTTGACTACTGG	CARERRSTSCYPFDYW	IGHV1-69	IGHJ4
TGTGCGAGAGACCCGTCGATTCGGGGAGTTATTATAACAGGGACATTGGAAAGTGGAAGGAAATTTGACTACTGG	CARDPSIRGVIITGTLESGRKFDYW	IGHV1-3	IGHJ4
TGTGCGAAAGTAGCCCCGCCAGGATATTGTAGTAGTACCAGCTGCTATGACTACTACTACATGGACGTCTGG	CAKVAPPGYCSSTSCYDYYYMDVW	IGHV3-23	IGHJ6
TGTGCGAGAGCCCCTAGTGGGAACTGGTTCGACCCCTGG	CARAPSGNWFDPW	IGHV3-20	IGHJ5
TGTGCACTCCTATACGCTTTACCAGCTGCTATAGGACGCTTTCTTACGCTGTGGAACTGGTTCGACCCCTGG	CALLYALPAAIGRFLTLWNWFDPW	IGHV4-61	IGHJ5
TGTGCAAGACTAGGATATTGTAGTGGTGGTAGCTGCTACTCATACTTTGACTACTGG	CARLGYCSGGSCYSYFDYW	IGHV1-45	IGHJ4
TGTGCGAGAGGTGTGGATATTGTAGTGGTGGTAGCTGCTACTTCAACCTACTACTACTACTACATGGACGTCTGG	CARGVDIVVVVAATSTYYYYYMDVW	IGHV3-30	IGHJ6
TGTGCGAGAGATCGACTGGGGGCCCCCCGAGGGAGTCAAGACTGGTTCGACCCCTGG	CARDRLGAPRGSQDWFDPW	IGHV3-7	IGHJ5
TGTGCAAGAGGTCCTCCGCCCCCGGTCGACTACTGG	CARGPPPPVDYW	IGHV3-74	IGHJ4
TGTACCACCTTTACGGAACCCCGCGACAATGGTTGTAGTGGTGGTAGCTGCTACTCTGACTACTGG	CTTFTEPRDNGCSGGSCYSDYW	IGHV3-15	IGHJ4
TGTGCGAGAGATTATCCCTGTAGTGGTGGTAGCTGCTATCAGTCTTACTACTTTGACTACTGG	CARDYPCSGGSCYQSYYFDYW	IGHV3-7	IGHJ4
TGTGCGAAATATCAAGATTACGTTAAGGATACAGCTATGGTTACACTCGGTCCGTGTTCCCGGGGGTTCTACTGG	CAKYQDYVKDTAMVTLGPCSRGFYW	IGHV3-23	IGHJ4
TGTGCGAGAGTACTCATCACCCTGTGTAGTAGTACCAGCTGCGCGACCCCCGTTGATTACTACTACTACTACTACATGGACGTCTGG	CARVLITLCSSTSCATPVDYYYYYYMDVW	IGHV3-30	IGHJ6
TGTGCGAGAGGTGGCCCATATTGTAGTGGTGGTAGCTGCTACTCGGGCCGGGGTACCTTTGACTACTGG	CARGGPYCSGGSCYSGRGTFDYW	IGHV4-34	IGHJ4
TGTGCGAGCAATCATTTCGAATTTTGGAGTGGTTATTATATTGACTACTACTACTACTACATGGACGTCTGG	CASNHFEFWSGYYIDYYYYYMDVW	IGHV1-46	IGHJ6
TGTACTAGAGATCGCGTATACCGGCTGACTACAGTAACTACGGATCGACTGGAAGTGGATGCTTTTGATATCTGG	CTRDRVYRLTTVTTDRLEVDAFDIW	IGHV3-49	IGHJ3
TGTGCGAGGGGTCCACGATACTATGGTTCAGGGAGTTATTATAACGCCGCCCCCGCTGTCTACTACTACTACATGGACGTCTGG	CARGPRYYGSGSYYNAAPAVYYYYMDVW	IGHV4-59	IGHJ6
TGTGCGAGAGGTGGTAAGCAGCAGCTGGCCGACTGTCGGGACTACTGG	CARGGKQQLADCRDYW	IGHV4-34	IGHJ4
TGTGCGAAAGAAGGGGGTCCACGTATTACTATGATAGTAGTGGTTAGCCAGGGGCAGGACTACTGG	CAKEGGPRITMIVVVSQGQDYW	IGHV3-23	IGHJ4
TGTGCGAGAGTCTCAGTGGCTGGTGGTGACTGG	CARVSVAGGDW	IGHV4-61	IGHJ4
TGTGCGAGAAATTTCTTATTTCCTCCGGGTATAGCAGTGGCTGGTACGTACTACTTTGACTACTGG	CARNFLFPPGIAVAGTYYFDYW	IGHV4-28	IGHJ4
TGTGCGAAAGTTATACGGTGTATAGGTGCTTATTGTAGTGGTGGTAGCTGCGGGTTTGACTACTGG	CAKVIRCIGAYCSGGSCGFDYW	IGHV3-23	IGHJ4
TGTGCGAGAGGAGACTACGGTGACTACGTCCGTCCTCAATACTACTACTACTACATGGACGTCTGG	CARGDYGDYVRPQYYYYYMDVW	IGHV3-30	IGHJ6
TGTGCACGGAGGTTTTACGTATTACGATTTTTGGAGTGGTTGGTTGCCCTTGTTGACTACTGG	CARRFYVLRFLEWLVALVDYW	IGHV2-70	IGHJ4
