TGTGCACACAGCGAAGGATATTGTAGTGGTGGTAGCTGCTACGAGTACTACTACTACATGGACGTCTGG	CAHSEGYCSGGSCYEYYYYMDVW	IGHV2-5	IGHJ6
TGTGCGAAAGATCTGGGTCAGCCTACGATTTTTGGAGTGGTTATTATAAAATTTGACTACTGG	CAKDLGQPTIFGVVIIKFDYW	IGHV3-NL1	IGHJ4
TGTACCACACCTGGCGGATATTGTAGTAGTACCAGCTGCGGTGACTACTGG	CTTPGGYCSSTSCGDYW	IGHV3-15	IGHJ4
TGTGCGAGAGATCCATACCCAGCTTTACGATTTTTGGAGAACTACTGG	CARDPYPALRFLENYW	IGHV3-20	IGHJ4
TGTGCGAGAGTCCCACGGGATATTGTAGTGGTGGTAGCTGGAACCCCGGTCTACTACTACTACATGGACGTCTGG	CARVPRDIVVVVAGTPVYYYYMDVW	IGHV4-61	IGHJ6
TGTGCAAGAGATGACCCTAGGTATAGCAGCAGCTGCCGAGCCCCTTACCGGGTGAGTTACTACTTTGACTACTGG	CARDDPRYSSSCRAPYRVSYYFDYW	IGHV3-13	IGHJ4
TGTGCGAGAGGGCGGTATTACGATATTTTGACTAACTGGTTCGACCCCTGG	CARGRYYDILTNWFDPW	IGHV4-34	IGHJ5
TGTGCGAGATGGGGTGATCGGCTTATTGTACTAATGGTGTATGCTATAGCATTTATGTGGTTCGACCCCTGG	CARWGDRLIVLMVYAIAFMWFDPW	IGHV1-69	IGHJ5
TGTGCGAGACTGGTACGCAGTGGCTGGATTGACTACTGG	CARLVRSGWIDYW	IGHV4-38-2	IGHJ4
TGTGCGAGACGTGGATATTGTAGTGGTGGTAGCTGCTATCCCTTTGACTACTGG	CARRGYCSGGSCYPFDYW	IGHV4-39	IGHJ4
TGTGCGATGAACCCCCTTCCAAATAATATTGTACTGGTGGTGTATGCTATTTCGATTTCTCCCTACTACTACTACTACTACATGGACGTCTGG	CAMNPLPNNIVLVVYAISISPYYYYYYMDVW	IGHV7-4-1	IGHJ6
TGTGCGAGAGATCAAGGTATTGTAGTGGTGGTAGCTGCTACCGGGGGGGAGTACTGG	CARDQGIVVVVAATGGEYW	IGHV1-46	IGHJ4
TGTGCGAAAGGAGTAGGACCCCGTACTATGGTTCAGGGAGTTATTGTCCCTTCGGATAGTTACTACTTTGACTACTGG	CAKGVGPRTMVQGVIVPSDSYYFDYW	IGHV3-NL1	IGHJ4
TGTGCGAAAGATTGCCGTAGCGATATTGTAGTAGTACCAGCTGCTGGATGGCTACACTGGATCTGG	CAKDCRSDIVVVPAAGWLHWIW	IGHV3-NL1	IGHJ3
TGTGCGAATCTCAATTACGATATTTTGACTACCTACTCGTTGGTCATTGGGGTCGCTGACTACTGG	CANLNYDILTTYSLVIGVADYW	IGHV3-NL1	IGHJ4
TGTGCGAGACGGTCAAGTCGGGGTATAGGAACTACGGTGGTAACTCCGAGCAGTTGGGACAAATACTGGTACTTCGATCTCTGG	CARRSSRGIGTTVVTPSSWDKYWYFDLW	IGHV5-51	IGHJ2
TGTGCGACCTGCAAGGCTGACGTAGTGGGAGCTACGAGAGTGGCGTACTACTACTACTACTACATGGACGTCTGG	CATCKADVVGATRVAYYYYYYMDVW	IGHV4-39	IGHJ6
TGTGCGAGACACCTCTTCGGATATTTTGACTGGTTATTATATGATACGCCTTTGCTCTGGGCGTACTACTTTGACTACTGG	CARHLFGYFDWLLYDTPLLWAYYFDYW	IGHV1-46	IGHJ4
TGTGGTCATATGAAGAACGAGGACTACGGTGGTAACTCCGATAGTCGGTCTCTATTTGACTACTGG	CGHMKNEDYGGNSDSRSLFDYW	IGHV3-30-3	IGHJ4
TGTACTAGAGATGGAAAATGTGGTAGGAATCGTAGGGACTACTGG	CTRDGKCGRNRRDYW	IGHV3-49	IGHJ4
TGTGCAAGAGATATACGTGTGGCTAGCAGCAGCTGGTACGTGGGGTACTACTTTGACTACTGG	CARDIRVASSSWYVGYYFDYW	IGHV3-13	IGHJ4
TGTGACGTACGATTTTTGGAGTGGTTATTATCGGAAGAGCCCTTTGAAGGCTACTACATGGACGTCTGG	CDVRFLEWLLSEEPFEGYYMDVW	IGHV4-38-2	IGHJ6
TGTGCGAGATGGATTGTACTGGTGGTGTATGCTATACGCCGCTACTACTACTACTACATGGACGTCTGG	CARWIVLVVYAIRRYYYYYMDVW	IGHV3-7	IGHJ6
TGTGCAAAAGAATTAGGGACCAGTAACTACGTTGAGTACTACTACTACTACTACATGGACGTCTGG	CAKELGTSNYVEYYYYYYMDVW	IGHV3-43	IGHJ6
TGTGCGAGAGGAGACAATAGAAAGGGGGAATGGTTGAGATCCCGTATCTGG	CARGDNRKGEWLRSRIW	IGHV4-4	IGHJ4
TGTGCACGGAGACCTTGGTCCACCGGTGTCGAGGGGATAGGGTACTACTACTACTACTACATGGACGTCTGG	CARRPWSTGVEGIGYYYYYYMDVW	IGHV2-26	IGHJ6
TGTGCGAGAGGCCGCCTTCTCAGAACCATCTATGCCCGAGACTTTTTTACTATGATAGTAGTGGTTATTACTTCCGTACGTCCCTTTGACTACTGG	CARGRLLRTIYARDFFTMIVVVITSVRPFDYW	IGHV4-34	IGHJ4
TGTGCGAGACATGGCAGGAACCACGATATTTTGACTGGTTATTATGGGGTGGATTGGAACTGGTTCGACCCCTGG	CARHGRNHDILTGYYGVDWNWFDPW	IGHV5-51	IGHJ5
TGTGCGAGATTTAGGATAGGTGTAGTAGTACCAGCTGCTATCCGGGGGTGGACGTGCACCCTGGGTGGGACTGACTACTGG	CARFRIGVVVPAAIRGWTCTLGGTDYW	IGHV4-34	IGHJ4
TGTACCACAGATCAGGAAATAGATCTTATTGTAGTGGTGGTAGCTGCTACCCTCCGCATTGACTACTGG	CTTDQEIDLIVVVVAATLRIDYW	IGHV3-15	IGHJ4
TGTGCGAGACAACCTAGTGGTGGTAGCTGCTACGTAATCTACTTTGACTACTGG	CARQPSGGSCYVIYFDYW	IGHV5-51	IGHJ4
TGTGCGAGACATTCGAGTCGGAATAGCAGCAGCTCGTACTTCGATCTCTGG	CARHSSRNSSSSYFDLW	IGHV5-51	IGHJ2
TGTGCGAGAGATGGAAGATATAGTGGCTACGATTCGTTCTTTGGAGGCATGGACTACTGG	CARDGRYSGYDSFFGGMDYW	IGHV3-7	IGHJ4
TGTGCGAGAAGGTGTAGTAGTACCAGCTGCTATAGCCGCGGTCGGATCCCTGTCTTTGACTACTGG	CARRCSSTSCYSRGRIPVFDYW	IGHV7-4-1	IGHJ4
TGTGCACGGATACCAGCTGTAGTAGTAAATTTGTACTACTACTACTACTACATGGACGTCTGG	CARIPAVVVNLYYYYYYMDVW	IGHV2-26	IGHJ6
TGTGCGAAAGATCGGGAAGGAGTGGTTCCTAACTGGTTCGACCCCTGG	CAKDREGVVPNWFDPW	IGHV3-NL1	IGHJ5
TGTGCGAGACTGGTGGTGTATGCTGTGGTGTCGACTGGCATTTCGGGGGAAGACTACTACATGGACGTCTGG	CARLVVYAVVSTGISGEDYYMDVW	IGHV5-51	IGHJ6
TGTGCGCACCAATACTCTATCCAGGGTGGGGCTATTGTAGTAGTACCAGCTGCTACCCGTGCTTTTGATATCTGG	CAHQYSIQGGAIVVVPAATRAFDIW	IGHV1-46	IGHJ3
TGTGCGAGAGGCACGGTTACCCCGGTGGTAGCTGCTAACAAGGGTGACGGTTACTGG	CARGTVTPVVAANKGDGYW	IGHV1-3	IGHJ5
TGTGCACACCCGATTTTTGGAGTGGTTATTATCCCCCGATGGGAGGTGCGCTTTGACTACTGG	CAHPIFGVVIIPRWEVRFDYW	IGHV2-5	IGHJ4
TGTACTAGAGTTTGTACCAGCTGCTATTACCCGCCGAGTGACTACTGG	CTRVCTSCYYPPSDYW	IGHV3-49	IGHJ4
TGTACCAGGGGCAGCTGGTCGGGGGGTTGTGGGAGCTACTACTCCAATGGAAGGTACTACTTTGACTACTGG	CTRGSWSGGCGSYYSNGRYYFDYW	IGHV3-15	IGHJ4
TGTGCGAAAGATCCGGGGAACCTGAGGTACCATCGTCCGATCCCGACTACGGTGACCTACTACTACTACTACTACATGGACGTCTGG	CAKDPGNLRYHRPIPTTVTYYYYYYMDVW	IGHV3-NL1	IGHJ6
TGTGCGAAAGCTAGGCGTCGGGTTGTGGTGGCCCCTTTACGGGGCCCCAACCTCATAAACTACTTTGACTACTGG	CAKARRRVVVAPLRGPNLINYFDYW	IGHV3-NL1	IGHJ4
TGTGCGAGACGTATTACTATGATAGTAGTGGTTATCGAAAGAATTCCAAACTACTGG	CARRITMIVVVIERIPNYW	IGHV4-39	IGHJ4
TGTGAACACCAGGAACAGCAGCTGGTAGGGGACTACTGG	CEHQEQQLVGDYW	IGHV5-10-1	IGHJ4
TGTGCGAAAGATCTGGGGAACTGGAACTACCAAGGTTTTGACTACTGG	CAKDLGNWNYQGFDYW	IGHV3-NL1	IGHJ4
TGTGCGAGAGATAAAGATGCCCGGTGTAGGTATAGTGGGAGCTACTACAAGTACTACTTTGACTACTGG	CARDKDARCRYSGSYYKYYFDYW	IGHV1-2	IGHJ4
TGTGCGAGACGAAGATCCTGGTATAGCAGCTCGCTTGACTACTGG	CARRRSWYSSSLDYW	IGHV1-3	IGHJ4
TGTGCGAGTAGGCGTATTACGATTTTTGGAGTGGTTATTATGGCCATCGCGGTTAACTACTACTACTACTACATGGACGTCTGG	CASRRITIFGVVIMAIAVNYYYYYMDVW	IGHV3-21	IGHJ6
TGTGCGAGAGACCATACTATGATAGTAGTGGTTATTCCCGGGCCTGACTACTGG	CARDHTMIVVVIPGPDYW	IGHV4-59	IGHJ4
TGTGCGAGACTTGGGAAAAACGGATATTGTAGTGGTGGTAGCTGCTACGGTAAACTTACCTACTACTACTACTACATGGACGTCTGG	CARLGKNGYCSGGSCYGKLTYYYYYMDVW	IGHV1-2	IGHJ6
TGTGCAAAAGATACGCTGGCCACACAACACTACGATTTTTGGAGTGGTTGTCGTTTTTACTACTACTACATGGACGTCTGG	CAKDTLATQHYDFWSGCRFYYYYMDVW	IGHV3-43	IGHJ6
TGTGCGAGAGAAATCTATTGTAGTAGTACCAGCTGCTATAGTAACGCCTACTGGGAGTACTACTACTACTACTACATGGACGTCTGG	CAREIYCSSTSCYSNAYWEYYYYYYMDVW	IGHV5-10-1	IGHJ6
TGTGCAAGAGTGTCCGCCCTCTTAGCAGCTCAGACTTACGGGTACTACTTTGACTACTGG	CARVSALLAAQTYGYYFDYW	IGHV6-1	IGHJ4
TGTGCGAAAGATCGATATAGCAGCAGCTGGGACTACTGG	CAKDRYSSSWDYW	IGHV3-NL1	IGHJ4
TGTGCGAAAGTCTTCTCGGTTCGGGTCCGCTGGTTCGACCCCTGG	CAKVFSVRVRWFDPW	IGHV3-23	IGHJ5
TGTGCGAGAGATGGAACGAGAACGATGACTACGGTGACTAAAAACCCCTACTGG	CARDGTRTMTTVTKNPYW	IGHV3-66	IGHJ4
TGTGCGAGAGTTCCCCAATGGGTAGTGGGAGCTACTACCCAGTTTGTTCGAACCTTTGACTACTGG	CARVPQWVVGATTQFVRTFDYW	IGHV4-34	IGHJ4
TGTGCGAGAGGGGAGCTAAATTTAAACTGGTTCGACCCCTGG	CARGELNLNWFDPW	IGHV1-2	IGHJ5
TGTACTAGAGCGTGGCTAGATTACTATGGTTCGGGGAGTTATTATAACGGAACCAGAATTATTGACTACTGG	CTRAWLDYYGSGSYYNGTRIIDYW	IGHV3-49	IGHJ4
TGTGCGAAAGATACGCGGTGGCTGGTAGGGGAGCCTATGGCGTCCGACTACTGG	CAKDTRWLVGEPMASDYW	IGHV3-NL1	IGHJ4
TGTGCGAGAGATGGATCTGACCTGACCCGACCGAGGGTCTACTGG	CARDGSDLTRPRVYW	IGHV1-3	IGHJ4
TGTGCGAGAGCCACAGGGCCATTGGATATTGTAGTACTTTGGAACTGTCCCGACTACTGG	CARATGPLDIVVLWNCPDYW	IGHV3-11	IGHJ4
TGTACCAGGTCCAGTGGTGGTAGCTGTGACAACTGGTTCGACCCCTGG	CTRSSGGSCDNWFDPW	IGHV3-15	IGHJ5
TGTGCGAAAGGCGGGTTTCGAGGTAGTGGTGGTAGCTGCTACTCCGTGCAGGGGTTTGACTACTGG	CAKGGFRGSGGSCYSVQGFDYW	IGHV3-23	IGHJ4
TGTGCAAGAGCGAATATTGTAGTAGTACCAGCTGCTATGGTGAAGTTTATGTTATCGTACTACTACTACTACATGGACGTCTGG	CARANIVVVPAAMVKFMLSYYYYYMDVW	IGHV3-13	IGHJ6
TGTGCGAGAGACCCTGGAGTCTTCCCGAAGTACTACTTTGACTACTGG	CARDPGVFPKYYFDYW	IGHV1-2	IGHJ4
TGTGCACTTCGTATAGCAGCAGCTGGAGGGGAAGGTTTCTTTGACTACTGG	CALRIAAAGGEGFFDYW	IGHV2-5	IGHJ4
TGTGCACGGATATCAATTGTAGTGGTGGTAGCTGCTACTCTGCCCCTACGGGTCTACTACTACTACTACATGGACGTCTGG	CARISIVVVVAATLPLRVYYYYYMDVW	IGHV2-70	IGHJ6
TGTGCGAGTCCATCCCCCATGAGCTATGATAGTAGTGGTGCGGCTCGGGACACGTTATACTACTTTGACTACTGG	CASPSPMSYDSSGAARDTLYYFDYW	IGHV4-59	IGHJ4
TGTGCGAGAGAACCTACGGTGGTAGCTGCTACTCGCGGAAACTTTGACTACTGG	CAREPTVVAATRGNFDYW	IGHV1-3	IGHJ4
TGTGCGAGCAGGAGGGTGGCGATTCCGGGGGTCCTAGGATATTGTAGTAGTACCAGCTGCTTTTACTGGTTCGACCCCTGG	CASRRVAIPGVLGYCSSTSCFYWFDPW	IGHV1-69	IGHJ5
TGTGCGAGAGCGGGTGATTGTAGTAGTACCAGCTGCAGTGGGACACAGATCTACTACTACTACATGGACGTCTGG	CARAGDCSSTSCSGTQIYYYYMDVW	IGHV3-48	IGHJ6
TGTGCAAGAGGTCAGGTCTTCAGGGATATTGTAGTAGTACCAGCTGCGGCCATTGACTACTGG	CARGQVFRDIVVVPAAAIDYW	IGHV6-1	IGHJ4
TGTGCAAGCCAGATAGTAGTGGTTAGCTATAAGTCGAGGTACTCCTGG	CASQIVVVSYKSRYSW	IGHV6-1	IGHJ4
TGTGCACGGATACATAGGTACTCACGATACTTTGACTACTGG	CARIHRYSRYFDYW	IGHV2-70	IGHJ4
TGTGCGAGACGAGAGGGTTACCCTTGTACTGGTGGTGTATGCTTGGCGCTGCTGATCGACTACTACTACTACATGGACGTCTGG	CARREGYPCTGGVCLALLIDYYYYMDVW	IGHV4-38-2	IGHJ6
TGTGCGAGCCGTTACCAAATTGTAGTAGTACCAGCTGCTATAGGAGATTACTACTACTACTACTACATGGACGTCTGG	CASRYQIVVVPAAIGDYYYYYYMDVW	IGHV1-18	IGHJ6
TGTGCAAGAGACCCCGGTAGCTGCTACGCCCTCCCCCTTGACTACTGG	CARDPGSCYALPLDYW	IGHV3-13	IGHJ4
TGTGCGAGAGGCCCCCGTACCAGCTGCTATCTGGGGAGGAGGACCTGG	CARGPRTSCYLGRRTW	IGHV1-2	IGHJ5
TGTGCAAGTAGTACCAGCTGCTATGGCTTTGGTGTGTCCCGCTACTGG	CASSTSCYGFGVSRYW	IGHV3-74	IGHJ4
TGTGCGAGAGGCTGTTGGGAATCCATAGTGGGAGCTACCCCCTATGCTTTTGATATCTGG	CARGCWESIVGATPYAFDIW	IGHV1-3	IGHJ3
TGTGCGAAAGATGGAGTTTCCTTGGTACGATTTTTGGAGTGGTTAACGGGGCACTACTACTACTACTACATGGACGTCTGG	CAKDGVSLVRFLEWLTGHYYYYYMDVW	IGHV3-23	IGHJ6
TGTGCGAGAGGGGGGGAGCAGTGGCTGGTACGGAAGGGCTGGTTCGACCCCTGG	CARGGEQWLVRKGWFDPW	IGHV3-7	IGHJ5
TGTGCAAGAAGATTACGTTTGGGGGAGTTATCGAACCACGCTTTTGATATCTGG	CARRLRLGELSNHAFDIW	IGHV3-74	IGHJ3
TGTACTTTTTGGTCGGTCCCTGAGGTGGTGACTGGGGTGGGTGGCCCCTCCTCACACCCGGACTTTGACTACTGG	CTFWSVPEVVTGVGGPSSHPDFDYW	IGHV3-49	IGHJ4
TGTACTAGACAGACTCTACGAGTGCACCTACCCTACGGTGACTACTACTTTGACTACTGG	CTRQTLRVHLPYGDYYFDYW	IGHV3-73	IGHJ4
TGTGCGAGAGAAGAGATCGTGGGGCTTGTACTGACAAGGAACTACTACTACTACTACATGGACGTCTGG	CAREEIVGLVLTRNYYYYYMDVW	IGHV3-20	IGHJ6
TGTGCGAGAGCCCGGTTAGGTCATTACGATATTTTGACTGGTTATATCTGGCGGTCTGACTACTGG	CARARLGHYDILTGYIWRSDYW	IGHV1-46	IGHJ4
TGTGCGACTGAATTAGCTTATGGTTCAGGGAGTTATGTGTGG	CATELAYGSGSYVW	IGHV1-2	IGHJ5
TGTACCACAAGAGTTACTATGATAGTAGTGGTTATTACCCCAGGCCATGCGGAGACCCCCGACTGG	CTTRVTMIVVVITPGHAETPDW	IGHV3-15	IGHJ4
TGTGCGAGAGCCTCCGATATTGTAGTGGTGGTAGCTGCTACAAAAAGGTACTACTACTACTACTACATGGACGTCTGG	CARASDIVVVVAATKRYYYYYYMDVW	IGHV3-20	IGHJ6
TGTGCGAAAGCAGTAGTATCCTGGGGGGTCGGGGTAATTATGATTACATTTGGGCGGGGCTTTGACTACTGG	CAKAVVSWGVGVIMITFGRGFDYW	IGHV3-23	IGHJ4
TGTGCGAGAATGAATTACTATGGTTCGGGGAGTTTGTGTCCACCTGCCATAGATCGGATTGTAGAGGAGATTGACTACTGG	CARMNYYGSGSLCPPAIDRIVEEIDYW	IGHV3-64	IGHJ4
TGTGCGAGACAAGGTATAGCTACGTTTATTTCGGATCACAACTGGTTCGACCCCTGG	CARQGIATFISDHNWFDPW	IGHV5-51	IGHJ5
TGTGCGAGAGGGTATAGCAGTGGCTGGCCTACCGGCAACTGGTTCGACCCCTGG	CARGYSSGWPTGNWFDPW	IGHV1-2	IGHJ5
TGTGCGAGCGATTTTTGGAGTGGTTATTCGAGGCGTCTTGACTACTGG	CASDFWSGYSRRLDYW	IGHV3-53	IGHJ4
TGTGTCACATTACTATGGTTCAGGGAGTTATTACATGGGTACTACTACTACTACATGGACGTCTGG	CVTLLWFRELLHGYYYYYMDVW	IGHV3-7	IGHJ6
TGTGCGAGAGATTGGAGGCAGATGTCTACGGTGACTACCACCGACTACTGG	CARDWRQMSTVTTTDYW	IGHV3-7	IGHJ4
