TGTGCGAAAGATTTTATAATTCCACACTGGTTCGACCCCTGG	CAKDFIIPHWFDPW	IGHV3-NL1	IGHJ5
TGTGCGAGACTTCGGCATCTCGGGGCCGTAAAAGGTGCAGAAGCTTTTGATATCTGG	CARLRHLGAVKGAEAFDIW	IGHV4-39	IGHJ3
TGTGCGAGAGATGAGGTCTGGAGCCCCCATTTTTGGAGTGGTTATTATAGGAGGTTTGACTACTGG	CARDEVWSPHFWSGYYRRFDYW	IGHV1-2	IGHJ4
TGTGCGAAAGATGGACCGAGGGGTTACGTTATTTTGGAGTGGTTATTACGCTTTGACTACTGG	CAKDGPRGYVILEWLLRFDYW	IGHV3-NL1	IGHJ4
TGTACCACAGTCCTATCCAGTAACTACACGTGGGCTTTTGATATCTGG	CTTVLSSNYTWAFDIW	IGHV3-15	IGHJ3
TGTGCGAGACAGCGTGAGCCAGCAGCTGGTACATTATTTGACTACTGG	CARQREPAAGTLFDYW	IGHV4-39	IGHJ4
TGTGCGAGAGGGAGCCCCTCGCTGCAGTATAGTGGGAGCTACTACGTTTCGCATCGGTACTTCGATCTCTGG	CARGSPSLQYSGSYYVSHRYFDLW	IGHV4-38-2	IGHJ2
TGTGCAAAAGATATACGCGGGTTACCCTGCATTAGGGACAACTACTACTACTACTACATGGACGTCTGG	CAKDIRGLPCIRDNYYYYYMDVW	IGHV3-43D	IGHJ6
TGTGCAAGAGATCGAACCTTCTATTGTAGTAGTACCAGCTGCTATGTTGGTCAGGGTTGCGGGGAAAATTACTACTACTACTACTACATGGACGTCTGG	CARDRTFYCSSTSCYVGQGCGENYYYYYYMDVW	IGHV3-74	IGHJ6
TGTGCGAAAGATCCGTATGATTACATTTGGGGGAGTTATCGTTTAACCTTCAACTGGTTCGACCCCTGG	CAKDPYDYIWGSYRLTFNWFDPW	IGHV3-NL1	IGHJ5
TGTGCGAGAGGCGAGCAGCAGCTGGAGATTTACTACTACTACTACTACATGGACGTCTGG	CARGEQQLEIYYYYYYMDVW	IGHV3-21	IGHJ6
TGTGCGAAAGATGTGCAGACTACGGTGACAAACGGTTTTGACTACTGG	CAKDVQTTVTNGFDYW	IGHV3-NL1	IGHJ4
TGTGCGAGAGGCTGGGTATCGGTGACTACCAACTGGTTCGACCCCTGG	CARGWVSVTTNWFDPW	IGHV3-7	IGHJ5
TGTGCGAGACTGAGTCATATTGTAGTGGTGGTAGCTGCTACTCCTGCATACTACTACATGGACGTCTGG	CARLSHIVVVVAATPAYYYMDVW	IGHV3-53	IGHJ6
TGTGCAACACCCAATCCTATTACTATGATAGTAGTGGTTATCAACTCGATAGCCCTAACCAAAGTCATTGACTACTGG	CATPNPITMIVVVINSIALTKVIDYW	IGHV1-24	IGHJ4
TGTGCGAGTTGGAACGGCTTGGTTCGGGGAGTTATTATGTTTCATGATGCTTTTGATATCTGG	CASWNGLVRGVIMFHDAFDIW	IGHV4-59	IGHJ3
TGTGCGAGACGGGGACCGATTACATTTGGGGGAGTTATCGTTCACTTTGACTACTGG	CARRGPITFGGVIVHFDYW	IGHV5-51	IGHJ4
TGTGCACACAGATTCGGGGTCTGTCACAGCAGTGGCTGGTTGGGGTTAAGCTTCCTGAAAAAATTCCGACCAAATTACAGCTACTACTACTACATGGACGTCTGG	CAHRFGVCHSSGWLGLSFLKKFRPNYSYYYYMDVW	IGHV2-5	IGHJ6
TGTGCGAGAGGACACCCCCCATGGGGGAGTTATAGGCCACGCATGGACGTCTGG	CARGHPPWGSYRPRMDVW	IGHV5-10-1	IGHJ6
TGTGCGAAAAGATGGCTAGGGCCATTACGATATTTTGACTGGGACGGCTACTGG	CAKRWLGPLRYFDWDGYW	IGHV3-NL1	IGHJ4
TGTGCGAAAGATCCCCCCTTACCGGGAGTTATTATTGACTACTGG	CAKDPPLPGVIIDYW	IGHV3-23	IGHJ4
TGTACTAGAGTACGATTTTTGGAGTGGTTATGTTACTGG	CTRVRFLEWLCYW	IGHV3-49	IGHJ4
TGTGCGAGAGTTTTATGGGTGGATATTGTAGTAGTACCAGCTGAGTTCGACCCCTGG	CARVLWVDIVVVPAEFDPW	IGHV4-34	IGHJ5
TGTGCGAGAGCCACCTGGAATCGGGAGGTGGCTCATTACGATATTTTGACTGGTTATGGCTACTACTACTACTACATGGACGTCTGG	CARATWNREVAHYDILTGYGYYYYYMDVW	IGHV4-59	IGHJ6
TGTGAACGGCACTTGTTTACTACGGTGACTACCGAGCCCCCTAACAGACCTTCCCGCCACTTAAGGTTGCTGGCGTACTGG	CERHLFTTVTTEPPNRPSRHLRLLAYW	IGHV3-53	IGHJ4
TGTGCGAGAGTTGGGGGTCAGACGATTTTTGGAGTGGTTCCACCACCCGAGGGTATCTGGTTCTACTACTGG	CARVGGQTIFGVVPPPEGIWFYYW	IGHV3-21	IGHJ4
TGTGCACACGATATTGTAGTAGTACCAGCTGCTCCTACCTCCCTACTATATTACTACTACTACTACTACATGGACGTCTGG	CAHDIVVVPAAPTSLLYYYYYYYMDVW	IGHV2-5	IGHJ6
TGTGCGAGAGATAGCAGCAGCTGGGGTAACTGGTTCGACCCCTGG	CARDSSSWGNWFDPW	IGHV3-53	IGHJ5
TGTGCTAGACGTCGGCAGGACTTTTTTGCTTTTGATATCTGG	CARRRQDFFAFDIW	IGHV3-72	IGHJ3
TGTGCGAGATCCTCAAGTTTGTGGTTCAGGGAGTTATTACTAGTCTTTATTTTTGACTACTGG	CARSSSLWFRELLLVFIFDYW	IGHV1-3	IGHJ4
TGTGCACGGATCGAAACCTACGGGTTAAATATAGTAGTGGTTGCCCCAAAACATTTCGCCGACTACTGG	CARIETYGLNIVVVAPKHFADYW	IGHV2-26	IGHJ4
TGTGCGAGAAACGGATACATTTTATTACGATATGGTTTTGACTACTGG	CARNGYILLRYGFDYW	IGHV3-21	IGHJ4
TGTGCGAAAGAGGGACATATTATGATTACATTTGGGGGAGTTATCGTTGCGGTGGGAAAGAAGATTAAGCGGGTAAATTACTACTACTACTACTACATGGACGTCTGG	CAKEGHIMITFGGVIVAVGKKIKRVNYYYYYYMDVW	IGHV3-23	IGHJ6
TGTGCGAGAGGCTCGGGGGTCCCAGGATCACTATCCAATGGTGTATGCTATTTTGACTACTGG	CARGSGVPGSLSNGVCYFDYW	IGHV4-34	IGHJ4
TGTGCGAGAACCCTAAAGGGCTTTGGGCCAGTGGGAGCTACTACCATAGACTACTGG	CARTLKGFGPVGATTIDYW	IGHV5-51	IGHJ4
TGTGCACATTTGGGGGAGGGATCGGGGATGCAGACCAGATACGGAAGCCATTATGCTTTTGATATCTGG	CAHLGEGSGMQTRYGSHYAFDIW	IGHV2-5	IGHJ3
TGTGCGAGAGGCAAAATCCAGCTCGTCCGGATCAACGCTGGCTACTGG	CARGKIQLVRINAGYW	IGHV4-34	IGHJ4
TGTGCGAGCGCATCGGGTCGGATCTACTACTACTACTACATGGACGTCTGG	CASASGRIYYYYYMDVW	IGHV4-34	IGHJ6
TGTGCGAAAGGGGGACAATGGACGGGATTACATTTGGGGGACGACTACTGG	CAKGGQWTGLHLGDDYW	IGHV3-23	IGHJ4
TGTGCAAGAGGGACGGTGTATAGCAGCTCGTCCGTACCAAGAGACACTGGTTACGGAGTAAACTGGTTCGACCCCTGG	CARGTVYSSSSVPRDTGYGVNWFDPW	IGHV3-13	IGHJ5
TGTGCGAGAGATGGACCATCGCGATATTGTAGTGGTGGTAGCTGCTACTTGGCCATTGATAAGAACTGGTTCGACCCCTGG	CARDGPSRYCSGGSCYLAIDKNWFDPW	IGHV1-3	IGHJ5
TGTGCGAGAGATCGTCTGAAACACTCTCTTATCCTCGCTGAGAGCCATTGTGACTACTGG	CARDRLKHSLILAESHCDYW	IGHV4-61	IGHJ4
TGTACTAGAGCTGGTATAGCAGTGGCTGGGGGTCCGAGCTTTGACTACTGG	CTRAGIAVAGGPSFDYW	IGHV3-49	IGHJ4
TGTGCGAGAGGTACGACAGCCAAAAGCCCAAGGACCTCATTACGATTTTTGGAGTGGTTATTATACATCATATTCCCTGCTTTTGATATCTGG	CARGTTAKSPRTSLRFLEWLLYIIFPAFDIW	IGHV1-46	IGHJ3
TGTGCGAAAGATCTCGGTCCTTCAGTAACTACACTGAAGAACTACTACTACTACATGGACGTCTGG	CAKDLGPSVTTLKNYYYYMDVW	IGHV3-NL1	IGHJ6
TGTGCAAGAGCCAACTATTACTATGATAGTAGTGGTTATTACTACGGACGGTTTGACTACTGG	CARANYYYDSSGYYYGRFDYW	IGHV1-45	IGHJ4
TGTGCGAGACGGGCGGACCCCGGGACTCGGCGTGTCCGGTATTACGATTTTTGGAGTGGGGGAGGGCCCCTGTACTACTTTGACTACTGG	CARRADPGTRRVRYYDFWSGGGPLYYFDYW	IGHV7-4-1	IGHJ4
TGTGCGAGACGGCTATATTGTAGTGGTGGTAGCTGCTACGCATACTACATGGACGTCTGG	CARRLYCSGGSCYAYYMDVW	IGHV5-51	IGHJ6
TGTGCGAGACCATACCCCGCCTGGACCCTTCATTACTACTACTACTACTACATGGACGTCTGG	CARPYPAWTLHYYYYYYMDVW	IGHV5-51	IGHJ6
TGTGCAAGAGCCGGGTATTACTATGATAGTAGTGCCCGCCCTCGCGAATACTTCCAGCACTGG	CARAGYYYDSSARPREYFQHW	IGHV1-45	IGHJ1
TGTGCAAGAGTTTATAGCAGCAGCACTGGCTCGACTTATCCGGCGGACTACTGG	CARVYSSSTGSTYPADYW	IGHV3-13	IGHJ4
TGTGCGAGACCGGGAAAACATTATTACTATGGTTCGGGGAGTTATTTGGATTACTGG	CARPGKHYYYGSGSYLDYW	IGHV5-51	IGHJ4
TGTGCGAAAGATATAGCCGTTTATGATTACATTTGGGGGAGTTATCGTGGAGGGTCTAGCTACTGG	CAKDIAVYDYIWGSYRGGSSYW	IGHV3-NL1	IGHJ4
TGTGCAAGAGAGACACAGGTGGTGACTGCTTCGGGAAGGCTTACCGGGAACTGGTTCGACCCCTGG	CARETQVVTASGRLTGNWFDPW	IGHV3-13	IGHJ5
TGTGCGAGAGATGTAAGGGGCTTTGAAGGATTACTATGGTTCAGGGAGTTATCACATAGCGTGCTACCAGGCTGGTTCGACCCCTGG	CARDVRGFEGLLWFRELSHSVLPGWFDPW	IGHV3-30	IGHJ5
TGTGCGAGAGATCTCGTGTATAGCAGCAGCTGGGGCCCCTACTGG	CARDLVYSSSWGPYW	IGHV1-69	IGHJ4
TGTGCGAAATCCGGGGACCCTCTTACGATTTTTGGAGTGGTTATTCAGGCACACAACTGGTTCGACCCCTGG	CAKSGDPLTIFGVVIQAHNWFDPW	IGHV3-23	IGHJ5
TGTGCGAGATTCGATTACTATGATAGTAGTGGTTATGGCGTCGGAGACTACTGG	CARFDYYDSSGYGVGDYW	IGHV4-34	IGHJ4
TGTCCAAGCGAACGTGGATATAGTGGCTACGAGTTTGGAGGGGGGTTTGACTACTGG	CPSERGYSGYEFGGGFDYW	IGHV3-30-3	IGHJ4
TGTGCGAGAGATGTCATATATTGCTATCAGAGCGGAACGGGTTTATTCTATATAGTGGCTACGACGGTAGGGGACTACTGG	CARDVIYCYQSGTGLFYIVATTVGDYW	IGHV4-59	IGHJ4
TGTGCGAGAGATTGGTCGGGCTACTACTACATGGACGTCTGG	CARDWSGYYYMDVW	IGHV4-61	IGHJ6
TGTACTAGAGTGACGAATTGTACTGGTGGTGTATGCCGTGGGGCCTGG	CTRVTNCTGGVCRGAW	IGHV3-49	IGHJ5
TGTGCGAGGACCCTTAAACCTTGTACTAATGGTGTATGCCGGAACCTTTACACCCCTTTCTTCTTTGACTACTGG	CARTLKPCTNGVCRNLYTPFFFDYW	IGHV5-51	IGHJ4
TGTGCGAGAGATTCCCCTGAGCAGCAGCTGCCGTGGGTTGACTACTGG	CARDSPEQQLPWVDYW	IGHV3-53	IGHJ4
TGTGCGAGACCCCCAGCAGCAGCTGGCTGCCCATGCTGGTTCGACCCCTGG	CARPPAAAGCPCWFDPW	IGHV4-38-2	IGHJ5
TGTGCGAGAGATGGTCCCCGGGATGACTACGGTGACTATAGACCCTGCAACCATGACTACTGG	CARDGPRDDYGDYRPCNHDYW	IGHV3-21	IGHJ4
TGTGCGAGCTCTACCCCCCCTAGTTCACGTGAGGATATTGTAGTGGTGGTAGCTGCTACGACCGTTACCCCTCACAACTGGTTCGACCCCTGG	CASSTPPSSREDIVVVVAATTVTPHNWFDPW	IGHV4-4	IGHJ5
TGTGCGAGACCGGGATATCCAGGTATTACTATGGTTCAGGGAGTTATTATGAAATACATCCCGCCGCCTTGTGACTACTGG	CARPGYPGITMVQGVIMKYIPPPCDYW	IGHV5-51	IGHJ4
TGTGCGATCGGTCCCCATAGGGGGTACGATATTTTGACTGGTTATTATCCTGTTACCACTCACTCCGTCTACTGG	CAIGPHRGYDILTGYYPVTTHSVYW	IGHV4-34	IGHJ4
TGTGCGAGAATTGGAGGGCGCAGTGGCTGGTACGGGTTTCGGCCCCCGTTCGACCCCTGG	CARIGGRSGWYGFRPPFDPW	IGHV3-53	IGHJ5
TGTGCGAATATAGCAGTGGCTGGCCCGGGTTTTGACTACTGG	CANIAVAGPGFDYW	IGHV4-59	IGHJ4
TGTGAGAAGCAGCAGAAGGTTCCGGATAGCGACTACTGG	CEKQQKVPDSDYW	IGHV3-30	IGHJ4
TGTGCGAGAGATCTACAAATGGGTATTACTATGGTTCAGGGAGTTATTATATTTGACTACTGG	CARDLQMGITMVQGVIIFDYW	IGHV4-59	IGHJ4
TGTACTAGATGGTTTTTGGGATGTGACCAAGTGCCATTTGGATTCTTTGACTACTGG	CTRWFLGCDQVPFGFFDYW	IGHV3-49	IGHJ4
TGTGCGAGAGTGTATTACTATGGTTCGGGGAGTTATTGCCACTACTGG	CARVYYYGSGSYCHYW	IGHV5-10-1	IGHJ4
TGTAGGGGTGATAGTAGTGGTTATTACTGGAACAACTGGTTCGACCCCTGG	CRGDSSGYYWNNWFDPW	IGHV3-49	IGHJ5
TGTGCGAAAGATCTAATGTGGTTTCGATATTGTAGTAGTACCAGCTGCTACAATTACTTCCAGCACTGG	CAKDLMWFRYCSSTSCYNYFQHW	IGHV3-NL1	IGHJ1
TGTGCGAGAGATTCCTCCCCTCCTGACTACGGTGACTACTGTCCTTGGTTCGACCCCTGG	CARDSSPPDYGDYCPWFDPW	IGHV1-69	IGHJ5
TGTGCGAAACTTTACTATGATAGTAGTGGTTATTACTTCGGTCTTTTTTACTTTGACTACTGG	CAKLYYDSSGYYFGLFYFDYW	IGHV3-23	IGHJ4
TGTGCGAGACCACCAGACCCCATTACGATTTTTGACGGTTCGAACCACCCCTACATGGACGTCTGG	CARPPDPITIFDGSNHPYMDVW	IGHV7-4-1	IGHJ6
TGTGCGAGAAGGTCAACTGGTGGTGTATGCTATGTCTACTGG	CARRSTGGVCYVYW	IGHV7-4-1	IGHJ4
TGTGCGAGAGCGGAGGAAATACGTATTACGATTTTTGGAGTGGTTATTCCATACTACTACTACTACTACATGGACGTCTGG	CARAEEIRITIFGVVIPYYYYYYMDVW	IGHV3-7	IGHJ6
TGTACAGGCTACCCCGTCGGGATGGCTACAATTAATAGGGCCTTTGACTACTGG	CTGYPVGMATINRAFDYW	IGHV3-49	IGHJ4
TGTGCGAGAGAAGGTAGTACCAGCTGCTATTTCTACTGG	CAREGSTSCYFYW	IGHV4-4	IGHJ4
TGTCAGGCCCGGTATGTAGGTTACTATGATAGTAGTGGTTATTACAGCATTGAAAGGGAAGCTTACTGG	CQARYVGYYDSSGYYSIEREAYW	IGHV3-30-3	IGHJ4
TGTGCGAGAGCCAAGAGGGGCAGAGGCTTAGGGGAGGAAAGCCGATTACGATTTTTGGAGTGGTTATTAACTGACTACTGG	CARAKRGRGLGEESRLRFLEWLLTDYW	IGHV3-21	IGHJ4
TGTGCCCCCCCAGATTGTAGTAGTACCAGCTGCTATTCGGCCTACTACTACATGGACGTCTGG	CAPPDCSSTSCYSAYYYMDVW	IGHV3-23	IGHJ6
TGTGCGCCTATGGTTCAGGGAGTTATTAGCTACTACTACTACTACATGGACGTCTGG	CAPMVQGVISYYYYYMDVW	IGHV4-38-2	IGHJ6
TGTGCGAGACCCTTTCTGAATATCGACTACTACTGG	CARPFLNIDYYW	IGHV5-51	IGHJ4
TGTGCGAGAGGGCATATTGTAGTAGTACCAGCTGCTATTTCGCACCGCAACTGGTTCGACCCCTGG	CARGHIVVVPAAISHRNWFDPW	IGHV1-46	IGHJ5
TGTGCGAGACCAGTGGCTGGCGGTTTAAACCGGATCTACTGG	CARPVAGGLNRIYW	IGHV4-39	IGHJ4
TGTGCGAGACATGGTTTCCCTTACGATTTTTGGAGTGGTTATGATAGGTTTTTCCGGAGGTTATTTGACTACTGG	CARHGFPYDFWSGYDRFFRRLFDYW	IGHV4-39	IGHJ4
TGTGCGAGAGATTGTAGTAGTACCAGCTGCAGGAGATTGGGTGACTACTGG	CARDCSSTSCRRLGDYW	IGHV1-2	IGHJ4
TGTGCCCGCACGGGGGTTGCCGGAAGTGGCTGGGCCAGGAGAGAATACTTCCAGCACTGG	CARTGVAGSGWARREYFQHW	IGHV3-49	IGHJ1
TGTGCGAGGGGCGCAGCAGCTGGCCGAAACTTTGACTACTGG	CARGAAAGRNFDYW	IGHV3-30	IGHJ4
TGTGCGAGACCCTGGGATTTGCAGCTGCTAATTGCGCCAACTGCATGGTGTCCAACACTCCCAAGTTCTAAGCCCACTAATGATTACTACTACTACTACTACATGGACGTCTGG	CARPWDLQLLIAPTAWCPTLPSSKPTNDYYYYYYMDVW	IGHV4-38-2	IGHJ6
TGTGCGAGACCTAATCCATTACTATGGTTCAGGGAGGGAGACCCCACCTTTGACTACTGG	CARPNPLLWFREGDPTFDYW	IGHV1-3	IGHJ4
TGTGCGAGAGTACGCGGCGACTACGGTGACTACACGGGGGAAAACAACCCCGGGGCACAGTACTGG	CARVRGDYGDYTGENNPGAQYW	IGHV1-3	IGHJ4
TGTGCGAGGGGGCGTCCGCAGTGGCTTACTTCTCGTGACTACTGG	CARGRPQWLTSRDYW	IGHV3-NL1	IGHJ4
TGTGCGAGACAATGGCCCTTCGTATTACGATTTTTGGAGTGGTTATTGACCCTCAGGAGTTTTGACTACTGG	CARQWPFVLRFLEWLLTLRSFDYW	IGHV5-51	IGHJ4
