TGTGCGAGAAGGACGGTGACTACACCGAGGACGGCCTACTGG	CARRTVTTPRTAYW	IGHV1-3	IGHJ4
TGTGCGAGAGGAAGGCAACATTGTAGTAGTACCAGCTGCTATGATGATTTCCCTTGGGACTACTGG	CARGRQHCSSTSCYDDFPWDYW	IGHV5-51	IGHJ4
TGTGCGAGATGGACGGTAGTATTACTATGGTTCAGGGAGTTATTAAGCCATGAGCACTACTACTACTACTACATGGACGTCTGG	CARWTVVLLWFRELLSHEHYYYYYMDVW	IGHV3-7	IGHJ6
TGTGCGAGGGAACGGAGATGGCTACAATGGCAAAAAGTCACATCCTACTGG	CARERRWLQWQKVTSYW	IGHV3-30	IGHJ4
TGTACCACATCGCCGAGGGCAGCTCGTCCGTTCCTACTGGTTTATTTGCCAAACTGGTTCGACCCCTGG	CTTSPRAARPFLLVYLPNWFDPW	IGHV3-15	IGHJ5
TGTGCGAGACGGATTGTAGTAGTACCAGCTGCTAACTGTGATGCTTTTGATATCTGG	CARRIVVVPAANCDAFDIW	IGHV5-51	IGHJ3
TGTGCGAGAGGGGGGGTGAGTATAGCAGCTCGTCGCAGACGACCTCCTTTATTCCCCCAACGGAGGGTCGCGTTCCCCGACTTTGACTACTGG	CARGGVSIAARRRRPPLFPQRRVAFPDFDYW	IGHV1-69	IGHJ4
TGTGCGAGTGGGGGAAATTGCGCGTGGATACAGCTATGGTTTTGGGGGAAGGACTACTGG	CASGGNCAWIQLWFWGKDYW	IGHV7-4-1	IGHJ4
TGTGCGAGTGCCAGCTCTGACTTCTGGGATTTGGAGTGGTTATTTCGCAACTACTTTGACTACTGG	CASASSDFWDLEWLFRNYFDYW	IGHV1-46	IGHJ4
TGTGCCAGCCGTATTACTATGATAGTAGTGGTTATTACCACCGCATCGCCCATGGACGTCTGG	CASRITMIVVVITTASPMDVW	IGHV3-23	IGHJ6
TGTGCGAGAGTAGCAGTGGCTGCGAAGTTTGACTACTGG	CARVAVAAKFDYW	IGHV5-51	IGHJ4
TGTACTAGACATGGGGTCTGGCAGGGGGATATTGTGGTGGTGACTGCTATCCCGATTCCCTACTGG	CTRHGVWQGDIVVVTAIPIPYW	IGHV3-73	IGHJ4
TGTACTAGACCACCCACGAGCCTGAATAGCAGTGGCTGGTACGATAACTGGTTCGACCCCTGG	CTRPPTSLNSSGWYDNWFDPW	IGHV3-73	IGHJ5
TGTGCAAGAGAATATCGATTACGTTTGGGGGAGTTATCGTTATCGGAGCCGACCTTGGTGGGGGCTTTTGATATCTGG	CAREYRLRLGELSLSEPTLVGAFDIW	IGHV3-13	IGHJ3
TGTGCGAGAGATAGAACCGGGTATAGCAGCAGCTGCGGTTTGGGGGGCTTTAACTGGTTCGACCCCTGG	CARDRTGYSSSCGLGGFNWFDPW	IGHV1-3	IGHJ5
TGTGCGAAAATTGACTACAGCAAGGTGACCTGGTTCGACCCCTGG	CAKIDYSKVTWFDPW	IGHV3-NL1	IGHJ5
TGTGCGAGAGTCCGGTTTGACTACGGTGAGAGGTTTGACTACTGG	CARVRFDYGERFDYW	IGHV4-4	IGHJ4
TGTGCGAAAGATCCCCCATATATTGTAGTGGTGGTAGCTGCTACTCCATATTACTACTACTACTACTACATGGACGTCTGG	CAKDPPYIVVVVAATPYYYYYYYMDVW	IGHV3-23	IGHJ6
TGTGCGAGAACTTGGGGACCTATGGTTCAGGGAGTTGGAGGGAGGGGGGTTCATTACTACTACTACTACTACATGGACGTCTGG	CARTWGPMVQGVGGRGVHYYYYYYMDVW	IGHV4-61	IGHJ6
TGTGTCCTCCCGATGCTAACCTTTATGGGGATCCTCAGGGTTCACTGGTTCGACCCCTGG	CVLPMLTFMGILRVHWFDPW	IGHV3-30-3	IGHJ5
TGTGCGAGAGATCCTAGGATTGTAGTAGTACCAGCTGCTACCCCTATATACTACTTTGACTACTGG	CARDPRIVVVPAATPIYYFDYW	IGHV3-21	IGHJ4
TGTGCGAGAGATTCCCGGGGACCGCGTGCCCCAAGCAGCAGCTGGTATAACTTTGACTACTGG	CARDSRGPRAPSSSWYNFDYW	IGHV3-53	IGHJ4
TGTGCGAGAGGGTGGGGCTACATGACGCCTCACCCATTACGATTTTTGGAGTGGTTTTTTTTCCTCGCTGACTACTGG	CARGWGYMTPHPLRFLEWFFFLADYW	IGHV3-53	IGHJ4
TGTGCGAGGCAGCAGCTGGCTTGCTACTTTGACTACTGG	CARQQLACYFDYW	IGHV4-38-2	IGHJ4
TGTGCGAGAACCATTACGATTTTTGGAGTGGTTATTATCCCCCCCTACTACTACATGGACGTCTGG	CARTITIFGVVIIPPYYYMDVW	IGHV4-38-2	IGHJ6
TGTGCGAGACCTCGGTATTACTATGATAGTAGTGGTTATTACAACCCCGAATGTTTCTACTGG	CARPRYYYDSSGYYNPECFYW	IGHV5-51	IGHJ4
TGTGCGAGACTGCTAGAGGAGGCCTGTAGTACCAGCTGCTATAACTGG	CARLLEEACSTSCYNW	IGHV4-39	IGHJ4
TGTGCGAAAGATCCGGGTGGTGGTAGCTGCTACTCTTTCAAGATCTACTGG	CAKDPGGGSCYSFKIYW	IGHV3-23	IGHJ4
TGTGCGAGAGGAGGCAGCAGCTGGTACGCCGGAAGGTACTACATGGACGTCTGG	CARGGSSWYAGRYYMDVW	IGHV5-10-1	IGHJ6
TGTGCGAAAGATTTTCTTTGGTTTTTGGAGTGGTTATTCAGACTCTTTGACTACTGG	CAKDFLWFLEWLFRLFDYW	IGHV3-NL1	IGHJ4
TGTGCGAGGGCCATAGCAGCAGCTGCCTTATCCCGTAGACGGCACCATAGATACTTTGACTACTGG	CARAIAAAALSRRRHHRYFDYW	IGHV3-7	IGHJ4
TGTGCGAATCCAGTTCAGGGAGCCAACTACTACTACTACTACATGGACGTCTGG	CANPVQGANYYYYYMDVW	IGHV3-NL1	IGHJ6
TGTGCGAGAGATGGCCCGGAGGTTATAGGGATACAGCTATGGTTACCATACTACTTTGACTACTGG	CARDGPEVIGIQLWLPYYFDYW	IGHV1-18	IGHJ4
TGTGCGATTACCTCGAGTATAGCAGCTCCGCGGGATTACTACTACTACTACATGGACGTCTGG	CAITSSIAAPRDYYYYYMDVW	IGHV4-59	IGHJ6
TGTGCGAGGGGCCGAGTTATTGTAGTAGTACCAGCTGCGCTAGATGCTTTTGATATCTGG	CARGRVIVVVPAALDAFDIW	IGHV3-7	IGHJ3
TGTGCTAGAGATCTGTTGTATAATATTGTAGTAGTACCAGCTGCTATCCATTTTCCCACCTACTGG	CARDLLYNIVVVPAAIHFPTYW	IGHV3-72	IGHJ4
TGTGCGAGGGGAGGTCCCGGGGGTGGCGCGGCCAAGCGCTACTGG	CARGGPGGGAAKRYW	IGHV1-2	IGHJ4
TGTGCGAGAGATCTCATGAAAGATATTTTGACTGGTTATTATACCCAGGGGCAGGCAACCGGTTTTACTGACTGGTACTTCGATCTCTGG	CARDLMKDILTGYYTQGQATGFTDWYFDLW	IGHV1-69	IGHJ2
TGTGCGCTGAGGGTAGGTCTACCCATATGGTTGTACTCATTGTACTGGTGGTGTATGCTACGGTCTATCAACTGGTTCGACCCCTGG	CALRVGLPIWLYSLYWWCMLRSINWFDPW	IGHV3-11	IGHJ5
TGTGCGAAAGATTTTTCAAACTACGGTGACTACGACAAGGACTACTGG	CAKDFSNYGDYDKDYW	IGHV3-23	IGHJ4
TGTGCGAGAGATGCCCGAGGTAGTGGTTATGGGGGTCCCTTTGACTACTGG	CARDARGSGYGGPFDYW	IGHV3-7	IGHJ4
TGTGCGAGAGGAGTGGCTGGTTACATCAAGAAATTTGACTACTGG	CARGVAGYIKKFDYW	IGHV4-61	IGHJ4
TGTGCGAGAGATCCTTACGGTATAGCAGTGGCGAGTAGAGGATTTGACTACTGG	CARDPYGIAVASRGFDYW	IGHV1-46	IGHJ4
TGTGCGAGAGTTGCTGTAGTGGTGGTAGCTGCTAGCGGCTCGACCCTTGACTACTGG	CARVAVVVVAASGSTLDYW	IGHV3-21	IGHJ4
TGTGCGAAAGGGTCAGGGGTGGGCTGCCTTGACTACTACTACTACATGGACGTCTGG	CAKGSGVGCLDYYYYMDVW	IGHV3-NL1	IGHJ6
TGTGCGAGAGAGACTGCCCAATTGGACCGCGGGGTAGCTATGGTACGGGGGGTACAGTACTTTGACTACTGG	CARETAQLDRGVAMVRGVQYFDYW	IGHV1-69	IGHJ4
TGTGCGAGAGAACGTATTACTATGGTTCAGGGAGTTATTATAAAGTCCCTTTGCGTCTGCGACGCCAGAACCACGGAGCCTTACTGG	CARERITMVQGVIIKSLCVCDARTTEPYW	IGHV7-4-1	IGHJ4
TGTGCGAGACTGCTGTACACAAAAATCATTACGATTTTTGGAGTGGTTATTATCGACTTCCCGGTAGTCGGGTTTGACTACTGG	CARLLYTKIITIFGVVIIDFPVVGFDYW	IGHV5-51	IGHJ4
TGTGCGGCATTACTATGGTTCAGGGAGCAGAACACATACTACTACTACTACTACATGGACGTCTGG	CAALLWFREQNTYYYYYYMDVW	IGHV1-58	IGHJ6
TGTGGTCCCTTCGGTGGGGATATTGTAGTGGTGGTAGCTGCTACCTACTACTACTACTACATGGACGTCTGG	CGPFGGDIVVVVAATYYYYYMDVW	IGHV3-30-3	IGHJ6
TGTGCGAGTTCACCGTATGACTACTGG	CASSPYDYW	IGHV1-3	IGHJ4
TGTGCAAGTTTTTTTAGATTACGATATTTTGACTGGTTATTAATTTCCAAGTGTGACTACTGG	CASFFRLRYFDWLLISKCDYW	IGHV3-74	IGHJ4
TGTGCGAAAGTCCTCGGTACCCATTGTAGTAGTACCAGCTGCTATGGATACTACTACTACTACTACATGGACGTCTGG	CAKVLGTHCSSTSCYGYYYYYYMDVW	IGHV3-NL1	IGHJ6
TGTGCGAGAGATCCCTCTGGAGGCATGTCCGGTCCCGTATTACGATTTTTGGAGTGGTTATTTGACTACTGG	CARDPSGGMSGPVLRFLEWLFDYW	IGHV3-21	IGHJ4
TGTGCGAAAGAACATATTGTGGTGGTGATTGCCACTGGCGTCCCCCACCCGGGTCCTGACTACTGG	CAKEHIVVVIATGVPHPGPDYW	IGHV3-23	IGHJ4
TGTGCGGGGGTGACTACAGTAACTACCTTCGCGAACGACTACTGG	CAGVTTVTTFANDYW	IGHV4-38-2	IGHJ4
TGTGCGAGAGTCCCACTCGCGCCTACAAGGGAACGGTCAAGGGACGTTTACTGTACCGATTACGATTTTTGGAGTGGTTACTTAACGCACTACTACTACATGGACGTCTGG	CARVPLAPTRERSRDVYCTDYDFWSGYLTHYYYMDVW	IGHV7-4-1	IGHJ6
TGTACTAGAGATAACCTAGGTACGGTGACTAAAATTGACTACTGG	CTRDNLGTVTKIDYW	IGHV3-49	IGHJ4
TGTGCGAGAGGTGATACGATTTTTGGAGTGGCCAACTGGTTCGACCCCTGG	CARGDTIFGVANWFDPW	IGHV4-34	IGHJ5
TGTGCGAGACTATGTGGATATTGTAGTAGTACCAGCTGCTATTCCGAGGAGGATGATACCTGGTTCGACCCCTGG	CARLCGYCSSTSCYSEEDDTWFDPW	IGHV5-51	IGHJ5
TGTGCGAGGTTGGTTATTACTATGATAGTAGTGGGCGTACGTCAGTACTACTTTGACTACTGG	CARLVITMIVVGVRQYYFDYW	IGHV1-2	IGHJ4
TGTGCGAGAGATATTGTAGTGGTGGTAGCTGCGCAATGCCTCACCTTTACCGGCTACTTTGACTACTGG	CARDIVVVVAAQCLTFTGYFDYW	IGHV3-7	IGHJ4
TGTGCGAGACATTATTCTATGATAGTAGTGGTTATTACAATTAGCCCGTACTACTTTGACTACTGG	CARHYSMIVVVITISPYYFDYW	IGHV5-51	IGHJ4
TGTGCGAGAGATCGGGGTTTTATTGTAGTAGTACCAGCTGCTAAAAAGGTGAAATCTGAGGGGACGGACTGGTTCGACCCCTGG	CARDRGFIVVVPAAKKVKSEGTDWFDPW	IGHV3-53	IGHJ5
TGTGCGAGAGATCCCACCGAGTATAGCAGCTCGTCGTTTTCCTTAATTGTTCTACGGGGTCCGTACTACTTTGACTACTGG	CARDPTEYSSSSFSLIVLRGPYYFDYW	IGHV3-21	IGHJ4
TGTGCGAGAGTGCGGCGCTACTACTACTACTACATGGACGTCTGG	CARVRRYYYYYMDVW	IGHV1-69	IGHJ6
TGTGCGAGATATACGATTTTTGGAGTGGTTATTATAACCAACGTAGGCCACGGGTACTACTACTACTACTACATGGACGTCTGG	CARYTIFGVVIITNVGHGYYYYYYMDVW	IGHV4-38-2	IGHJ6
TGTGCGAGACTGGCCGATGGAGTGGTTATTATAGGGTACTACTACTACTACATGGACGTCTGG	CARLADGVVIIGYYYYYMDVW	IGHV4-39	IGHJ6
TGTGCGAGAGGCCTAAAGGGGCTATATTGTACTGGTGGTGTATGCTATATCCGAATCTGG	CARGLKGLYCTGGVCYIRIW	IGHV4-34	IGHJ4
TGTGCACGGATACGCTCTGGGATTTCAGCAGCTGGGGGCCACGCAGGCCCCTACTGG	CARIRSGISAAGGHAGPYW	IGHV2-26	IGHJ4
TGTGCGAAAGATCTCCCTGATAGAGGGGGAGGCCAGTCGGACGATATTGTAGTGGTGGTAGCTGCTAATGATGCTTTTGATATCTGG	CAKDLPDRGGGQSDDIVVVVAANDAFDIW	IGHV3-23	IGHJ3
TGTGCGAGAGACCCTCCTTATTGTAGTAGTACCAGCTGCTATCGAGGTTGG	CARDPPYCSSTSCYRGW	IGHV3-53	IGHJ5
TGTGCGAGTACCGGACGATGGTTATTACTAAGCCCCTGG	CASTGRWLLLSPW	IGHV5-51	IGHJ4
TGTGCGAACCGCTTCCCGACGGAGTATTACGATTTTTGGAGTGGTTATTATCTGAACTGGTTCGACCCCTGG	CANRFPTEYYDFWSGYYLNWFDPW	IGHV3-NL1	IGHJ5
TGTGCGAGAGCACCGTGGCGTATTACTATGGTTCAGGGAGTTATCTGGTTTTTAATATCGTCTGACACGGCCGATGCTTTTGATATCTGG	CARAPWRITMVQGVIWFLISSDTADAFDIW	IGHV4-38-2	IGHJ3
TGTGCGAAAGATGGGCCCGGAGCTCCGGGACCTGCTTTTGATATCTGG	CAKDGPGAPGPAFDIW	IGHV3-NL1	IGHJ3
TGTGCGAGAGGGAGGTGGGAGCTACTAAATGACTACTGG	CARGRWELLNDYW	IGHV1-46	IGHJ4
TGTGCGAGAGGCACCACGTATTACGATTTTTGGAGTGGTTATTTAAAGGATCCCGACCCCTACTACTACTACTACTACATGGACGTCTGG	CARGTTYYDFWSGYLKDPDPYYYYYYMDVW	IGHV4-34	IGHJ6
TGTGCGAGAGGGGATTACGATTTTTGGAGTGGTTATTATACCAGCGACTACTGG	CARGDYDFWSGYYTSDYW	IGHV4-34	IGHJ4
TGTGCGAGAGATATTGGAGGCAAGGGGGGAGTTATCGTTGACTTTGACTACTGG	CARDIGGKGGVIVDFDYW	IGHV1-2	IGHJ4
TGTGCACACAGACAAGTGCATATTGTGGTGGTGATTGCTATTATTCTCTACTTTGACTACTGG	CAHRQVHIVVVIAIILYFDYW	IGHV2-5	IGHJ4
TGTGCGAGACCACCACTGGAACGTGAATTTGACTACTGG	CARPPLEREFDYW	IGHV5-51	IGHJ4
TGTGCACGGATATGTAATAGAGATGGCTACAATTACGGGTACTTTGACTACTGG	CARICNRDGYNYGYFDYW	IGHV2-70	IGHJ4
TGTGCACACGAGATTACGATTTTTGGAGTGGCCCACTACTACTACTACTACATGGACGTCTGG	CAHEITIFGVAHYYYYYMDVW	IGHV2-5	IGHJ6
TGTGCGAGAGATAGATATAGTCCCTACTGG	CARDRYSPYW	IGHV1-69	IGHJ4
TGTGCACCCGCCACGGATTTTTGGAGTGGTTATGGGGCGAACTGGTTCGACCCCTGG	CAPATDFWSGYGANWFDPW	IGHV2-5	IGHJ5
TGTGCAAGAGACCCGTATTACGATTTTTGGAGTGGTTATTACCCTGATGCTTTTGATATCTGG	CARDPYYDFWSGYYPDAFDIW	IGHV3-74	IGHJ3
TGTGCGAAACGTTCGCTATTGTACTGGTGGTGTATGCTATACGGTGTGTGGTTCGACCCCTGG	CAKRSLLYWWCMLYGVWFDPW	IGHV3-23	IGHJ5
TGTGCAAGAACCACAAACTTAACTCCCTGGACTAGGATATTGTACTGGTGGTGTATGCTATCGCAGGCCCACTTCCAGCACTGG	CARTTNLTPWTRILYWWCMLSQAHFQHW	IGHV1-45	IGHJ1
TGTGCGAGAGAAGAAGCAAGGTTGGGTCTTATAACCCTTAGGGATATTGTAGTGGTGGTAGCTGCTAGTGTTGGTAGCTACTACATGGACGTCTGG	CAREEARLGLITLRDIVVVVAASVGSYYMDVW	IGHV3-20	IGHJ6
TGTGCGAGAGATACTCTTATTGTGGTGGTGATTGCTACCGGTTACAACTGGTTCGACCCCTGG	CARDTLIVVVIATGYNWFDPW	IGHV4-59	IGHJ5
TGTGCGAAAGGTTCCGCCGGGTATAGCAGCAGCTGCGATGAGTCACATGCTTTTGATATCTGG	CAKGSAGYSSSCDESHAFDIW	IGHV3-NL1	IGHJ3
TGTGCGAGATTACTATGGTTCAGGGAGTTATTATGCGGTCTCTGG	CARLLWFRELLCGLW	IGHV4-59	IGHJ4
TGTGCGAGACAGGTCCCTAACCCAGCAGCTGGTATGGCAGAATACTTTGACTACTGG	CARQVPNPAAGMAEYFDYW	IGHV4-39	IGHJ4
TGTGCGAGACGGGCGGTGGTAGCTGCTACGAGGAATTACTACTACTACTACTACATGGACGTCTGG	CARRAVVAATRNYYYYYYMDVW	IGHV3-66	IGHJ6
TGTGCGAGATGTCCGTCGGGGGCAGACCTTTCTGGGTATAGCAGCAGCTGGCTCCACGTTATCTTTTACTGTTTTGACTACTGG	CARCPSGADLSGYSSSWLHVIFYCFDYW	IGHV4-59	IGHJ4
TGTGCAAAAGATATATTTTTTTGTTGTGGTAACCAAGGGATACATGCATACCCCGGATTCTCCTGGGAACAACTGGCATTAAATAACTACTGG	CAKDIFFCCGNQGIHAYPGFSWEQLALNNYW	IGHV3-43	IGHJ4
TGTGCACGGATCATCCCGCTGAGTATAGCAGCTCGTCCGGCTAACCCTTCCCCCGGGAATGATGCTTTTGATATCTGG	CARIIPLSIAARPANPSPGNDAFDIW	IGHV2-70	IGHJ3
TGTGCGAGATCGTTACCCCATATAGCAGCAGCTGTTAGGGGAAACTGGTTCGACCCCTGG	CARSLPHIAAAVRGNWFDPW	IGHV1-2	IGHJ5
TGTGCACGGGCGATGGTACGATTTTTGGAGTGGTTATGGAACTACATGGACGTCTGG	CARAMVRFLEWLWNYMDVW	IGHV2-70	IGHJ6
