TGTGCACACAGGATATATTACGATTTTTGGAGTGTTAGCCAGCGTTACTACTACTACTACTACATGGACGTCTGG	CAHRIYYDFWSVSQRYYYYYYMDVW	IGHV2-5	IGHJ6
TGTGCGAGAAGGACCGTCTTCGATATTGTAGTAGTACCAGCTGCTTGTTCGCGTTACTACTACTACTACTACATGGACGTCTGG	CARRTVFDIVVVPAACSRYYYYYYMDVW	IGHV4-38-2	IGHJ6
TGTGCGAGACGGAAAACTACGGTGACCAATCGGATGATAACCTGTGATGCTTTTGATATCTGG	CARRKTTVTNRMITCDAFDIW	IGHV4-39	IGHJ3
TGTGCAAATGTTTTGACTGGTTATTATATAAAAGGGTCGGAGTTTGACTACTGG	CANVLTGYYIKGSEFDYW	IGHV3-7	IGHJ4
TGTGCGAGAGCTAATCCCACGTATTACTATGATAGTAGTGGTTATTACGGTTGCTTTGACTACTGG	CARANPTYYYDSSGYYGCFDYW	IGHV1-2	IGHJ4
TGTGCGAGGCTTACGATATACTACTTTGACTACTGG	CARLTIYYFDYW	IGHV4-34	IGHJ4
TGTGCGAGAGGTGACTATTGTAGTGGTGGTAGCTGCTCCCTAGTTGACTACTGG	CARGDYCSGGSCSLVDYW	IGHV4-34	IGHJ4
TGTGCGAGACTGAGGGGCATTGTAGTAGTACCAGCTGCTAAGTACTGG	CARLRGIVVVPAAKYW	IGHV3-64	IGHJ4
TGTGCGAGACAAGCCCTTAGAAGTCGTATTACTATGATAGTAGTGGTTATTACTACGTTACGCTTTGACTACTGG	CARQALRSRITMIVVVITTLRFDYW	IGHV1-2	IGHJ4
TGTGCACGGATGGGAATTACTATGGTTCAGGGAGTACCGGTCCACGACTACTGG	CARMGITMVQGVPVHDYW	IGHV2-26	IGHJ4
TGTGCACGGATAGGAGGTTCAGGGAGTTATTATAACGAGATCCCCGTCTTTGACTACTGG	CARIGGSGSYYNEIPVFDYW	IGHV2-26	IGHJ4
TGTGCGAGAGAAGAGAAGGCCACCCCTAGCAGGATATTGTACTGGTGGTGTATGCTTGAAATTAACGGCGATGACTACTGG	CAREEKATPSRILYWWCMLEINGDDYW	IGHV3-64	IGHJ4
TGTGCGAACGTAATACCTAGTAGCAGCAGCTGGCTCTTTGACTACTGG	CANVIPSSSSWLFDYW	IGHV3-NL1	IGHJ4
TGTGCGAGGGCGGAAGCAGCAGCTGGTGGGAAAAGCATTGACTACTGG	CARAEAAAGGKSIDYW	IGHV1-18	IGHJ4
TGTGCGAGACCCGTAAGGTTACGATTTTTGGAGTGGTTATTATTGTCTCCTAACTACTACTACATGGACGTCTGG	CARPVRLRFLEWLLLSPNYYYMDVW	IGHV4-59	IGHJ6
TGTGCGAGAGAGGCCTCAGTTACCTTCTTTACCGGGGCCTCTCACTGGTACTTCGATCTCTGG	CAREASVTFFTGASHWYFDLW	IGHV4-38-2	IGHJ2
TGTGCGCGCTCCCCTTGTATTACTATGATAGTAGTGGTTATTACTACCGGGCACAACTGGTTCGACCCCTGG	CARSPCITMIVVVITTGHNWFDPW	IGHV3-23	IGHJ5
TGTGCACGGATAAGTAGTCCTCAGTCCGCCAAATTCTACTGG	CARISSPQSAKFYW	IGHV2-70	IGHJ4
TGTGCGAGAGATCTCTTTGTAGTAGTACCAGCTGCTAGAGGGGCCTCCTACTGG	CARDLFVVVPAARGASYW	IGHV3-21	IGHJ4
TGTGCGAGACCGGCCGGGTCACCGGATTGTAGTGGTGGTAGCTGCTACTCAGGACCCGGGCGCATACACTGGTTCGACCCCTGG	CARPAGSPDCSGGSCYSGPGRIHWFDPW	IGHV4-38-2	IGHJ5
TGTGCGAGAGTGTATGGTTCAGGGAGTCCCTGGCCCACCGACTACTGG	CARVYGSGSPWPTDYW	IGHV3-7	IGHJ4
TGTGCGAGAGGCGCCGAGAGTGAGTGGTGTAGGTGGGCCAACTACTACTACTACTACATGGACGTCTGG	CARGAESEWCRWANYYYYYMDVW	IGHV4-34	IGHJ6
TGTACCCAGCGGGGTAGTGGTGGAAACTCCCGCTTTGACTACTGG	CTQRGSGGNSRFDYW	IGHV3-15	IGHJ4
TGTGCGAGAGCAATAAGGGAGGTAGTGGCTACTAGGTTTGACTACTGG	CARAIREVVATRFDYW	IGHV3-11	IGHJ4
TGTGCAAGAGATGGCGGGATTACTATGGTTCAGGGAGTTATTATCAAGGTCGACCCACCGAATCCACCAGACCCCTACTACTACTACTACATGGACGTCTGG	CARDGGITMVQGVIIKVDPPNPPDPYYYYYMDVW	IGHV3-13	IGHJ6
TGTGCGAGACCCATTGTAGTGGTGGTAGCTGCTACGACCTTTGACTACTGG	CARPIVVVVAATTFDYW	IGHV4-34	IGHJ4
TGTGCGAGAGACCCCAATGATGGTGCTACGGTGGTAACTCCGCCTGTGAACTGGTTCGACCCCTGG	CARDPNDGATVVTPPVNWFDPW	IGHV4-59	IGHJ5
TGTGCGAAAGATCCTTTTATCGGTATAGCAGTGGCTGGTCGCTACTACTTTGACTACTGG	CAKDPFIGIAVAGRYYFDYW	IGHV3-NL1	IGHJ4
TGTGCGAGAGGAGGAATCAGCAGTGGCTGGGGGGATTGGGGGAAAGAGGGGGGAGTCCCCTTTGACTACTGG	CARGGISSGWGDWGKEGGVPFDYW	IGHV3-11	IGHJ4
TGTGCGAGAGATCCCCCCCCTATTACGATTTTTGGAGTGGTTATTATCCTTTACTACATGGACGTCTGG	CARDPPPITIFGVVIILYYMDVW	IGHV1-18	IGHJ6
TGTACCACCTCGACTACAGTAACTACGTGCAGGCCTTTAATGGGCAACGGGGTTAACCTGGCTGACTACTGG	CTTSTTVTTCRPLMGNGVNLADYW	IGHV3-15	IGHJ4
TGTGCGAGAGAACTCGAGTGGCAAATTACTATGGTTCAGGGAGATAAAGGCGACTACTGG	CARELEWQITMVQGDKGDYW	IGHV1-18	IGHJ4
TGTGCGAGGTCACCTATGGTTAGCTACTGG	CARSPMVSYW	IGHV3-11	IGHJ4
TGTGCGAGAGAGACCTTAACGACGGGTGGTATAACTGGAACTACCCGGGATCCGGTCTTTGACTACTGG	CARETLTTGGITGTTRDPVFDYW	IGHV3-30	IGHJ4
TGTGCGAAAGATGTCGGTATTGTAGTGGTGGTAGCTGCTACTGGCTTTGACTACTGG	CAKDVGIVVVVAATGFDYW	IGHV3-NL1	IGHJ4
TGTGGTACCCACCCAGCAGTGGCTGGTGAGGCCTTTGACTACTGG	CGTHPAVAGEAFDYW	IGHV3-30	IGHJ4
TGTGCGAGAGGCGAGGCTAGTCCTGGGCGGGATTACGATTTTTGGAGTGGCGAACTCTACTACTACTACTACATGGACGTCTGG	CARGEASPGRDYDFWSGELYYYYYMDVW	IGHV7-4-1	IGHJ6
TGTGCGAGTGATGTGGGGGGGTATACAACATATTGTACTAATGGTGTATGCTATACATCAACCTTCTTATACTACTTTGACTACTGG	CASDVGGYTTYCTNGVCYTSTFLYYFDYW	IGHV7-4-1	IGHJ4
TGTGCGAGAGCGTTTGTAGTAGTACCAGCTGCTATGTTCGTCTTTGACTACTGG	CARAFVVVPAAMFVFDYW	IGHV1-46	IGHJ4
TGTGCACGGCCATTAGCAGCTCGGCCTCCCCACTGGTTCGACCCCTGG	CARPLAARPPHWFDPW	IGHV2-70	IGHJ5
TGTGCGAGAGGGGGCAAAACCTGTAGTAGTACCAGCTGCTATTCCCACTACTACTACTACTACATGGACGTCTGG	CARGGKTCSSTSCYSHYYYYYMDVW	IGHV1-69	IGHJ6
TGTGCTCCACCCTTGAATTACGATTTTTGGAGTGGTTATTACGGGTACTGGTACTTCGATCTCTGG	CAPPLNYDFWSGYYGYWYFDLW	IGHV2-70	IGHJ2
TGTGCGAGAGGGATATTGTACTGGTGGTGTATGCTAAGCCGATACTACTACTACTACTACATGGACGTCTGG	CARGILYWWCMLSRYYYYYYMDVW	IGHV4-38-2	IGHJ6
TGTACCACAGAGGGTAGCCCTAGCAGCAGCTGGTATCTCCGGAGTGACTACTGG	CTTEGSPSSSWYLRSDYW	IGHV3-15	IGHJ4
TGTGCGAGATGGTTCCTTCGGGGCCATATAGTGGCTACGATTCCTGACTACTGG	CARWFLRGHIVATIPDYW	IGHV4-38-2	IGHJ4
TGTGCGAGAGATTCGCCGATTGTAGTAGTACCAGCTGCTATACCTGAGCATTACTACTACTACTACTACATGGACGTCTGG	CARDSPIVVVPAAIPEHYYYYYYMDVW	IGHV3-48	IGHJ6
TGTACCACAGTGTCCACTGATACGCAGCAGCTGGAAATCTACTTTGACTACTGG	CTTVSTDTQQLEIYFDYW	IGHV3-15	IGHJ4
TGTGCATTGGCTACGATCGGGGGGTGG	CALATIGGW	IGHV4-39	IGHJ5
TGTGCGAGAGAATCATTCGTTGGAGTGGTTATTATCCGTGCATCCTACTGG	CARESFVGVVIIRASYW	IGHV4-61	IGHJ4
TGTGCGAGAGGGTGTAAGGCCGCCTGGTACTTCGATCTCTGG	CARGCKAAWYFDLW	IGHV1-69	IGHJ2
TGTGCGAGAGATGTCCCCGGGATACAGCTATGGTTAGACCTCTTTGGACCCCCGGGGCTATTAGTCTGG	CARDVPGIQLWLDLFGPPGLLVW	IGHV3-53	IGHJ3
TGTGCGAGAGGCGGTTCTGAGGCCCGCTTAAATTGTAGTAGTACCAGCTGCTATCCGGTGGCCTACTACATGGACGTCTGG	CARGGSEARLNCSSTSCYPVAYYMDVW	IGHV4-38-2	IGHJ6
TGTGCGAGAGGCTATTATGATTACATTTGGGGGAGTTATCGTGACTACTGG	CARGYYDYIWGSYRDYW	IGHV3-7	IGHJ4
TGTGCGAGAGCTTATTTGAACGACGTCTTTGACTACTGG	CARAYLNDVFDYW	IGHV3-64	IGHJ4
TGTGCGAGAGATGAATGGACCGCGGTCAGGTACAGTAACTTTCGTAGGGAGGAGCCCAAGACAAGAAACTGGTACTTCGATCTCTGG	CARDEWTAVRYSNFRREEPKTRNWYFDLW	IGHV3-53	IGHJ2
TGTGCACGGATACCGATCTGTCGCCCTATGGTTCAGGGAGTTATTGGCAAATACTACATGGACGTCTGG	CARIPICRPMVQGVIGKYYMDVW	IGHV2-70	IGHJ6
TGTGCGAGGGATGAATGGATCCGAGGTAGTCCAGTGACTACTGACCCAGTTGGCTACATGGACGTCTGG	CARDEWIRGSPVTTDPVGYMDVW	IGHV4-59	IGHJ6
TGTGCGGTACACGTTAGGGTACTATGGTTCAGCCACGTAACCCGGGCCCCCGCTTTCTTTGACTACTGG	CAVHVRVLWFSHVTRAPAFFDYW	IGHV4-59	IGHJ4
TGTGCGAGAGGTACGGTGACCTCTGGGCTTGACTACTGG	CARGTVTSGLDYW	IGHV4-28	IGHJ4
TGTGCGAGAGCGACGGCCAGGTGGAATTGGCCGTACTGGTACTTCGATCTCTGG	CARATARWNWPYWYFDLW	IGHV1-2	IGHJ2
TGTGCGAGACCCGTAGTGGTTGTGGTGGTGACTGCAGCCTACTACTTTGACTACTGG	CARPVVVVVVTAAYYFDYW	IGHV5-51	IGHJ4
TGTGCGAGAGACCGGCGGAGTGGTAGGGGTTCGTTTGACTACTGG	CARDRRSGRGSFDYW	IGHV3-20	IGHJ4
TGTGCGAGACGGGCATATTGTAGTGGTGGTAGCTGCTACTCAAGTACAGACTTTGACTACTGG	CARRAYCSGGSCYSSTDFDYW	IGHV5-51	IGHJ4
TGTGCGAGTACGCAGTGGCTGGTACCCTTTGAGCCCCTGAGGCCCAACTGGTTCGACCCCTGG	CASTQWLVPFEPLRPNWFDPW	IGHV1-46	IGHJ5
TGTGCGAGACAGCCCTTCCAAATAGCAGTGGCTGGGGTATACTTTGACTACTGG	CARQPFQIAVAGVYFDYW	IGHV3-7	IGHJ4
TGTGCGAGAGATGAAAAGTGGTTATTGGACTGGTACTTCGATCTCTGG	CARDEKWLLDWYFDLW	IGHV1-46	IGHJ2
TGTGCGAGGTGTGCGCAGCAGCTGGTTGCGAGTTGTTTTGACTACTGG	CARCAQQLVASCFDYW	IGHV1-2	IGHJ4
TGTGCGAGAGAAGGGGGCTACCCGTACACGGGGTTATCGAATGTAGTGGTGGTAGCTGCTACTCCGTCTTTGAAGTTTGACTACTGG	CAREGGYPYTGLSNVVVVAATPSLKFDYW	IGHV3-21	IGHJ4
TGTGCACACAGAAAGGAAGTAACCTCCGGGTATAGCAGTGGCTGGTGTAATCTCCGAATTTACTACTGG	CAHRKEVTSGYSSGWCNLRIYYW	IGHV2-5	IGHJ4
TGTGCGAAAGATTGCAGTCGGAGTTTTCCTCCCACGTATTACGATTTTTGGAGTGGTTATGCCTACTTTGACTACTGG	CAKDCSRSFPPTYYDFWSGYAYFDYW	IGHV3-NL1	IGHJ4
TGTACTAGAGATCCCGACGCAGCCACTATAATGTGTATAGCAGCTCCCCGGCCCTACTGG	CTRDPDAATIMCIAAPRPYW	IGHV3-49	IGHJ4
TGTGCGAAAGCAATTCCGGATATTGTAGTAGTACCAGCTGCTATAGGGTCCTTCGGGTACTACTACTACTACTACATGGACGTCTGG	CAKAIPDIVVVPAAIGSFGYYYYYYMDVW	IGHV3-23	IGHJ6
TGTGCGAAAGTGATGGATGAGGCGACTACGGTGACTACTGTCCATGCTTTTGATATCTGG	CAKVMDEATTVTTVHAFDIW	IGHV3-23	IGHJ3
TGTACTCCGGCTCCTACAGTAACTACGTTTGGGCGGTTCGACCCCTGG	CTPAPTVTTFGRFDPW	IGHV3-49	IGHJ5
TGTACCACAGCGGGACGGCATGACTACGGTGACTACAACGTTTGG	CTTAGRHDYGDYNVW	IGHV3-15	IGHJ4
TGTGCGAGAGACAACGATTGTACTGGTGGTGTATGCTATCAAATAGACTACTACTACTACTACATGGACGTCTGG	CARDNDCTGGVCYQIDYYYYYMDVW	IGHV3-48	IGHJ6
TGTGCGAAAGATGTGAAAATTGACGCTACGATTTTTGGATGGTTGGATTACTACTACTACTACTACATGGACGTCTGG	CAKDVKIDATIFGWLDYYYYYYMDVW	IGHV3-23	IGHJ6
TGTGCGAAAGATCTTACCCAGTTAGGATATTGTAGTAGTACCAGCTGCTATGCGGTCTGG	CAKDLTQLGYCSSTSCYAVW	IGHV3-NL1	IGHJ5
TGTACCACTTTAGGCAGGCTTGACTACTGG	CTTLGRLDYW	IGHV3-15	IGHJ4
TGTGCGAGAGGAGGGGTAAAGGAGCCGAAAGATATTGTAGTGGTGGTAGCTGCTGGAAACGTATTTGACTACTGG	CARGGVKEPKDIVVVVAAGNVFDYW	IGHV4-34	IGHJ4
TGTGCGAGCCGTAAATTCCTGGACCTCAAGTTTGACTACTGG	CASRKFLDLKFDYW	IGHV3-21	IGHJ4
TGTGCGAGAGGCGTGGTTATTATGTTCCTTACCTGGTACTTCGATCTCTGG	CARGVVIMFLTWYFDLW	IGHV3-53	IGHJ2
TGTGCGAGAGATCCGCCCCAACAGGTTAGTATTACTATGATAGTAGTGGTTATTACCGCTTACCCCCAATACTTCCAGCACTGG	CARDPPQQVSITMIVVVITAYPQYFQHW	IGHV1-18	IGHJ1
TGTGCACGGAACTACGAGGGGGGAAGGGTATTACGATTTTTGGAGTGGTTATTAGTCACCCTTGGTCTCTACTACTACTACTACATGGACGTCTGG	CARNYEGGRVLRFLEWLLVTLGLYYYYYMDVW	IGHV2-26	IGHJ6
TGTGCGAGACAGGGTGTTCCCAATGATAGTAGTGGTGTCTGGTTCGACCCCTGG	CARQGVPNDSSGVWFDPW	IGHV1-69	IGHJ5
TGTGCAAGGTTTCCCGATGCAGCAGCTGCGTGTACAGTGGCTGTTGGGTGG	CARFPDAAAACTVAVGW	IGHV3-13	IGHJ5
TGTGCGAAAGATGTCGAAGCGCAGCAGCTGCACTACTGGTACTTCGATCTCTGG	CAKDVEAQQLHYWYFDLW	IGHV3-NL1	IGHJ2
TGTGCGAGAGATAAGAAGGTGCCTATTACGATTTTTGGAGTGGTTATTATGGATGGGGGTTACTTTGACTACTGG	CARDKKVPITIFGVVIMDGGYFDYW	IGHV3-11	IGHJ4
TGTGCGAAAGATCCTCATATAGCAGCTCGTCCCCCTCCTCGGCATGACTACTGG	CAKDPHIAARPPPRHDYW	IGHV3-NL1	IGHJ4
TGTGCGAAACGAAACGATATTGTAGTGGTGGTAGCTGCTACTCAATCCCACTACATGGACGTCTGG	CAKRNDIVVVVAATQSHYMDVW	IGHV3-23	IGHJ6
TGTGCGAGAGATACTATTGTAGTAGTACCAGCTGCAGACTACTGG	CARDTIVVVPAADYW	IGHV3-7	IGHJ4
TGTGCGAGGATCATTGTAGTAGTACCAGCTGCGGCCCGCCGACCGACTGTTTGGTGTAATTACTACTACTACTACATGGACGTCTGG	CARIIVVVPAAARRPTVWCNYYYYYMDVW	IGHV4-34	IGHJ6
TGTGCGAGCCTTCCGCCCTATTACTATGGTTCGGGGGTTAGGCTTGACTACTGG	CASLPPYYYGSGVRLDYW	IGHV1-69	IGHJ4
TGTGCGTACATGGAGTACCAGCTAGGACTCTGCTACTACTACTACTACATGGACGTCTGG	CAYMEYQLGLCYYYYYMDVW	IGHV4-34	IGHJ6
TGTGCGAAGCCCCGACTCCGGTTTCTCTGG	CAKPRLRFLW	IGHV3-NL1	IGHJ2
TGTGCAGGCGCAGCAGCCATTTCTTCCTACTGG	CAGAAAISSYW	IGHV3-NL1	IGHJ4
TGTTATTGGTTGTATAGCAGCAGCTGGTACGGTCTGTGGTTTAGCTGG	CYWLYSSSWYGLWFSW	IGHV4-39	IGHJ5
TGTGCGAGAGATGGTCGTCCCGCGGGTGGTAGCTGCTACTCAGGCGGTTACTACTACTACATGGACGTCTGG	CARDGRPAGGSCYSGGYYYYMDVW	IGHV3-20	IGHJ6
TGTGCGAGAGATCCGTATATGGATACAGCTATGGTTATGTGGTTTGACTACTGG	CARDPYMDTAMVMWFDYW	IGHV3-20	IGHJ4
TGTACTAGAGTCTTTAATAGATTTTACTATGATAGTAGTGGTTACCAAGGTGCTTTTGATATCTGG	CTRVFNRFYYDSSGYQGAFDIW	IGHV3-49	IGHJ3
