TGTCATTGTAGTGGTGGTAGCTGCTACCTCAACTACTTTGACTACTGG	CHCSGGSCYLNYFDYW	IGHV3-30-3	IGHJ4
TGTGCGGCAGATCCCTGCCCAAAAGATCTTGGGGGAGTTGATCATGCTTTTGATATCTGG	CAADPCPKDLGGVDHAFDIW	IGHV1-58	IGHJ3
TGTGCGAGAGTAAGATCCCCCCCTAAAAAGAATATTGTACTAATGGTGTATGCTTCCCGACCAGTCTGG	CARVRSPPKKNIVLMVYASRPVW	IGHV7-4-1	IGHJ4
TGTGCGAGAGCCCAGCAGTGGCTGGTGCCAAGTGGTACCTCCGGAGACTACTGG	CARAQQWLVPSGTSGDYW	IGHV7-4-1	IGHJ4
TGTGCAAGAGGATTCTGTATTACTATGATAGTAGTGGTTATTATACGTGACTACTGG	CARGFCITMIVVVIIRDYW	IGHV3-13	IGHJ4
TGTGCGAGAGATTACTCTCCGATAGCAGTGGCTGGTACGTGGTGGCCGTCGTCGGACTACTACTACTACTACATGGACGTCTGG	CARDYSPIAVAGTWWPSSDYYYYYMDVW	IGHV4-59	IGHJ6
TGTGCAAGAGATGAATCGGGGGTTACTATGATAGTAGTGGTTATTGGGGTCAACTGGTTCGACCCCTGG	CARDESGVTMIVVVIGVNWFDPW	IGHV6-1	IGHJ5
TGTGCGAGATACGGGACTACGGTGACTACCCCCCCTAACTACTGG	CARYGTTVTTPPNYW	IGHV4-38-2	IGHJ4
TGTGCTAACCCTTGTGACTACTGTGACTACTGG	CANPCDYCDYW	IGHV3-23	IGHJ4
TGTGCGAGAGATCTTCCCCAATATTGTACTAATGGTGTATGCACCCCCGACCCCTGG	CARDLPQYCTNGVCTPDPW	IGHV3-53	IGHJ5
TGTGCGAGAGGCAAGGAAGAGTACATTACTATGGTTCAGGGAGTTACAAGAGCTTTTGACTACTGG	CARGKEEYITMVQGVTRAFDYW	IGHV3-30	IGHJ4
TGTACCACAGCTGGTTTTGGAGTGGTTATTATACACGTTGGTTGGGGCATTGAAACATACTACTACTACTACATGGACGTCTGG	CTTAGFGVVIIHVGWGIETYYYYYMDVW	IGHV3-15	IGHJ6
TGTGCGAGTCCGGAAGGGGCTTGGGGCCAGTGGCTGGGCCACGTTGGTGACTACTGG	CASPEGAWGQWLGHVGDYW	IGHV7-4-1	IGHJ4
TGTGCGAGAAGGCGGGTAATTACTATGATAGTAGTGGTTATTACTAAAGGAATGAATGACTACTGG	CARRRVITMIVVVITKGMNDYW	IGHV3-20	IGHJ4
TGTGCGAAAGATCGAGGGTATTACGATATTTTGACTGGTTATTTCGACTTTGACTACTGG	CAKDRGYYDILTGYFDFDYW	IGHV3-NL1	IGHJ4
TGTGCGAGAGATATAATTGTAGTGGTGGTAGCTGCTATAGGGTGGTTCGACCCCTGG	CARDIIVVVVAAIGWFDPW	IGHV3-20	IGHJ5
TGTGCGAAAGAGCACGTGGGACGACGGACTACGGTGACTACGAGGGGGGGAGAGTTTGATGCTTTTGATATCTGG	CAKEHVGRRTTVTTRGGEFDAFDIW	IGHV3-NL1	IGHJ3
TGTGCAAGAGATAGGAAAGGTATAACTGGAACGTTTTTTGACTACTGG	CARDRKGITGTFFDYW	IGHV3-13	IGHJ4
TGTGCGAGAGGACCGAGGCCGGGTTGTAGTGGTGGTAGCTGCTACTCGATGACATACTGGTACTTCGATCTCTGG	CARGPRPGCSGGSCYSMTYWYFDLW	IGHV1-69	IGHJ2
TGTGCGACTTCCGTAGATAAATTTGTAATGGATGCTTTTGATATCTGG	CATSVDKFVMDAFDIW	IGHV1-69	IGHJ3
TGTGCATTGTTGACGCTAATGGCCGCGGCTGGTAACCGAGACTACTGG	CALLTLMAAAGNRDYW	IGHV3-30-3	IGHJ4
TGTGCGAGACGCCGATATTACTATGGTTCGGGGAGTTATATTACGTGGCTGTACTACTTTGACTACTGG	CARRRYYYGSGSYITWLYYFDYW	IGHV5-51	IGHJ4
TGTGCGAAAGACTGTACGATTTTTGGAGTGGTTATTACGTACTTTGACTACTGG	CAKDCTIFGVVITYFDYW	IGHV3-NL1	IGHJ4
TGTGCGAGACATGGTATAGCAGTGGCTGGTACCACCTCATCTGCCCTAGTGGGGGACTACTTTGACTACTGG	CARHGIAVAGTTSSALVGDYFDYW	IGHV5-51	IGHJ4
TGTGCGAGAGGGGGGTCAGGCCATTACTTTGACTACTGG	CARGGSGHYFDYW	IGHV1-2	IGHJ4
TGTGCCCCCGGGAGGTTTTGCAGCTCGAGAGGAGTATTTCGCTACTGG	CAPGRFCSSRGVFRYW	IGHV3-30	IGHJ4
TGTGCGAAAGATCTGGCTCTTAGTGGCTGGTACTGGCGGCTCTTTGACTACTGG	CAKDLALSGWYWRLFDYW	IGHV3-23	IGHJ4
TGTGCGAGCCTATTCCCGTCGAGTATAGCAGCTCGTCATCCGGAGTACCGTGGCGACTACTGG	CASLFPSSIAARHPEYRGDYW	IGHV1-3	IGHJ4
TGTGCGAGGCTTCCAGGATCATGGAGAAGTGACTACTGG	CARLPGSWRSDYW	IGHV3-21	IGHJ4
TGTGCGAGAGGAAAGTACTACCCTAGCAGCTCGCAGTACTGG	CARGKYYPSSSQYW	IGHV1-2	IGHJ4
TGTGCGAAAGATCCCCGGGTCCCGAGCTACTACTACTACTACATGGACGTCTGG	CAKDPRVPSYYYYYMDVW	IGHV3-NL1	IGHJ6
TGTGCGAGAGGAAGCCCGCGGAGTGGTTATTCCGCCTCGACAGGAAACTACTACTACTACATGGACGTCTGG	CARGSPRSGYSASTGNYYYYMDVW	IGHV3-20	IGHJ6
TGTGCGAGATTACGATATTTTGACTGGTTATTAGCGTTCGACTACTGG	CARLRYFDWLLAFDYW	IGHV3-64	IGHJ4
TGTGCGAGAGATGCAGGGGCGTATATCCACCTGGCAGCTCGTATTACTTGCTTTGACTACTGG	CARDAGAYIHLAARITCFDYW	IGHV4-59	IGHJ4
TGTGCGAAAGCTGAGGTATTTTGGAGTGGTTATTATACCGGTCTCAACTGGTTCGACCCCTGG	CAKAEVFWSGYYTGLNWFDPW	IGHV3-NL1	IGHJ5
TGTGCAAGCCAGGGGGTAGTTTTTGGAGTGGCCCACTACTACTACTACTACATGGACGTCTGG	CASQGVVFGVAHYYYYYMDVW	IGHV1-45	IGHJ6
TGTGCGAAAGATGCCTGGGATTACTATGATAGTAGTGAACACATTGACTACTGG	CAKDAWDYYDSSEHIDYW	IGHV3-23	IGHJ4
TGTGCGAATCTAGGTAGAAATAGCAGCAGCTGGCCACCTAACTACTGG	CANLGRNSSSWPPNYW	IGHV3-23	IGHJ4
TGTGCGAGAGAGGGGCATATTGTGGTGGTGACTTCACCGGGGGGCGGAGGAAACTGG	CAREGHIVVVTSPGGGGNW	IGHV3-11	IGHJ4
TGTGCGAGAGATCCCAAGGCGGTGACTCCACACGACTACTGG	CARDPKAVTPHDYW	IGHV3-48	IGHJ4
TGTGCGAGACAGGGGCCGAAACCATTTGACTACTGG	CARQGPKPFDYW	IGHV5-51	IGHJ4
TGTGCGAGCTCACTACTAGGTGGACTACAGTACTCCTACTACTACTACATGGACGTCTGG	CASSLLGGLQYSYYYYMDVW	IGHV3-21	IGHJ6
TGTGCGAGAGGTAGGTTCATAGCAGCCGTGTTTGACTACTGG	CARGRFIAAVFDYW	IGHV4-38-2	IGHJ4
TGTGCACACAGACTGATTTTGACTGGTTATTCTAAAGACGCCGGGACATTTTTTTCATACTTCCAGCACTGG	CAHRLILTGYSKDAGTFFSYFQHW	IGHV2-5	IGHJ1
TGTGCGAGAGATCAGATAGCAGTGGCTGCCCTTTTTTTCCGCCTCCGGAGGAACAACTGGTTCGACCCCTGG	CARDQIAVAALFFRLRRNNWFDPW	IGHV3-53	IGHJ5
TGTGCGAAAGATCGGGTGGATACAGCTATGGAGAGTATAATTGACTACTGG	CAKDRVDTAMESIIDYW	IGHV3-NL1	IGHJ4
TGTGCAAGTGCGGGCACAATGACGGTGACTACTAGGTACTACTTTGACTACTGG	CASAGTMTVTTRYYFDYW	IGHV1-45	IGHJ4
TGTGCGAGAGGGGATTATCAGAGGCTTGACTACTGG	CARGDYQRLDYW	IGHV3-21	IGHJ4
TGTGCGAAAGATTTTGTAGGGTTGTACTGGTGGTGTATGCTATATCAGGAACGTCCCAACTGGTTCGACCCCTGG	CAKDFVGLYWWCMLYQERPNWFDPW	IGHV3-23	IGHJ5
TGTGCGAGAAATATAGTGGCTACGATTCTGATAGTCCCATGTGACTACTGG	CARNIVATILIVPCDYW	IGHV4-4	IGHJ4
TGTGCGAGACATGTAGATCGGGATATTGTACTGGTGGTGTATGCTACGGACCGCGGCTGGTTCGACCCCTGG	CARHVDRDIVLVVYATDRGWFDPW	IGHV5-51	IGHJ5
TGTGCGAAAGATGAGGGCGTGACTACACCTGAGCGATCCTACTTTGACTACTGG	CAKDEGVTTPERSYFDYW	IGHV3-NL1	IGHJ4
TGTGCGTCGTTACACTGGTGGTGTATGCTATACATACCCGACTACTACTACTACATGGACGTCTGG	CASLHWWCMLYIPDYYYYMDVW	IGHV1-46	IGHJ6
TGTGCGAGAGCTCCTGGACTGGAGACTTCAAACTACTGG	CARAPGLETSNYW	IGHV3-66	IGHJ4
TGTGCATCGACGTATTACGATTTTTGGAGTGGTTATTATGACTACTACTACTACTACATGGACGTCTGG	CASTYYDFWSGYYDYYYYYMDVW	IGHV1-46	IGHJ6
TGTGCGAGAGGGCGTATAGCAGTGGCAGGTTACCAAATATTTGACTACTGG	CARGRIAVAGYQIFDYW	IGHV1-2	IGHJ4
TGTGCGAGTTTGCGTATTACTATGATAGTAGTGGTTATTACGATCCACTGG	CASLRITMIVVVITIHW	IGHV3-20	IGHJ4
TGTGCGAGAGTAGTACCAGCTGCTATCAAGCATCGTCCTTACTACTACTACTACTACATGGACGTCTGG	CARVVPAAIKHRPYYYYYYMDVW	IGHV3-20	IGHJ6
TGTGCGAGAGCCATTGTACTGGTGGTGTATGCTAGCCCTTGCTATTACTACTACTACTACTACATGGACGTCTGG	CARAIVLVVYASPCYYYYYYYMDVW	IGHV3-53	IGHJ6
TGTGCGAGAGAACCCGGGAAGATAGGTATAGCAGTGGCTGGTGGGGCCCTACCCTACTTTGACTACTGG	CAREPGKIGIAVAGGALPYFDYW	IGHV4-34	IGHJ4
TGTGCGAAACAAGGCACTGCTAGAAACATCGTATTATGGTTCAGGGAGTTATTATGGGACTGGTTCGACCCCTGG	CAKQGTARNIVLWFRELLWDWFDPW	IGHV3-NL1	IGHJ5
TGTGCACGGATATTCCCATATTGTAGTGGTGGTAGCTGCTACTCCTCCTGTCCCAACTGGTTCGACCCCTGG	CARIFPYCSGGSCYSSCPNWFDPW	IGHV2-26	IGHJ5
TGTGCGAGAGGCAGGCCGTATAGCAGCAGCTGGTACGACTACTTTGACTACTGG	CARGRPYSSSWYDYFDYW	IGHV4-34	IGHJ4
TGTGCGAGAGCCCCGGGTTTTAGTGGTGGTAGCTGCCTCGACTGGTTCGACCCCTGG	CARAPGFSGGSCLDWFDPW	IGHV1-8	IGHJ5
TGTGCACACAGGAAGCAGTGGCTGGTACTTCAATCCTCCTGCGGTGAGGTTTCAAGCTTTGACTACTGG	CAHRKQWLVLQSSCGEVSSFDYW	IGHV2-5	IGHJ4
TGTGCGAGAGATGAAATTTTTGGAGTGGAGGGCCGGTACTACTACTACTACTACATGGACGTCTGG	CARDEIFGVEGRYYYYYYMDVW	IGHV4-59	IGHJ6
TGTGCAAAACCACTAATAGCAGTGGCTGGTACTCCGGTTTTGGGTGGCGAATTTCGGCTGGGTTGGCCCAGGTCCTACTGG	CAKPLIAVAGTPVLGGEFRLGWPRSYW	IGHV3-43	IGHJ4
TGTGCGTGGCTCTATAGTGGCTACCCGATCCATCGCGTCCGGCAAGGCTACCCCTTTCTGGTGAAGTTTGACTACTGG	CAWLYSGYPIHRVRQGYPFLVKFDYW	IGHV1-46	IGHJ4
TGTGCGAGTCATATTGTAGTGGGAAAGTACCGGTGCCGCTGGTTCGACCCCTGG	CASHIVVGKYRCRWFDPW	IGHV7-4-1	IGHJ5
TGTGCGAGAGTCGGCACTGGATATTGTACTGGTGGTGTATGCTATACCGTCCTCTACTTTGACTACTGG	CARVGTGYCTGGVCYTVLYFDYW	IGHV4-61	IGHJ4
TGTGCGAGAGGAAGGGTTGACTACTGG	CARGRVDYW	IGHV3-53	IGHJ4
TGTGCGAGAGCCTCTGTGGTTATCCAACCCACAGAAGCCTGGTTCGACCCCTGG	CARASVVIQPTEAWFDPW	IGHV5-10-1	IGHJ5
TGTGCGAGAGAGAAAGCGGACTTTGACTACTGG	CAREKADFDYW	IGHV3-53	IGHJ4
TGTGCACACAGCCCTTCCGGTAGCAGTGGCTGGTACTGGGATCATGACTACTACTACTACTACATGGACGTCTGG	CAHSPSGSSGWYWDHDYYYYYMDVW	IGHV2-5	IGHJ6
TGTGCGAGAGATGGACGGCTTCTTCGGGCCGACTACTGG	CARDGRLLRADYW	IGHV4-59	IGHJ4
TGTGCGAGAGATCTTAATTTGGGTTTAGAATACGGTGACTACGGGATTACCCTGTTTGACTACTGG	CARDLNLGLEYGDYGITLFDYW	IGHV3-20	IGHJ4
TGTGCGAGAGGCATTATTCTCCCCCCCCCATTAGATACCAGTATTACGATTTTTGGAGTGGTTATTATACCAAATGCTTTTGATATCTGG	CARGIILPPPLDTSITIFGVVIIPNAFDIW	IGHV4-34	IGHJ3
TGTGCGAAAGCCGATTTCAGCAGCTGGCTCTTCCAGCACTGG	CAKADFSSWLFQHW	IGHV3-23	IGHJ1
TGTGCGAGAGTCGCCTTATTACGATTTTTGGAGTGGTTATTGGGGATTGACTACTGG	CARVALLRFLEWLLGIDYW	IGHV3-66	IGHJ4
TGTACTAGAGTCTGTGAGAAAGTAGTGGTGGTATTATTACGTCGACGCCGCCCCCTCTTAGCGCCTGGAGGTTACCGAACTGGACCCACGTATTTTGACTACTGG	CTRVCEKVVVVLLRRRRPLLAPGGYRTGPTYFDYW	IGHV3-49	IGHJ4
TGTGCGAGAGATGAGGGCCAGGATATTGTACTAATGGTGTATGCTATGACTTCCCTTGACTACTGG	CARDEGQDIVLMVYAMTSLDYW	IGHV3-53	IGHJ4
TGTACTAGAGTTTCCCTTAGACCGACTTCCGATGCTTTTGATATCTGG	CTRVSLRPTSDAFDIW	IGHV3-49	IGHJ3
TGTAGAGAGGATTTATTACGATATTACTACTTTGACTACTGG	CREDLLRYYYFDYW	IGHV3-15	IGHJ4
TGTGCACACGAGACCGTGGGTGCGGTTCAGGGAGTTGGGGCAAGCTACTACTACTACTACATGGACGTCTGG	CAHETVGAVQGVGASYYYYYMDVW	IGHV2-5	IGHJ6
TGTACCACAGCTCCCGCTGGTGGTGTATGCTATAAACGGACTACTCCGCGGTTGGTAGCGTGGTTCGACCCCTGG	CTTAPAGGVCYKRTTPRLVAWFDPW	IGHV3-15	IGHJ5
TGTGCGAAAGGGAATATGGTTCAGGGCTTTGTTGTGCCCATCCACTTTGACTACTGG	CAKGNMVQGFVVPIHFDYW	IGHV3-23	IGHJ4
TGTACTAGACCGCAGTCGACCCGAGGACTGGAACTTCTTTGTCCTCGTAGTACTGCACGCAACTGGTTCGACCCCTGG	CTRPQSTRGLELLCPRSTARNWFDPW	IGHV3-73	IGHJ5
TGTGCGAAAGACCAGTATTACTATGATAGTAGTGGTTATTACTACCCATCAAGGTTCGACCCCTGG	CAKDQYYYDSSGYYYPSRFDPW	IGHV3-NL1	IGHJ5
TGTGCGGCCGTTGCCCGGGCCCTCCTTCGTCGGGAGTGGGAGCGCCAAGGCCCCATTTGTACCCGCACCAATAATTTTGACTTGATGGAAGAGGACAACTGGTTCGACCCCTGG	CAAVARALLRREWERQGPICTRTNNFDLMEEDNWFDPW	IGHV1-46	IGHJ5
TGTGCGAGAGTATCGATGGTCTGGGGAGGAAGTTACGGGACCCAGCAGCTCTGCGGGTCTGACTACTGG	CARVSMVWGGSYGTQQLCGSDYW	IGHV3-21	IGHJ4
TGTGCGAGAGGGACTAGACTTATTGTAGTAGTACCAGCTGCTATCGGCTGGTTCGACCCCTGG	CARGTRLIVVVPAAIGWFDPW	IGHV4-59	IGHJ5
TGTGCACGGGGTTCGGGCAGTTTCAACTGGTTCGACCCCTGG	CARGSGSFNWFDPW	IGHV2-26	IGHJ5
TGTGCGAGACCCGTTAGCACCGTATTACGATTTTTGGAGTGGTCCCAAATGGACGTCTGG	CARPVSTVLRFLEWSQMDVW	IGHV3-7	IGHJ6
TGTGCGAGAGCCATCGGGTTACGATTTTTGGAGTGGTTATTGAAAGGATCCGACGGATACTTTGGAGGGATTTACTACTACTACATGGACGTCTGG	CARAIGLRFLEWLLKGSDGYFGGIYYYYMDVW	IGHV3-21	IGHJ6
TGTACCACAGATCTGCCGGACGAAGAGATACGATTTTTGGAGTGGTTATTATACCGGTGGGGCCCTAACTGGTTCGACCCCTGG	CTTDLPDEEIRFLEWLLYRWGPNWFDPW	IGHV3-15	IGHJ5
TGTGCGAAGGGTAGCAGCAGCTGGTACAGTGCCTCGGGGAACTACTTTGACTACTGG	CAKGSSSWYSASGNYFDYW	IGHV3-7	IGHJ4
TGTGCGAGACATGACGAATTTCTGACTACGGTGACTATGATGTGCTTGGACTACTGG	CARHDEFLTTVTMMCLDYW	IGHV4-39	IGHJ4
TGTGCGAAAACCGTATTGATTACATTTGGGGGAGTTATCGTTACCTTTGACTACTGG	CAKTVLITFGGVIVTFDYW	IGHV3-23	IGHJ4
TGTGCAAGAGTCCCTCTTCACGGAGAATGGCGGTGTGTCGGGTCCCCCGGAGTCAAGGTAAGCCAGAGAGCAGTGGCTGGTAGAGAAGACTGGTTCGACCCCTGG	CARVPLHGEWRCVGSPGVKVSQRAVAGREDWFDPW	IGHV1-45	IGHJ5
TGTGCGGCCTGCTCCTCAATATTGTACTGGTGGTGTATGCGAAGCGTTGACTACTGG	CAACSSILYWWCMRSVDYW	IGHV1-58	IGHJ4
