TGTGCGAGAGGGCCGTCGTATTACTATGGTTCAGGGAGTTATTATAACCTTTTCTGGCAAGATCGACAATTGGTGAACTGGTTCGACCCCTGG	CARGPSYYYGSGSYYNLFWQDRQLVNWFDPW	IGHV5-10-1	IGHJ5
TGTACCACAGATGGGATTACGATTTTTGGAGTGGTTATTGGCACCTTTGCTTTTGATATCTGG	CTTDGITIFGVVIGTFAFDIW	IGHV3-15	IGHJ3
TGTGCGAGAGGATTCCCCAAGTACCAGCTGCCCCGATTAGTGTGTAACTGGTTCGACCCCTGG	CARGFPKYQLPRLVCNWFDPW	IGHV3-30	IGHJ5
TGTGCGAAAGATCACACCGATATTGTAGTGGTGGTAGCTGCCCCTGACACCTGGTTCGACCCCTGG	CAKDHTDIVVVVAAPDTWFDPW	IGHV3-NL1	IGHJ5
TGTGCGAATAGGTACGACATTTTTGGCTGGTACCTTTACTACTGG	CANRYDIFGWYLYYW	IGHV3-23	IGHJ4
TGTGCGAAAGGGACCGATGGCTTTACGATTTTTGGAGTGGTTACCATGTACTACTTTGACTACTGG	CAKGTDGFTIFGVVTMYYFDYW	IGHV3-23	IGHJ4
TGTGTACCGGCGCCCCGTAAGGGAGGGCCCCAATATTGTAGTAGTACCAGCTGCTATGGAGGCTACTACTACTACTACATGGACGTCTGG	CVPAPRKGGPQYCSSTSCYGGYYYYYMDVW	IGHV7-4-1	IGHJ6
TGTGCGAGAGCAGATATTGTAGTAGTACCAGCTGCTAAACAAGCTAACTGGTTCGACCCCTGG	CARADIVVVPAAKQANWFDPW	IGHV4-38-2	IGHJ5
TGTGCGAGAGATCGCCATCCGAAACCCCTATGGTTCAGGGACAGCTACTACTACTACATGGACGTCTGG	CARDRHPKPLWFRDSYYYYMDVW	IGHV3-53	IGHJ6
TGTGCGAGAGGAGGGCCAGACTACGGTGACTACTGTAGGCTGGGCCGATACTACTACTACTACTACATGGACGTCTGG	CARGGPDYGDYCRLGRYYYYYYMDVW	IGHV3-53	IGHJ6
TGTACCACAGTGACCTCTATTGTACTACGTGTTACCTACTGG	CTTVTSIVLRVTYW	IGHV3-15	IGHJ4
TGTGCGAGAGGGCGATTTTTGGAGTGGTGCCCTAATCAAGGGAGCCCCTACTACTACTACTACATGGACGTCTGG	CARGRFLEWCPNQGSPYYYYYMDVW	IGHV3-48	IGHJ6
TGTGCGAAATATTGTGGCTGGTACGGCTACTACTTTGACTACTGG	CAKYCGWYGYYFDYW	IGHV3-NL1	IGHJ4
TGTGCAACAGCGGAGATGAGGAGATGTATAGCAGCTCGTGTCGGGACCGCTTTTAACTGGTTCGACCCCTGG	CATAEMRRCIAARVGTAFNWFDPW	IGHV1-24	IGHJ5
TGTGCGAGCGGGGGAGTCCTAGCGATCGCGCTTCAGGAGGGGTTAGCCTGG	CASGGVLAIALQEGLAW	IGHV4-59	IGHJ4
TGTGCGAGAGGCCCGGCCCCCCCTATAGCAGTGGTTAGGGACTACTACTACTTTGACTACTGG	CARGPAPPIAVVRDYYYFDYW	IGHV4-34	IGHJ4
TGTGCGAGAGATAGGAACCACCCTTCGTTTGACTACTGG	CARDRNHPSFDYW	IGHV7-4-1	IGHJ4
TGTGCGAGTGGCTTGAGCTTTAGACGCTGG	CASGLSFRRW	IGHV4-61	IGHJ4
TGTGCGACGGTGGCTACGTTTCTCCAGCACTGG	CATVATFLQHW	IGHV5-10-1	IGHJ1
TGTGCGAGGATACCTGGGGAGGATATTGTAGTGGTGGTAGCTGCTACCCTCTACTACATGGACGTCTGG	CARIPGEDIVVVVAATLYYMDVW	IGHV1-69	IGHJ6
TGTACCGCCCTTAGTCGTTCCGGGATGGGTATTACGATTTTTGGAGTGGTTATGCCCCCCTACCCGGAGTACTGGTTCGACCCCTGG	CTALSRSGMGITIFGVVMPPYPEYWFDPW	IGHV3-9	IGHJ5
TGTACCACAGTGGCACGGGCCCGGAGTCAGATAGCAGTGGCTGGTAAAGATGCTTTTGATATCTGG	CTTVARARSQIAVAGKDAFDIW	IGHV3-15	IGHJ3
TGTGCGAAAGCGAAGGGGATAGTAGTGGTTACACATAACTTTGACTACTGG	CAKAKGIVVVTHNFDYW	IGHV3-NL1	IGHJ4
TGTGCGATTCCGCCTATAACTGGAACGACCTTATGGGGTGACTACTGG	CAIPPITGTTLWGDYW	IGHV3-30	IGHJ4
TGTGCGAGAGGGTTAGACAGTGCTCACGTGGCTGGTACCGCTTTTCATGCTTTTGATATCTGG	CARGLDSAHVAGTAFHAFDIW	IGHV1-69	IGHJ3
TGTGCGAGAGAGTGCCGATCTGAGTACTACTTTGACTACTGG	CARECRSEYYFDYW	IGHV3-11	IGHJ4
TGTGCGAAAAGGATGGAGGAAGAGGATATTGTAGTGGTGGTAGCTGCTGCTGTGCATAGGATTTACTACATGGACGTCTGG	CAKRMEEEDIVVVVAAAVHRIYYMDVW	IGHV3-23	IGHJ6
TGTGCGAGAATACTAAAATCCGGGTATAGCAGTGGCTGGTACCTTGCTTTTGATATCTGG	CARILKSGYSSGWYLAFDIW	IGHV7-4-1	IGHJ3
TGTGCGAGAGCGGGCGTTCCGCAGTGGCTGGTACACGTTGACTACTGG	CARAGVPQWLVHVDYW	IGHV3-7	IGHJ4
TGTGCGAAATCTGATATTGTAGTGGTGGTAGCTGCTACTCGATGGGGGTCGGGTTGGTTCGACCCCTGG	CAKSDIVVVVAATRWGSGWFDPW	IGHV3-23	IGHJ5
TGTGCGAAAGATCCAGGGTATAGCAGTGGCTGGGGGTTTGACTACTGG	CAKDPGYSSGWGFDYW	IGHV3-23	IGHJ4
TGTGCGAGACTCCGTTCCTACATGGACGTCTGG	CARLRSYMDVW	IGHV5-51	IGHJ6
TGTGCGAGAATTACCGTGGTGGTAGCTGCTACTCCTATGGACGTCTGG	CARITVVVAATPMDVW	IGHV3-53	IGHJ6
TGTGCGAGAGATCCCAGTTTCCGAAGTCCTTGGGAGTTATCGTTATTATTGGGTGAGAGGGCTCTAGTTCGCGGGCTTGACTACTGG	CARDPSFRSPWELSLLLGERALVRGLDYW	IGHV3-30	IGHJ4
TGTGCGAAAGATTGCTGGGGTATAGCAGCCTTGTACTACTTTGACTACTGG	CAKDCWGIAALYYFDYW	IGHV3-NL1	IGHJ4
TGTGCGAGAAGATCCGTAGCAGTGGCTGGGGGTCCAGCCCCCCGGCGTCCCTACTACTACTACTACATGGACGTCTGG	CARRSVAVAGGPAPRRPYYYYYMDVW	IGHV7-4-1	IGHJ6
TGTGCGAGAGAGTTTGGCGTGGCTACGATTTTGGGCCGGAACTGGTACTTCGATCTCTGG	CAREFGVATILGRNWYFDLW	IGHV4-59	IGHJ2
TGTGCGAGAGAATTGTTGATTGTACTGGTGGTGTATGCTATGGCGCAGCGGGTAGCCGGGGTCTCACCCTACTACTACTACTACATGGACGTCTGG	CARELLIVLVVYAMAQRVAGVSPYYYYYMDVW	IGHV3-64	IGHJ6
TGTGCAAGAAATTTGACCAAGGATATTGTACTGGTGGTGTATGCTATCTCGGTATTGGGTGTGTGGTACTACTACTACATGGACGTCTGG	CARNLTKDIVLVVYAISVLGVWYYYYMDVW	IGHV1-45	IGHJ6
TGTAGCAGGGACTATTGTAGTGGTGGTAGCTGCTACTGTTCGCGAGCCTACTGGAAGGGTTACTTTGACTACTGG	CSRDYCSGGSCYCSRAYWKGYFDYW	IGHV3-30-3	IGHJ4
TGTGCGAGAGATTGGTTCCGCCTCATTCCCAGTATTACTATGGTTCAGGGATTTGACTACTGG	CARDWFRLIPSITMVQGFDYW	IGHV1-2	IGHJ4
TGTGCGAGACGCTCCCGGAGGCGATATTGTAGTAGTACCAGCTGCTATGTGGGGGTACCCTACTACTACTACTACTACATGGACGTCTGG	CARRSRRRYCSSTSCYVGVPYYYYYYMDVW	IGHV5-51	IGHJ6
TGTGCGAACGATTCCAGAGTGCTAGGGCCGGGTATAGCAGTGGCTGGTTCGCCCTACTGG	CANDSRVLGPGIAVAGSPYW	IGHV3-NL1	IGHJ4
TGTGCGACTGGCTCCATAGCAGTTTTCTACTGG	CATGSIAVFYW	IGHV3-11	IGHJ4
TGTGCGAGAGATCCGTATTTTTTAGATCTGACTTATTACTATGATAGTAGTGGTTATGCAGACTACTTTGACTACTGG	CARDPYFLDLTYYYDSSGYADYFDYW	IGHV3-53	IGHJ4
TGTGCGAGAGATGCGGTAAAGTGGGTGACTATTGTAGTAGTACCAGCTGCTATGAGTAACTACTTTGACTACTGG	CARDAVKWVTIVVVPAAMSNYFDYW	IGHV1-2	IGHJ4
TGTACTAGAAGTATCGCGTATTACTATGATAGTAGTGGGGGGCGATTTGACTACTGG	CTRSIAYYYDSSGGRFDYW	IGHV3-73	IGHJ4
TGTGCGTTTTGGCGCGAAGCGCTGGTAGTACCAGCTGCTATGCTTGACTACTGG	CAFWREALVVPAAMLDYW	IGHV5-51	IGHJ4
TGTGCGAAAGACGCCCGGATGGTATTACGATTTTTGGAGTGGTTATCCGGCTACTTTGACTACTGG	CAKDARMVLRFLEWLSGYFDYW	IGHV3-23	IGHJ4
TGTGCGAGAGCAGACTTAGTGGGAGCTATAGACTACTGG	CARADLVGAIDYW	IGHV3-53	IGHJ4
TGTGCGAGGGAGAATGCCGGAGGCAATACTACGGTGACTACGAGGCGCAAGAGGGGGAGCTTTGACTACTGG	CARENAGGNTTVTTRRKRGSFDYW	IGHV3-7	IGHJ4
TGTGCGAAAGATCCAAGGTCACTCCTCTGGTTCGACCCCTGG	CAKDPRSLLWFDPW	IGHV3-NL1	IGHJ5
TGTGCGAGAGATGCAGCAGCTCGTCCTCCTCGCTTCTGGTTCGACCCCTGG	CARDAAARPPRFWFDPW	IGHV3-20	IGHJ5
TGTGGCCGGTATTACGATTTTTGGCTGTACTACTACTACTACATGGACGTCTGG	CGRYYDFWLYYYYYMDVW	IGHV3-30	IGHJ6
TGTGCGAGATGCAAGGAGGGTGTATTGGAGTGGTTGAATAGGGACTACTACTACTACATGGACGTCTGG	CARCKEGVLEWLNRDYYYYMDVW	IGHV1-69	IGHJ6
TGTGCGAGAGGTCTCCTGGGTATAGCAGCAGCTGGTACGCCAGAGCCCTGGTTCGACCCCTGG	CARGLLGIAAAGTPEPWFDPW	IGHV3-21	IGHJ5
TGTGCGAAAGCCATTGACTACAGTAAGCGCTACTTTGACTACTGG	CAKAIDYSKRYFDYW	IGHV3-23	IGHJ4
TGTGCGAAAGATGGAAATGTACTAATGGTGTATGCTATAATTTCCAGGTTCGACCCCTGG	CAKDGNVLMVYAIISRFDPW	IGHV3-23	IGHJ5
TGTGCGAGAGTAATGTTGGCCGGGATGACTACGGTGACTAAGCGGGGGCGCCCCAACTACTACTACTACATGGACGTCTGG	CARVMLAGMTTVTKRGRPNYYYYMDVW	IGHV3-66	IGHJ6
TGTGCGAGAGACCACTCTTGTTCCCCCCCAATTGTAGTGGTGGTAGCTGCTACTCGAAAGGGTTACTACTACTACTACATGGACGTCTGG	CARDHSCSPPIVVVVAATRKGYYYYYMDVW	IGHV4-59	IGHJ6
TGTGCGATAACCCGTCTACGCTACTGG	CAITRLRYW	IGHV7-4-1	IGHJ4
TGTGCGAGATGGTGGGAGGCTAAGAGCAGTGGCTGGTACTCTGGGAACTTTGACTACTGG	CARWWEAKSSGWYSGNFDYW	IGHV4-38-2	IGHJ4
TGTGCGAGGTACTGTAAAGCGTGTCCTAACCGGAACCATATCAAAGCTATTGAGAAAAGTGACTACTGG	CARYCKACPNRNHIKAIEKSDYW	IGHV1-69	IGHJ4
TGTACTAGGGGGAATTACGATTTTTGGAGTGGTTATTATACTCCCCGCTTTCCAGGGCCATGG	CTRGNYDFWSGYYTPRFPGPW	IGHV3-49	IGHJ4
TGTGCGAGAGATACGTATTACTATGATAGTAGTGGTTATTGCGGTGCGGCCCCACCCGACTACTGG	CARDTYYYDSSGYCGAAPPDYW	IGHV3-48	IGHJ4
TGTGCGAGAACCCAGGGGGGTAGTGGTGGTAGCTGCTACTCCGCCTTTAGAGGCTGGTTCGACCCCTGG	CARTQGGSGGSCYSAFRGWFDPW	IGHV4-34	IGHJ5
TGTGCGAGAGTCCGGGGGTTTTACTATGGTTCAGGGAGTTACAACTGGTTCGACCCCTGG	CARVRGFYYGSGSYNWFDPW	IGHV4-34	IGHJ5
TGTGCCGAAACGTCGATTGTAGTAGTACCAGCTGCCTACTTTTTCTACTGG	CAETSIVVVPAAYFFYW	IGHV4-59	IGHJ4
TGTGCGAAAGATGGCCCCCGCCTAGTGGTGGTAGCTGCCAGCGCCCCCTACTGGTTCGACCCCTGG	CAKDGPRLVVVAASAPYWFDPW	IGHV3-NL1	IGHJ5
TGTGCGAAAGCCCGGAACATTGTTCCTTCCCGGGGAACCGTCATATACAACTGGTTCGACCCCTGG	CAKARNIVPSRGTVIYNWFDPW	IGHV3-23	IGHJ5
TGTGCACGGATATTGGGCGATTTTTGGAGTGGTTATTATTTAATGATATCGGTGCCTGATTTCTACTGG	CARILGDFWSGYYLMISVPDFYW	IGHV2-70	IGHJ4
TGTGCGAGAGATCGGTTTTGGAGTGGTGCCGTATCCTACTACTACTACTACATGGACGTCTGG	CARDRFWSGAVSYYYYYMDVW	IGHV3-53	IGHJ6
TGTGCACGGGGGCCCGGACTAGGTTGTAGTGGTGGTAGCTGCTACTACGGCCCAAACTACATGGACGTCTGG	CARGPGLGCSGGSCYYGPNYMDVW	IGHV2-26	IGHJ6
TGTGCGAGAGATAGAGATATTTTGACTGGTTCCCCGTACTACTACTACTACATGGACGTCTGG	CARDRDILTGSPYYYYYMDVW	IGHV4-59	IGHJ6
TGTGCGAAAGATCGGCCGGAGAGTTCTATTGTAGTAGTACCAGCTGCTATCTGGCTAAATTGCCATGATGCTTTTGATATCTGG	CAKDRPESSIVVVPAAIWLNCHDAFDIW	IGHV3-NL1	IGHJ3
TGTGCGAGAGTTCCGAGCAGCTCGTCCGAGATTGACTACTGG	CARVPSSSSEIDYW	IGHV3-20	IGHJ4
TGTGCGAGAGGCGACGAGTATTGTAGTAGTACCAGCTGGCGAGAATTTGACTACTGG	CARGDEYCSSTSWREFDYW	IGHV4-34	IGHJ4
TGTGCGAGATGTATTACGATTTTTGGAGTGGTTATTGATGCTTTTGATATCTGG	CARCITIFGVVIDAFDIW	IGHV5-10-1	IGHJ3
TGTGCGAGAGAGAGGCTAGAACTGGAACGACATGCTTTTGATATCTGG	CARERLELERHAFDIW	IGHV4-59	IGHJ3
TGTGCACGGGATTTTTGGAGTGGTCGGTTGTACGGTGGCTACTACTACTACTACATGGACGTCTGG	CARDFWSGRLYGGYYYYYMDVW	IGHV2-26	IGHJ6
TGTGCGAGATCGCTGCCATATTGTGGTGGTGTCCCTTGG	CARSLPYCGGVPW	IGHV3-20	IGHJ4
TGTGCAAAAGATATTATTTCCCAGCAGCAGCTGGTACGTTGGTTCGACCCCTGG	CAKDIISQQQLVRWFDPW	IGHV3-43	IGHJ5
TGTGCGAGATCTACCAGCTGCGGTGGGGGGATCCACTACTACTACTACATGGACGTCTGG	CARSTSCGGGIHYYYYMDVW	IGHV7-4-1	IGHJ6
TGTACCGAGGGACCCTTCGGAACGTATTACGATTTTTGGAGTGGTCGCGCCCGGTGCTACTACTACTACTACATGGACGTCTGG	CTEGPFGTYYDFWSGRARCYYYYYMDVW	IGHV3-15	IGHJ6
TGTGCGAGAGATGGGAACCTTGTAGTGGTGGTAGCTGCTACTCCCCGACACAACTGGTTCGACCCCTGG	CARDGNLVVVVAATPRHNWFDPW	IGHV3-53	IGHJ5
TGTGCGAGACTACCGGGTAGGACTACAGTAACTACGTGTGACTACTACTACTACTACATGGACGTCTGG	CARLPGRTTVTTCDYYYYYMDVW	IGHV1-2	IGHJ6
TGTGCGAGAGAGGTCATAGTGGCTACGATTGTTGACTACTGG	CAREVIVATIVDYW	IGHV4-34	IGHJ4
TGTGCGAGACCGTGGACATTGTCGATGGTGTATGCTATTCACAACTGGTTCGACCCCTGG	CARPWTLSMVYAIHNWFDPW	IGHV4-4	IGHJ5
TGTGCGAAACCGGGGGGTCTACCAGCTGCTATGGGCTACTACTACTACATGGACGTCTGG	CAKPGGLPAAMGYYYYMDVW	IGHV3-NL1	IGHJ6
TGTGCAAGGCCTACTTCGGGGAGTTATGTGGATGTGAAGTTTGCTTGG	CARPTSGSYVDVKFAW	IGHV1-24	IGHJ5
TGTGCGAGAACACCCCATATTGTGGTGGTGACTGCTATCGTGAAATCTATTGCCGGTGATATCTGG	CARTPHIVVVTAIVKSIAGDIW	IGHV3-53	IGHJ3
TGTGCGAGAGACGTGATAGTAGTGGTTATTGAATACTTCCAGCACTGG	CARDVIVVVIEYFQHW	IGHV4-34	IGHJ1
TGTGCGAAAGGCTCGCCGTACATTTGGGGGAGTTATCGCAATTGGAAGTGTACCGAATACTTCCAGCACTGG	CAKGSPYIWGSYRNWKCTEYFQHW	IGHV3-NL1	IGHJ1
TGTGCGAGACCGAGGGGGCTATGCCGAACTGGAACGACGTCGTTCCCCGGCTGGTTCGACCCCTGG	CARPRGLCRTGTTSFPGWFDPW	IGHV4-39	IGHJ5
TGTGCGAGACGGAGTGTGCAAGAATTGAACGTAGTACCCTACTACTACTACTACATGGACGTCTGG	CARRSVQELNVVPYYYYYMDVW	IGHV5-51	IGHJ6
TGTGCACGGGAGTATAGCAGCTCGTCAGACAACTACTTTGACTACTGG	CAREYSSSSDNYFDYW	IGHV2-70	IGHJ4
TGTGCGAGACATATCCTGGTGAGAACTATCAGTAGTGGTTATTACGGGGGGGGAAATGACTACTGG	CARHILVRTISSGYYGGGNDYW	IGHV4-39	IGHJ4
TGTACCACTGCACCCTTACCCAGTACGATTTTTGGAGTGGTTATTATATGGGACTACTACTACTACTACATGGACGTCTGG	CTTAPLPSTIFGVVIIWDYYYYYMDVW	IGHV3-15	IGHJ6
TGTGCGAGACGCGAGTTAACCTCGCACCATATAGGATATTGTAGTGGTGGTAGCTGCTACTCCTTGGCTAACCGGTCTAATGCTTTTGATATCTGG	CARRELTSHHIGYCSGGSCYSLANRSNAFDIW	IGHV5-10-1	IGHJ3
TGTGCGAAACTGGGATGTCCCGTAGTACCAGCTGCTATTATTACCTACTGGTACTTCGATCTCTGG	CAKLGCPVVPAAIITYWYFDLW	IGHV3-23	IGHJ2
