TGTGCGTGCCAAAGCCAGCGAGTGGTTATAAGGAAGATTCAGGCTTCCTACCCGAACTGGTTCGACCCCTGG	CACQSQRVVIRKIQASYPNWFDPW	IGHV3-66	IGHJ5
TGTGCGAAAGAATGGGAGATGTATTATTGTAGTAGTACCAGCTGCGGTACATTGGGGGGGTCAGGGGAAAAAACCTTTGACTACTGG	CAKEWEMYYCSSTSCGTLGGSGEKTFDYW	IGHV3-23	IGHJ4
TGTGCGAAAGACCGTGATAGTAGTGGTTATGTTTCCGGGCATGATGCTTTTGATATCTGG	CAKDRDSSGYVSGHDAFDIW	IGHV3-NL1	IGHJ3
TGTGCGAAACAAATACTGGAACGACACTACTTTGACTACTGG	CAKQILERHYFDYW	IGHV3-NL1	IGHJ4
TGTGCGAGAGGTAATGGGGGGCACCCGGTATTACTATGGTTCAGGGAGCGCAACCTTGACTACTGG	CARGNGGHPVLLWFRERNLDYW	IGHV3-30	IGHJ4
TGTGCGGTCCCGTTTTTGAGTATAGCAGTGGCTGGTGGGCGACGAGGGTGGGACCCCTGG	CAVPFLSIAVAGGRRGWDPW	IGHV2-70	IGHJ5
TGTGCGAGAGATCGGCTGCAAACTGGAACTACGAGCTGGTTCGACCCCTGG	CARDRLQTGTTSWFDPW	IGHV3-53	IGHJ5
TGTGGTTTTATGATTACATTTGGGGGAGTTATCGTTACACTGAGCACGAAGTTTGACTACTGG	CGFMITFGGVIVTLSTKFDYW	IGHV3-30	IGHJ4
TGTGCGAAAGGCCAACTCGGGGGATACAGCTATGGTTTATTGGGTTTCATGCGGTACCTGCTACCCCCCAACTGGTTCGACCCCTGG	CAKGQLGGYSYGLLGFMRYLLPPNWFDPW	IGHV3-23	IGHJ5
TGTGCGAGACTGGTTGACTGGTCCCTCATTGACTACTGG	CARLVDWSLIDYW	IGHV5-51	IGHJ4
TGTGCGAGGGCCACCCGGAAGGATATTGTAGTAGTACCAGCTGCTAAGAACTGGTTCGACCCCTGG	CARATRKDIVVVPAAKNWFDPW	IGHV1-46	IGHJ5
TGTGCGAGAGAACCTGACCCCTATTACTATGATAGTAGTGGTTATTACTACCGCTTTGACTACTGG	CAREPDPYYYDSSGYYYRFDYW	IGHV3-7	IGHJ4
TGTGCGAAAGATCAAAGGAGTTCCCAGGGAAGGCACCTTTACTACTTTGACTACTGG	CAKDQRSSQGRHLYYFDYW	IGHV3-NL1	IGHJ4
TGTGCGAGAGATTTCCTGCCAAGGCAGGGGGCCCATTACGATATTTTGACTGGACTAAAGGACTTTGACTACTGG	CARDFLPRQGAHYDILTGLKDFDYW	IGHV3-7	IGHJ4
TGTACTAGACGCGTGGACCCTACTGGTGGTGTATGCCGTTTAAGCTACTGG	CTRRVDPTGGVCRLSYW	IGHV3-73	IGHJ4
TGTGCGAAAGCTTTCTACGGTGACTACGGTACTTACCATCTATTCTGGTTCGACCCCTGG	CAKAFYGDYGTYHLFWFDPW	IGHV3-23	IGHJ5
TGTGCGAGAAGGGAGCCGTTTGACTACTGG	CARREPFDYW	IGHV7-4-1	IGHJ4
TGTGCACGGATACGTACCGGGTATAGCAGCAGCTGGTGGACCTACCAGGGGCGGTACTTTGACTACTGG	CARIRTGYSSSWWTYQGRYFDYW	IGHV2-26	IGHJ4
TGTACCACAGGGAACCCAAAGGATACAGCTATGGTTCACTACTGG	CTTGNPKDTAMVHYW	IGHV3-15	IGHJ4
TGTACCTCTAGTGGCGCGATTTTTGGAGTGGTTATCTATAACAGTGACTACTGG	CTSSGAIFGVVIYNSDYW	IGHV3-15	IGHJ4
TGTGCGAGAACCCATTACTATGGTTCAGGGAGAACCTACTACATGGACGTCTGG	CARTHYYGSGRTYYMDVW	IGHV1-69	IGHJ6
TGTGCACGGACCAATGACTACGGTGACGGCCGCTACTTTGACTACTGG	CARTNDYGDGRYFDYW	IGHV2-26	IGHJ4
TGTGCGAGACATCAATCCGACAGCTATGCACCCTACTGG	CARHQSDSYAPYW	IGHV5-51	IGHJ4
TGTACCCAGGGTCGTATTGTAGTGGTGGTAGTTGACTACTGG	CTQGRIVVVVVDYW	IGHV3-49	IGHJ4
TGTGCGAGGATGGTTGTACTGGTGGTGTATGCTATTTACTACTACATGGACGTCTGG	CARMVVLVVYAIYYYMDVW	IGHV5-51	IGHJ6
TGTGCGAGAGAATTTGATTACATTTGGGGGAGTTATCGGAACGGCTACTTTGACTACTGG	CAREFDYIWGSYRNGYFDYW	IGHV1-2	IGHJ4
TGTGCGAAACAGGAATCGGTCCCTTGTAGTAGTACCAGCTGCTATATTCGGTTTGACTACTGG	CAKQESVPCSSTSCYIRFDYW	IGHV3-NL1	IGHJ4
TGTGCGACGTGTATAGTGGCTACGACAGACTACTGG	CATCIVATTDYW	IGHV3-30-3	IGHJ4
TGTGCGGGCCCCGGAAGGTGTAGTACCAGCTGCTTCCGCCTGGACTTTGACTACTGG	CAGPGRCSTSCFRLDFDYW	IGHV3-53	IGHJ4
TGTGCGAGAGCCCTAAATGACTACTGG	CARALNDYW	IGHV1-3	IGHJ4
TGTGCGAGCCTGGGGGTAGCAGCTCGTCACCGGGCCCCGGACTACTACTACTACTACATGGACGTCTGG	CASLGVAARHRAPDYYYYYMDVW	IGHV1-46	IGHJ6
TGTGCGATGTCCCAGCTCGTCCAGGCTTTTGATATCTGG	CAMSQLVQAFDIW	IGHV3-30	IGHJ3
TGTGCGTTTATTTTGACTGGTTATTTTGTGACTGACTACTGG	CAFILTGYFVTDYW	IGHV3-NL1	IGHJ4
TGTGCGAAAGATCCGCGGTATAGTGGGACGTCGTCAATTTCTGACTACTGG	CAKDPRYSGTSSISDYW	IGHV3-23	IGHJ4
TGTCTCCGCAAGAAAGTTGACTACGACTTCGGGGTTTCCTTCTACTGG	CLRKKVDYDFGVSFYW	IGHV3-30-3	IGHJ4
TGTGCGAGAGATAGAGGGGCCCTGGCGTATTACTATGGTTCGGGGAGTTATATTTCGGGCCACTTTGACTACTGG	CARDRGALAYYYGSGSYISGHFDYW	IGHV3-7	IGHJ4
TGTGCGAGTCCGGATATTGTAGTAGTACCAGCTGCTGGGTACTACTTTGACTACTGG	CASPDIVVVPAAGYYFDYW	IGHV4-34	IGHJ4
TGTACTAGAGATTCATCGGCGGGTATAGCAGTGGCTGATAGGTACTGG	CTRDSSAGIAVADRYW	IGHV3-49	IGHJ4
TGTGCGAGAGATTGTGAGGAGCAGTGGGCCTGG	CARDCEEQWAW	IGHV3-53	IGHJ4
TGTGCGAGAGGGGGAACCTCCCCTTACGATATTTTGACTGGTTATTATACCCGAGTAGACGGGTACTACTACTACTACTACATGGACGTCTGG	CARGGTSPYDILTGYYTRVDGYYYYYYMDVW	IGHV4-59	IGHJ6
TGTACCACGGTCGGGGGTTTTGGAGTGGTTATTATAACCCCCCAATACTACTACTACTACATGGACGTCTGG	CTTVGGFGVVIITPQYYYYYMDVW	IGHV3-15	IGHJ6
TGTGCGACTGAAACAAGCCAAATGTGGGAGCTACAGTGCCGACACTGGTTCGACCCCTGG	CATETSQMWELQCRHWFDPW	IGHV3-30-3	IGHJ5
TGTGCGAGAGATCATATTGTAGTAGTACCAGCTAGGCGGAACTGGTTCGACCCCTGG	CARDHIVVVPARRNWFDPW	IGHV3-7	IGHJ5
TGTGCGAGAAGCAGCTCCAGTTTCCGATTATTCGTACAGGGATATTGTAGTAGTACCAGCTGCTATGCGTACTTTGACTACTGG	CARSSSSFRLFVQGYCSSTSCYAYFDYW	IGHV4-61	IGHJ4
TGTGCGAGACATGCCGAATTAGTGGTGGTAGCTGCTATGGGCGGCAAATACTGG	CARHAELVVVAAMGGKYW	IGHV5-51	IGHJ4
TGTGCGAGAGGCCTATCGCGGGTGGGTCAGATTGTAGTAGTACCAGCTGCTATGACCCGTCTGGGTGACTACTGG	CARGLSRVGQIVVVPAAMTRLGDYW	IGHV4-34	IGHJ4
TGTGCGAGAGAAGGGCCTGGTAGTCCTATTGTAGTGGTGGTAGCTGCTAAAGCGAACTTTGACTACTGG	CAREGPGSPIVVVVAAKANFDYW	IGHV4-34	IGHJ4
TGTACCACGGGCTGCGTATTACGATTTTTGGAGTGGTTATTATTAACCGCCTACTACTACTACTACATGGACGTCTGG	CTTGCVLRFLEWLLLTAYYYYYMDVW	IGHV3-15	IGHJ6
TGTACCACCCTTCTACGTAGCGTTTTTGACTACTGG	CTTLLRSVFDYW	IGHV3-15	IGHJ4
TGTGCGAGAGATATGGGATATTGTAGTAGTACCAGACAAGGATACAACTGGTTCGACCCCTGG	CARDMGYCSSTRQGYNWFDPW	IGHV1-2	IGHJ5
TGTGCGAGATCTGACGTGCCCGGGGCGCTCCTCCGTAGTACCAGCTGCTACAACAGGGGGATGGTCCCTGACTACTGG	CARSDVPGALLRSTSCYNRGMVPDYW	IGHV1-3	IGHJ4
TGTGCGAGAGATTGTTGTGATGACTACGGTGACTATCATTTTGGATCCCGGAAAAGGGATCCTGAGCCAGGACCACCCTTAGACTACTGG	CARDCCDDYGDYHFGSRKRDPEPGPPLDYW	IGHV1-2	IGHJ4
TGTGCTAGAGATGGCCTAACTGGAACGACGCGGTTCATTGACTACTGG	CARDGLTGTTRFIDYW	IGHV3-72	IGHJ4
TGTGCGAGAGATCGGGGTTTCGGAAGGACCCGCCTCCATTGGGATATTGTAGTGGTGGTAGCTGCCGGGTATAGCAACCAGTCAATGACAACCCTCGGTCCCCGGCTTACCTCCAGCCCCGGGCACTGG	CARDRGFGRTRLHWDIVVVVAAGYSNQSMTTLGPRLTSSPGHW	IGHV3-66	IGHJ4
TGTGCAAAAGATATGATGGCCCTCGGTGGTGGTAGCTGCTACTCGTTTAATTGGTTCGACCCCTGG	CAKDMMALGGGSCYSFNWFDPW	IGHV3-43D	IGHJ5
TGTGCGAGAGTTCCCCTGTATAGCAGTGGCTGGGACCATTGGCGGCCTTTTGACTACTGG	CARVPLYSSGWDHWRPFDYW	IGHV1-3	IGHJ4
TGTGCAAGAGATCCGAAAGATATTGTAGTAGTACCAGCTGCTATGAAGAGATTTATTACATATTACTACTACTACTACTACATGGACGTCTGG	CARDPKDIVVVPAAMKRFITYYYYYYYMDVW	IGHV3-13	IGHJ6
TGTGCTAGAGACCCGGCCGATGGCTACACGTGTCCGCGGGACTACTGG	CARDPADGYTCPRDYW	IGHV3-72	IGHJ4
TGTGCGAGAGATCTCATCCGGGTGGCTGCTCACCCCTACTTTGACTACTGG	CARDLIRVAAHPYFDYW	IGHV3-53	IGHJ4
TGTACCACAGGCCGTACGATTTTTGGAGTGGTTATTAATTTTGACTACTGG	CTTGRTIFGVVINFDYW	IGHV3-15	IGHJ4
TGTGCGAGACTTGGTGGCCTACTATGGTTCAGGGAGTTATTAGTACGGTACTACATGGACGTCTGG	CARLGGLLWFRELLVRYYMDVW	IGHV3-66	IGHJ6
TGTGCGAAGCTGGAACTACGTCGTGTAGTTGATGACTACTGG	CAKLELRRVVDDYW	IGHV4-38-2	IGHJ4
TGTGCGAGACATGGGGGCGTGGAACACCCCCTATTACTATGGTTCGGGGAGTTACTCCCCATAATTAACCTTCACTTTGACTACTGG	CARHGGVEHPLLLWFGELLPIINLHFDYW	IGHV4-39	IGHJ4
TGTGCGAGAGCCTTCATAGCAGTGGCTGGTACAAATAGAGGTGACTACTGG	CARAFIAVAGTNRGDYW	IGHV4-59	IGHJ4
TGTGCGAAAGATGTTCTAGTACGATTTTTGGAGTGGGACAACCATAGTCCCTACAACTGGTTCGACCCCTGG	CAKDVLVRFLEWDNHSPYNWFDPW	IGHV3-23	IGHJ5
TGTGCGAGTGGCTACACGTATTACGATTTTTGGAGTGGTTATTACATGGACGTCTGG	CASGYTYYDFWSGYYMDVW	IGHV3-7	IGHJ6
TGTGCGAGAGATGGGCAGTCGCGCCTTTTGACTGATGACTACTGG	CARDGQSRLLTDDYW	IGHV1-3	IGHJ4
TGTGCGAGAGATCCGCAGTATAGCAGTGGCTGCTTTGACTGG	CARDPQYSSGCFDW	IGHV3-21	IGHJ4
TGTGCGAGAGCCTGGCCGTTGTATAGCAGCAGCTGGTACGCCCGTCCTGACTACTGG	CARAWPLYSSSWYARPDYW	IGHV1-46	IGHJ4
TGTGCGAGAGATACGGTGACGTATATTAACTACTTTGACTACTGG	CARDTVTYINYFDYW	IGHV4-59	IGHJ4
TGTGCGAATACAGTTCCCGGGACAGGAAAACGCCTCTCGCCTAAAACCTCGGTCATGGACGTCTGG	CANTVPGTGKRLSPKTSVMDVW	IGHV4-39	IGHJ6
TGTGCGGCGGAGCATATATTACGATTTTTGGAGTGGTTTTATTCAAACTGGTTCGACCCCTGG	CAAEHILRFLEWFYSNWFDPW	IGHV1-2	IGHJ5
TGTGCGAAGGTCGATAGTGGCTACGAAAAAGACGGAACGTCTGACTACTGG	CAKVDSGYEKDGTSDYW	IGHV3-NL1	IGHJ4
TGTGCGAAAGATCATATCGTGTATAGCAGCAGCTGGTACTTTGCACCCCACAACTGGTTCGACCCCTGG	CAKDHIVYSSSWYFAPHNWFDPW	IGHV3-NL1	IGHJ5
TGTGCGAGCGGGCCCTCGTACTGGTGGTGTATGCTAAATAACTACTACTACTACTACATGGACGTCTGG	CASGPSYWWCMLNNYYYYYMDVW	IGHV4-34	IGHJ6
TGTGCGAGAGAAGGAAGGGGGGGAAACTATGATTACATTTGGGGGAGTTATCGTTACCAAACCCCCAACTGG	CAREGRGGNYDYIWGSYRYQTPNW	IGHV3-11	IGHJ4
TGTACTAGAGATTACCTCGCCCTCCGACCCGACTACTGG	CTRDYLALRPDYW	IGHV3-49	IGHJ4
TGTGGGATACTCCGTTCGTATTACGATATTTTGACTGGTTATAGGTACTACTACTACATGGACGTCTGG	CGILRSYYDILTGYRYYYYMDVW	IGHV3-30	IGHJ6
TGTGCGAGCCCCCTGCAGTGGCTGGTACGACCATATTACTACTACTACTACTACATGGACGTCTGG	CASPLQWLVRPYYYYYYYMDVW	IGHV3-21	IGHJ6
TGTGCGAGAGGTTTGGCCCGGTTCGGGGAGTTATTCCGGGTGGATGCCTACTGG	CARGLARFGELFRVDAYW	IGHV1-69	IGHJ4
TGTGCGAGAGATTTTGCCTGGTACGCCTTTGACTACTGG	CARDFAWYAFDYW	IGHV3-30	IGHJ4
TGTGCGAGAGATCACAAAGGTTTGTCCCGGCATCCTGTGGTGGTGACTGCTATTCAAAACTGGTTCGACCCCTGG	CARDHKGLSRHPVVVTAIQNWFDPW	IGHV1-69	IGHJ5
TGTGCGAGAGCCGGACACTCCACTATTGTAGTGGTGGTAGCTGTTCGGGCCGACTACTGG	CARAGHSTIVVVVAVRADYW	IGHV4-59	IGHJ4
TGTGCGAGACAACCGCGGCACCATATTGTAGTGGTGGTAGCTGCTACAAGCTGGTTCGACCCCTGG	CARQPRHHIVVVVAATSWFDPW	IGHV4-39	IGHJ5
TGTGCGAGAGGCGCATTCGGTATAGCAGTGGCTGCAGTCGATATTCGCGACGGGGTATTCTCTAATGACTACTGG	CARGAFGIAVAAVDIRDGVFSNDYW	IGHV4-34	IGHJ4
TGTGCGAAAGATTTTCTTTATCCTTGTCCCGGGGATTACTATGGTTCGGGGAGTTACCCATTTGACTACTGG	CAKDFLYPCPGDYYGSGSYPFDYW	IGHV3-23	IGHJ4
TGTGCGAGACATCCCCTGCCTATAACACCCATTACTATGGTTCAGGGAGTTATTATAAGGCGGGGGCCCGACTACTGG	CARHPLPITPITMVQGVIIRRGPDYW	IGHV5-51	IGHJ4
TGTGCGAGATTATACTACTACGGTGACTACCACGACTACTGG	CARLYYYGDYHDYW	IGHV3-66	IGHJ4
TGTGCGAGAGGCCCCAGGAGGGTACGATTTTTGGAGTGGTACTACTACTACTACTACATGGACGTCTGG	CARGPRRVRFLEWYYYYYYMDVW	IGHV4-61	IGHJ6
TGTGCGAGAATTACGATTTTTTACGAGGACTACTGG	CARITIFYEDYW	IGHV7-4-1	IGHJ4
TGTGCGACATATGCCCGTACCGTCTATGATAGTAGTGGTTACGATAGCCACTTTGACTACTGG	CATYARTVYDSSGYDSHFDYW	IGHV1-2	IGHJ4
TGTACCACAGTGGAACCCCGGCTAAAGCCGGGCCTGTCCTTTGACTACTGG	CTTVEPRLKPGLSFDYW	IGHV3-15	IGHJ4
TGTGCGAGAGATTGCTTACGTATTACTATGGTTCGGGGAGTTATAAGTTTTCTTGGGGGTTACTACTTTGACTACTGG	CARDCLRITMVRGVISFLGGYYFDYW	IGHV3-7	IGHJ4
TGTGCGAGAGGGGCAGCGCCTGTAGTAGTACCAGCTGCTATGGTTCCCTACTACTACTACATGGACGTCTGG	CARGAAPVVVPAAMVPYYYYMDVW	IGHV4-34	IGHJ6
TGTGCGAAAAGATTGAATGGATATTGTAGTGGTGGTAGCTGCTACTCACCCCTCGATAATGCTTTTGATATCTGG	CAKRLNGYCSGGSCYSPLDNAFDIW	IGHV3-23	IGHJ3
TGTGCGAGAGATCCTGAGAGGGGTATTACGATTTTTGGAGTGGTTATTATTTTTGATGCTTTTGATATCTGG	CARDPERGITIFGVVIIFDAFDIW	IGHV3-66	IGHJ3
TGTGCGAGACCCCCCCAGCAGTGGCTGGTAGTTAAGGTTGACTACTGG	CARPPQQWLVVKVDYW	IGHV4-38-2	IGHJ4
TGTGCGAGAGATCCGCCGATTGGCAAGGTAACTGGAGGTACGAACTTTGACTACTGG	CARDPPIGKVTGGTNFDYW	IGHV3-53	IGHJ4
TGTGCGAAAGGGGGCGGGACTCAATACGTATTACGATTTTTGGAGTGGTTAGGTGTGCCTTACTTTGACTACTGG	CAKGGGTQYVLRFLEWLGVPYFDYW	IGHV3-23	IGHJ4
TGTGCGAGAGTCTATGGTTCGGGGAGTTATTATAATGATGACTACTGG	CARVYGSGSYYNDDYW	IGHV1-69	IGHJ4
