TGTGCGAGAGGCATTTCCGAGGTGACCCTGTACTGGTGGTGTATGAAGTACTACTTTGACTACTGG	CARGISEVTLYWWCMKYYFDYW	IGHV4-34	IGHJ4
TGTACTTTTCTCGGGCATTGTAGTAACTACTACTACTACTACATGGACGTCTGG	CTFLGHCSNYYYYYMDVW	IGHV1-8	IGHJ6
TGTACTAGAGGGGCACTATGGTTCAGGGAGTTATGCCGGTGG	CTRGALWFRELCRW	IGHV3-49	IGHJ5
TGTGCGAGAGAGGGGGTGATTGCCGCTGACTACTGG	CAREGVIAADYW	IGHV3-30	IGHJ4
TGTGCGAGAGTCCCTCGCATGGTTCAGGGAGTGCAGATTTCACCTCTTCCTTACTTTGACTACTGG	CARVPRMVQGVQISPLPYFDYW	IGHV3-21	IGHJ4
TGTGCGAGAGTAACTAGTGGTGGTAGCTGCTACTCCGACTACTGG	CARVTSGGSCYSDYW	IGHV4-34	IGHJ4
TGTGCAAGAGGGACGAGAACGTCGGATATAGTGGCTACGAGGCACTTTGACTACTGG	CARGTRTSDIVATRHFDYW	IGHV6-1	IGHJ4
TGTGCGGCACGCCCTAGGGGAAAAACTGGAACTACATTGAACTGGTTCGACCCCTGG	CAARPRGKTGTTLNWFDPW	IGHV1-58	IGHJ5
TGTGCGAAACCGGCGCTCGAATTACTATGGTTCGGGGAGTTATACAACTGGTTCGACCCCTGG	CAKPALELLWFGELYNWFDPW	IGHV3-NL1	IGHJ5
TGTGCGAGAGGATATTGTAGTAGTACCAGCTGCTATTTTGGAGGGGACTACTACTACTACTACATGGACGTCTGG	CARGYCSSTSCYFGGDYYYYYMDVW	IGHV3-53	IGHJ6
TGTGCGAGGCCCATCCCGGCTATTACTATGATTGGCGTCCACCCCGATGCTTTTGATATCTGG	CARPIPAITMIGVHPDAFDIW	IGHV7-4-1	IGHJ3
TGTGCGAAAGATTGTATAGCAGCAGCTGGTACCTTGATGTGGTTCGACCCCTGG	CAKDCIAAAGTLMWFDPW	IGHV3-NL1	IGHJ5
TGTGCACGGACAAATTCGTGGACGAGTCCAGCTCGTCCCGGGGGTACGGGGCCGAGGCCCAATGGTAATTACTACTACTACTACTACATGGACGTCTGG	CARTNSWTSPARPGGTGPRPNGNYYYYYYMDVW	IGHV2-26	IGHJ6
TGTGCGAGACCGAATAAAAATAGCAGCAGCTGGTACATGGGACCTACGTACTACTACTACTACTACATGGACGTCTGG	CARPNKNSSSWYMGPTYYYYYYMDVW	IGHV5-10-1	IGHJ6
TGTGCGAGAGCCCCTATGATAGTAGTGGTTACCCAGTTACCCTTGTGTCCCTACTGG	CARAPMIVVVTQLPLCPYW	IGHV1-69	IGHJ4
TGTGCGAGACCCCTGGTACGATTTTTGGAGTGGTTATTATCGGGTTGGGCGAATAACTGGTTCGACCCCTGG	CARPLVRFLEWLLSGWANNWFDPW	IGHV3-21	IGHJ5
TGTGCGAAAGAACTAGTGCTAGCATATTGTGGTGGTGACTGCGATTGGGGTACGAGGGGCGACGGGATATCCTGGTTCGACCCCTGG	CAKELVLAYCGGDCDWGTRGDGISWFDPW	IGHV3-NL1	IGHJ5
TGTGCGAGACATCGAGTCGGTGTCACCCCTGTAGCTCCGTACCGGAACTTTGACTACTGG	CARHRVGVTPVAPYRNFDYW	IGHV5-51	IGHJ4
TGTGCGAAAGTGACTTCAATGATTACATTTGGGGGAGTTAAGAATAACTTTGACTACTGG	CAKVTSMITFGGVKNNFDYW	IGHV3-NL1	IGHJ4
TGTGCGAAAGCTAGCCGCAGTGGCTGGTACCCCTTTGACTACTGG	CAKASRSGWYPFDYW	IGHV3-NL1	IGHJ4
TGTGCGAGAAACCAGACGTATTACGATTTTTGGAGTGGTTATTGGCTTAGCGTTCTTGACTACTGG	CARNQTYYDFWSGYWLSVLDYW	IGHV7-4-1	IGHJ4
TGTGCGAGTCGGCCTCCGATTACGATTTTTGGAGTGGTTATTAGGTCTGGCTACTGG	CASRPPITIFGVVIRSGYW	IGHV3-7	IGHJ4
TGTGCGAGACAGGGGACCCATTACGATATTTTGACTGGTTATTATAAACTTTTTGACTACTGG	CARQGTHYDILTGYYKLFDYW	IGHV5-51	IGHJ4
TGTGCGAGGCAGTTGTGGCGACCTTTGATTGTAGTGGTGGTAGCTGCTAACAGAGATGATGCTTTTGATATCTGG	CARQLWRPLIVVVVAANRDDAFDIW	IGHV3-11	IGHJ3
TGTGCAAGAGTTACGATTTTTGGAGTGGTTATGCCGATGGACGTCTGG	CARVTIFGVVMPMDVW	IGHV3-74	IGHJ6
TGTGCGAGAAGGCGAAGATATTGTAGTAGTACCAGCTGCTATACACTAACCCGTGACTACTGG	CARRRRYCSSTSCYTLTRDYW	IGHV4-34	IGHJ4
TGTGCGAGCCTTAGTAGTACCAGCTGCTACCCCACGTACTACTTTGACTACTGG	CASLSSTSCYPTYYFDYW	IGHV1-69	IGHJ4
TGTACCACAGACAGGGCCACTTGTGGTGGTGACAGAAGGTACTTCCAGCACTGG	CTTDRATCGGDRRYFQHW	IGHV3-15	IGHJ1
TGTGCGACTCTTGAACAGTGGCTGATGACTGACTACTGG	CATLEQWLMTDYW	IGHV3-NL1	IGHJ4
TGTACGAAACTTACGGGCGCCCACCGTATTACTATGATAGTAGTGGTTATTAGCCCTTTTGACTACTGG	CTKLTGAHRITMIVVVISPFDYW	IGHV3-9	IGHJ4
TGTGCGGGTGAGTGTTGTACAGTGGCTGGTACCCCCCCGCCCTTCGACCCCTGG	CAGECCTVAGTPPPFDPW	IGHV3-21	IGHJ5
TGTGCGAAAGCTCCCGGTGGATATTGTACTAATGGTGGACTGGGGGGTATTGACTACTGG	CAKAPGGYCTNGGLGGIDYW	IGHV3-NL1	IGHJ4
TGTGCGAGACCCAAGTGGGAGCTGGCCCTTGACTACTGG	CARPKWELALDYW	IGHV4-39	IGHJ4
TGTGCGAAAGATCGGTATAGCAGCAGCTGGCCTTTTGGCATTGACTACTGG	CAKDRYSSSWPFGIDYW	IGHV3-NL1	IGHJ4
TGTGCGAGAGTTCGGGAGTACGGCGATATTGTAGTAGTACCAGCTGCTATAAACTGG	CARVREYGDIVVVPAAINW	IGHV3-21	IGHJ5
TGTACCACTCTTCTCCAACACACTATGATAGTAGTGGTTATTAAACTGGGGAGATTTCGAGGGCGTCGGCAGAAAGCACCGTGGTCGTACTACTTTGACTACTGG	CTTLLQHTMIVVVIKLGRFRGRRQKAPWSYYFDYW	IGHV3-15	IGHJ4
TGTGCAAAAGAAATAAGGTTAATCGGTGACTACGTGGGATTTTACTACTTTGACTACTGG	CAKEIRLIGDYVGFYYFDYW	IGHV3-43	IGHJ4
TGTGCGAGAGGGTCCCCGGAGGATATTGTAGTGGTGGTAGCTGCTACCCTTGTCGATTACTACTACTACTACTACATGGACGTCTGG	CARGSPEDIVVVVAATLVDYYYYYYMDVW	IGHV3-21	IGHJ6
TGTGCGAGAGGTCTAATAGCAGTGGCTGGCTATCCGTTCCCACACTACTACTACTACATGGACGTCTGG	CARGLIAVAGYPFPHYYYYMDVW	IGHV4-34	IGHJ6
TGTGCGAGGACCCTGTACCAGCTGCCGAGAGTATACTACTACTACTACATGGACGTCTGG	CARTLYQLPRVYYYYYMDVW	IGHV1-3	IGHJ6
TGTGCGAGACATGATCGTGGGGAGGTTGTGGTGGTAGCTGCTACGGTGGAGCGGCCACACGGGCCTTGGTGGTTCGACCCCTGG	CARHDRGEVVVVAATVERPHGPWWFDPW	IGHV5-51	IGHJ5
TGTGCGAGAGGCATCAGGGTTCTTGCACTCGGGGCCTTCGATGGAGATGGCTACAATTTACGTATAGACTACTGG	CARGIRVLALGAFDGDGYNLRIDYW	IGHV1-3	IGHJ4
TGTGCACGGATGAGAAAAACTGTGAGTCTTACGATTTTTGGAGTGGTTATAGTCCTTGACTACTGG	CARMRKTVSLTIFGVVIVLDYW	IGHV2-26	IGHJ4
TGTGCGAGAGATGGGAATAGCATCTCTAACCCGAGTGCCTCCAGTTGTGGTAGCTGCTACTCGAGAGACTACTACTACTACTACATGGACGTCTGG	CARDGNSISNPSASSCGSCYSRDYYYYYMDVW	IGHV1-2	IGHJ6
TGTCTATCCTTAGCAGTGGCTGGTATCTTTTCTCGTTGGTTCGACCCCTGG	CLSLAVAGIFSRWFDPW	IGHV3-23	IGHJ5
TGTGCGAAAGATTGTTGTATTACGATTTTTGGAGTGGTTATGAGTTGGCAAATCTTTGACTACTGG	CAKDCCITIFGVVMSWQIFDYW	IGHV3-23	IGHJ4
TGTGCGAGAGGCGCCGGTTCGGGGAGTTATTATAAAAGCTGGTTCGACCCCTGG	CARGAGSGSYYKSWFDPW	IGHV4-34	IGHJ5
TGTGCGAGAACAATAAGCAGTGGCTGCCGGGGTGCTTACTACTTTGACTACTGG	CARTISSGCRGAYYFDYW	IGHV4-34	IGHJ4
TGTGCAAAAGATATAACCGCGTACGATATTTTGACTGGTTATTATAAGATCTCCCACAGGGTACCCCTTGACTACTGG	CAKDITAYDILTGYYKISHRVPLDYW	IGHV3-43	IGHJ4
TGTGCACACAGACTGGCTCCCGGGGGTACGGTGACTACTCGAAGCAACTACTACTACTACATGGACGTCTGG	CAHRLAPGGTVTTRSNYYYYMDVW	IGHV2-5	IGHJ6
TGTGCACCGGGTATTGTAGTAGTACCAGCTGCTACTCGATACTACTTTGACTACTGG	CAPGIVVVPAATRYYFDYW	IGHV3-23	IGHJ4
TGTGCGAAAGATCGTATTACGATTTTTGGAGTGGTTATTACATCTAACTGGTTCGACCCCTGG	CAKDRITIFGVVITSNWFDPW	IGHV3-NL1	IGHJ5
TGTGCGAGAGAACGAGAGTTGCCCGTTATTGTAGTGGTGGTAGCTGCACTTGGAGACTACTACTACTACTACATGGACGTCTGG	CARERELPVIVVVVAALGDYYYYYMDVW	IGHV4-34	IGHJ6
TGTGCGAAAGATAGGGACTTCCTGCAACTAAGTTTGGGGGAGTTATCGCCCTTTGACTACTGG	CAKDRDFLQLSLGELSPFDYW	IGHV3-NL1	IGHJ4
TGTGCGAGAGGCCTTGTAGTGGTGGTAGCTGCCCACAATGGGAACTGGTTCGACCCCTGG	CARGLVVVVAAHNGNWFDPW	IGHV4-59	IGHJ5
TGTGATATATACCACTGCGGTGCGGGACTGGAGGGTAGTGGTGGTAGCTGCTACTATGTAACGGGTGACTACTGG	CDIYHCGAGLEGSGGSCYYVTGDYW	IGHV1-8	IGHJ4
TGTGCGAGAGCCGGAATTACTATGATAGTAGTGGTTATTTCCGGGAATACCCGAAGTGAGCAGCGCTTTGACTACTGG	CARAGITMIVVVISGNTRSEQRFDYW	IGHV3-7	IGHJ4
TGTGCGAGAATGGTCATACGTATGATTACATTTGGGGGAGTTATCGACTACTGG	CARMVIRMITFGGVIDYW	IGHV7-4-1	IGHJ4
TGTACCACAGATCGGATAGCAGTGGCTGGTGTAAGAGGGCGGCTTGACTACTGG	CTTDRIAVAGVRGRLDYW	IGHV3-15	IGHJ4
TGTGCGATGGAGCTATGGTTCGGGGAGTGGGTGTTTTCCGGTTCCGAACCAGCCAATGACTACTGG	CAMELWFGEWVFSGSEPANDYW	IGHV3-7	IGHJ4
TGTACCGGCCCCGTGTATATTGTAGTAGTACCAGCTGCTACCCCCAACTACTACTACTACATGGACGTCTGG	CTGPVYIVVVPAATPNYYYYMDVW	IGHV3-15	IGHJ6
TGTGCGAGAGTCGTTTTTCCCACACGAGCGTATAGTGGGAGCTACTCCGAATACTGG	CARVVFPTRAYSGSYSEYW	IGHV4-38-2	IGHJ4
TGTGCCATACGAACCGAGAGCAGCAGCTGGCCAGCTCTAAGCTACTACTACTACTACATGGACGTCTGG	CAIRTESSSWPALSYYYYYMDVW	IGHV1-8	IGHJ6
TGTGCGAGACCCCAGCCTTACGATTTTTGGAAAACCTTTGACTACTGG	CARPQPYDFWKTFDYW	IGHV7-4-1	IGHJ4
TGTGCGAAAGGGATTTTTGGAGTGGTTATTATACTGACCTGGGTTCGGTTCGACCCCTGG	CAKGIFGVVIILTWVRFDPW	IGHV3-23	IGHJ5
TGTGCGAAAGAGCCCGCCCCAGTGCGGTTAGGATATTGTAGTGGTGGTAGCTGCTACTCCGAGGTGAGACCGGGAAACCGTAGCGAGGGCGACACCCTCCTTGGGCTCTACTGG	CAKEPAPVRLGYCSGGSCYSEVRPGNRSEGDTLLGLYW	IGHV3-NL1	IGHJ4
TGTGCGAGAGCTTCTATTACTATGATAGTAGTGGTTAAGGGATCGGTAGCCAGAGCTTTTGATATCTGG	CARASITMIVVVKGSVARAFDIW	IGHV7-4-1	IGHJ3
TGTGCGAGAGGTTCGGATATTGTAGTGGTGGTAGCTGCGGATCCCTACTGG	CARGSDIVVVVAADPYW	IGHV1-2	IGHJ4
TGTGCGAGTTATGGTAGTGATTATGATTACATTTGGGGGAGTTATGGCTTTGACTACTGG	CASYGSDYDYIWGSYGFDYW	IGHV4-38-2	IGHJ4
TGTGCGAGAGATCTAGGTGCAAGACGGCTACGATTCACCTCATTTGACTACTGG	CARDLGARRLRFTSFDYW	IGHV3-21	IGHJ4
TGTGCGAGAGAGTCGGGAATTTGTACTGGTGGTGTATGCTATAACTGGTTCGACCCCTGG	CARESGICTGGVCYNWFDPW	IGHV3-11	IGHJ5
TGTGCACACAGGGGGTATTACTATGATAGTAGTGGTTATTACCCCTACTTTGACTACTGG	CAHRGYYYDSSGYYPYFDYW	IGHV2-5	IGHJ4
TGTGCGAGCGCGACGTATAACTGGAACTACATGTGG	CASATYNWNYMW	IGHV1-18	IGHJ4
TGTGCAAGATACGGAGTACGGGAATACAACCCCTTTGACTACTGG	CARYGVREYNPFDYW	IGHV1-45	IGHJ4
TGTGCAAGGGGAGCAGATAACATTACTATGGTTCGGGGAGTTAACACCTGGTTCGACCCCTGG	CARGADNITMVRGVNTWFDPW	IGHV3-30-3	IGHJ5
TGTGCGAGGAACTTCTACGTATTACGATTTTTGGAGTGGTTATTATACTACTTTGACTACTGG	CARNFYVLRFLEWLLYYFDYW	IGHV1-3	IGHJ4
TGTGCGAGCTCGTCCCTTTATGAATCTCAACGGGTGGGGTTTGACTACTGG	CASSSLYESQRVGFDYW	IGHV1-3	IGHJ4
TGTGCGAGAGGGCGGCTCCCGCAGCAGCTGTACGGGAAACCGGACGATCTGCTCCACTTTGACTACTGG	CARGRLPQQLYGKPDDLLHFDYW	IGHV1-2	IGHJ4
TGTGCGAACGCAGGTTGTAGTGGTGGTAGCTGCTACCCCGCAGGAAACTGGTTCGACCCCTGG	CANAGCSGGSCYPAGNWFDPW	IGHV3-NL1	IGHJ5
TGTGCGAGACTTGGAAAGGATGTGGTGGTGACTGCTATAAGGAAATCCCTTGACTACTGG	CARLGKDVVVTAIRKSLDYW	IGHV4-39	IGHJ4
TGTGCAAGAACGTTACGATTTTTGGAGTGGTTATTGTCGTACTACTACTACTACTACATGGACGTCTGG	CARTLRFLEWLLSYYYYYYMDVW	IGHV6-1	IGHJ6
TGTGCGAAAGAATATATTGTAGTAGTACCAGCTGCTAACCGGGATGCTTTTGATATCTGG	CAKEYIVVVPAANRDAFDIW	IGHV3-NL1	IGHJ3
TGTACTAGAGAGTTAATGAGCGGTATAGCAGTGGCTGGTGACCGCTACTGG	CTRELMSGIAVAGDRYW	IGHV3-49	IGHJ4
TGTGCGAGAAGGGATGGCCCTAGTGGTTATTACCAGGGGTACTTTGACTACTGG	CARRDGPSGYYQGYFDYW	IGHV4-39	IGHJ4
TGTGCGAGGTGTCGGTTTTGGAGTGGTTATTGTTTTGACTACTGG	CARCRFWSGYCFDYW	IGHV5-10-1	IGHJ4
TGTGCGAGAGATGAGTATTGTAGTAGTACCAGCTGCTATCGGGAGGGCACATACTACTACTACTACATGGACGTCTGG	CARDEYCSSTSCYREGTYYYYYMDVW	IGHV3-21	IGHJ6
TGTGCGAGTTCCGGAGTTGTAGTAGTACCAGCTGCTAGGGGTACAGATTACTACTACTACTACTACATGGACGTCTGG	CASSGVVVVPAARGTDYYYYYYMDVW	IGHV4-39	IGHJ6
TGTGGACTGTCGTCCTACGGCGTAGCAGCAGCTGGTACGACTGACTACTGG	CGLSSYGVAAAGTTDYW	IGHV3-30	IGHJ4
TGTACCCGTCCCGGAGTGGTTATTATGCAGGATGCTTTTGATATCTGG	CTRPGVVIMQDAFDIW	IGHV3-21	IGHJ3
TGTGCGAGAGCTCGCAATAGTAGTACCAGCTGCCATCACCTCTGG	CARARNSSTSCHHLW	IGHV3-30	IGHJ4
TGTGCGAGAGTCAGTATTACTATGGTTCAGGGAGTTCCGTATGAAAATTTTCCTTGGGATTACTACTACTACTACTACATGGACGTCTGG	CARVSITMVQGVPYENFPWDYYYYYYMDVW	IGHV3-21	IGHJ6
TGTGCGAGACCTGTTCGGATGATTACATTTGGGGGAGTTATCGACCGGGAGCGGTACTACTTTGACTACTGG	CARPVRMITFGGVIDRERYYFDYW	IGHV4-39	IGHJ4
TGTGCGAGAGTTTTACGATTTTTGGAGTGGTTATGGCCAGCTTTCTACTGG	CARVLRFLEWLWPAFYW	IGHV1-18	IGHJ4
TGTACCACAGATCCGGGCGATAACGCCTTATCGGCCGACGGTAGCTGCAGTGGCGGGGGGTCCCGGAGCTACTACTTTGACTACTGG	CTTDPGDNALSADGSCSGGGSRSYYFDYW	IGHV3-15	IGHJ4
TGTGCAAGGGGCCTTAGGTTTACTATGATAGTAGTGGTTATTTGGGCCGCCTTTGACTACTGG	CARGLRFTMIVVVIWAAFDYW	IGHV1-45	IGHJ4
TGTACTAGAGGAAGGCCCCCTCGGTATTGTAGTGGTGGTAGCTGCTACTTAGCCCCTGCTGACTACTGG	CTRGRPPRYCSGGSCYLAPADYW	IGHV3-49	IGHJ4
TGTACCACAGACCCGAACGATATATATAGCAGCTCGTCCGGGATTGACTACTGG	CTTDPNDIYSSSSGIDYW	IGHV3-15	IGHJ4
TGTGCGAGAGATCCAGGGGGCTTACGATTTTTGGAGTGGTTAGGGGTCCGCTACTTTGACTACTGG	CARDPGGLRFLEWLGVRYFDYW	IGHV1-2	IGHJ4
TGTACTAATATTGTAGTGGTGGTAGCTGCTACTGTAGGGTACTACTACTACTACATGGACGTCTGG	CTNIVVVVAATVGYYYYYMDVW	IGHV3-73	IGHJ6
TGTGCGAAAGATTTACGGGGCTATTGTGGTGGTGACTGCTACCTCATCCCCGCTTTTGATATCTGG	CAKDLRGYCGGDCYLIPAFDIW	IGHV3-NL1	IGHJ3
