TGTGCGAGAGTGGTTTTTTGGAGTGGTTATCACTACTACTACTACTACATGGACGTCTGG	CARVVFWSGYHYYYYYMDVW	IGHV3-7	IGHJ6
TGTGCGAGAGATCGCGAAATAGTGGTGACTGCTACCGTTGGCTGG	CARDREIVVTATVGW	IGHV1-18	IGHJ1
TGTGCGAAGGCCCTTTTGGGTATGATTACGTTTGGGGGAGTTATCGTTATACCGGTTACCGACGGAGGTGGTTGG	CAKALLGMITFGGVIVIPVTDGGGW	IGHV3-23	IGHJ4
TGTGCGAGAGCCCCTGGTGGTTTGGAGTGGTTACATGCAGGAGACTACTACTACATGGACGTCTGG	CARAPGGLEWLHAGDYYYMDVW	IGHV4-61	IGHJ6
TGTGCGAGACCGACCGTGGATACAGCTATGGGTCTGTACTACTTTGACTACTGG	CARPTVDTAMGLYYFDYW	IGHV4-38-2	IGHJ4
TGTGCGAGATCGGATGTGGTTACTACGGACTCCCAACGTAACTGGTTCGACCCCTGG	CARSDVVTTDSQRNWFDPW	IGHV7-4-1	IGHJ5
TGTGCGAAAGAGTATTGTAGTAGTACCAGCTGCTATGTTGGAGATGCTTTTGATATCTGG	CAKEYCSSTSCYVGDAFDIW	IGHV3-23	IGHJ3
TGTGCGAGAGATCCCGGTTCAGGGAGTCCCTGTAGGGGGCCCTTAAGTGCCCATGACTACTACTACTACTACATGGACGTCTGG	CARDPGSGSPCRGPLSAHDYYYYYMDVW	IGHV3-30	IGHJ6
TGTGCTAGAGATCGAGTAATAGCAGCAGCCGGGCATGGCAACTGGTTCGACCCCTGG	CARDRVIAAAGHGNWFDPW	IGHV3-72	IGHJ5
TGTGCAAGAGTTTCGGATAGCAGTGGCTGGTATCGTAACCAAACGCAATCCCACTTTGACTACTGG	CARVSDSSGWYRNQTQSHFDYW	IGHV3-74	IGHJ4
TGTGCGAAGACCCAAAACGACCGGCACTATGATAGTAGTGTACCGGGTTGCAAGTACTTCCAGCACTGG	CAKTQNDRHYDSSVPGCKYFQHW	IGHV3-NL1	IGHJ1
TGTGCGAAAGCGAGAAAAAACATTGTAGTAGTACCAGCTGCTTTCGGCTACATGGACGTCTGG	CAKARKNIVVVPAAFGYMDVW	IGHV3-23	IGHJ6
TGTGCAAGAGATGGGTGGGAGGGATATTGTAGTAGTACCAGCTGCTATCGTAGGTGGTACTACTTTGACTACTGG	CARDGWEGYCSSTSCYRRWYYFDYW	IGHV3-13	IGHJ4
TGTGCAAGAAAAAAGGCATACATGACTACGGTGACAAGTTCGCAACCAGACTACTGG	CARKKAYMTTVTSSQPDYW	IGHV3-13	IGHJ4
TGTGCGAGCCACGGGTACTGGGTGGTAGCTGCGAGGCGGAAGGGGGGAGGGTCGGGGTCGTACGAGCGCGGGTACTACTTTGACTACTGG	CASHGYWVVAARRKGGGSGSYERGYYFDYW	IGHV3-11	IGHJ4
TGTGATCTGGAAGAGGATATTGTAGTGGTGGTAGCTGGTGCCCCCCACTGGTTCGACCCCTGG	CDLEEDIVVVVAGAPHWFDPW	IGHV1-3	IGHJ5
TGTGCGAGACGGCCCGGAGGATATTGTAGTAGTACCAGCTGGAGAAAGGTGAACTACTACTACTACTACATGGACGTCTGG	CARRPGGYCSSTSWRKVNYYYYYMDVW	IGHV5-51	IGHJ6
TGTGCAAGAGAACCCCAGCAGCTGGTAAAACAGATTCTCGACCTACCCAACTACTACATGGACGTCTGG	CAREPQQLVKQILDLPNYYMDVW	IGHV3-74	IGHJ6
TGTGCGAAAGGGGAATATTGTAGTAGTACCAGCTGCTATGAGGAAGCCTCTGTCTACTACTACTACTACATGGACGTCTGG	CAKGEYCSSTSCYEEASVYYYYYMDVW	IGHV3-NL1	IGHJ6
TGTGCGAGAGATACCCTACGATTTTTGGAGTGGTTATTATACCGCGGTACCGCGGGGGAATCGGCAGCCCATGCTTTTGATATCTGG	CARDTLRFLEWLLYRGTAGESAAHAFDIW	IGHV3-21	IGHJ3
TGTGCAAGTCGGCTCTATTGTAGTGGTGGTAGCTGCTACTCCGGGGCTGGCTGTTACTGG	CASRLYCSGGSCYSGAGCYW	IGHV3-74	IGHJ4
TGTGCAAAAGATATCTCGGGGGATGGTAGCAGTGGCTGGTGGAACTCCCGACCTACGTACGGAGACGGGCCCGACTACTGG	CAKDISGDGSSGWWNSRPTYGDGPDYW	IGHV3-43D	IGHJ4
TGTGCGAGTGGAACTGGATATTATAGCAGCTCGTCCGGACGGCCCGGGAACAGCGACTACTGG	CASGTGYYSSSSGRPGNSDYW	IGHV7-4-1	IGHJ4
TGTGCGAGAAACGGCGATTTTTGGAGTGGTTACCCTTGGGTTCCAGTATGGCAGGCCCTCTACTTTGACTACTGG	CARNGDFWSGYPWVPVWQALYFDYW	IGHV1-69	IGHJ4
TGTGCGAAATCCATTACTATGATAGTAGTGTTAAACTGG	CAKSITMIVVLNW	IGHV3-23	IGHJ4
TGTGCGAAACCTGGCCGTCTGAAATTTCAGCTGCTATACTACTACTACTACATGGACGTCTGG	CAKPGRLKFQLLYYYYYMDVW	IGHV3-NL1	IGHJ6
TGTGCAAAAGATATTTATATGTTACGATTTCCTGATGCTTTTGATATCTGG	CAKDIYMLRFPDAFDIW	IGHV3-43	IGHJ3
TGTGCGAGCGTTTCCTATCCCAACAGTATAGCAGCAGCTGGTACTAATTACTACTACTACTACTACATGGACGTCTGG	CASVSYPNSIAAAGTNYYYYYYMDVW	IGHV3-11	IGHJ6
TGTGCGAGGTCCGATGGCCCGAGGGTCCGTAGTGGCTACGATTTTTGCGCGTACAACTGGTTCGACCCCTGG	CARSDGPRVRSGYDFCAYNWFDPW	IGHV4-59	IGHJ5
TGTGCGAGGCCAAGGCCTCCAGCTTTGGGGTACTTTGACTACTGG	CARPRPPALGYFDYW	IGHV7-4-1	IGHJ4
TGTGCGAGAGATGAGAGAGGAGATGATAGTAGTGGTTATTACTTTGGACAATTTGACTACTGG	CARDERGDDSSGYYFGQFDYW	IGHV1-2	IGHJ4
TGTGCAAGAGCATCCTTTTTGGAGTGTGAATCCTACTACTACTACTACATGGACGTCTGG	CARASFLECESYYYYYMDVW	IGHV3-13	IGHJ6
TGTGCGAGACTCCCTAATGGGCCCCCTAATAGCAGCAGCTGGTATGACTACTGG	CARLPNGPPNSSSWYDYW	IGHV3-21	IGHJ4
TGTGCGAGAGATGAAAAAAAGAAAGCTATTGACTACTGG	CARDEKKKAIDYW	IGHV1-3	IGHJ4
TGTGCGAGAGATATTGTAGTGGTGGTAGCTGCTACTCCGGTGGAACTATCGGTTATTGACTACTGG	CARDIVVVVAATPVELSVIDYW	IGHV1-69	IGHJ4
TGTGCGAGAGTTCTGCCCGGTAGTGGTGGTAGCTGCTACTCAACAGGGGGAGCGCTAGTTCACTGG	CARVLPGSGGSCYSTGGALVHW	IGHV4-59	IGHJ4
TGTGCAAGAGATACCAGATTGGGTAGTAGTACCAGCTGCTATGCTTACTACTACTACTACTACATGGACGTCTGG	CARDTRLGSSTSCYAYYYYYYMDVW	IGHV3-74	IGHJ6
TGTGCAAGACTGGGGAGGCAGTCTATGGTTCAGGGAGTTATTAGATACTACTACTACTACATGGACGTCTGG	CARLGRQSMVQGVIRYYYYYMDVW	IGHV3-13	IGHJ6
TGTGCGCGTGGGTATTACGATTTTTGGAGTGGTGGGTCGAGCTACTGG	CARGYYDFWSGGSSYW	IGHV4-34	IGHJ4
TGTGCGAGCCGGGCGTGGGAGCTACCGGACTGG	CASRAWELPDW	IGHV1-18	IGHJ4
TGTGCGAAAGATCGGAGGGCCGGGGGTTGCTCCGGGATGGCTCAGACGCCCTTGGGGATTGACTACTGG	CAKDRRAGGCSGMAQTPLGIDYW	IGHV3-23	IGHJ4
TGTGCGAAAGATTTATGGATATACGATTTTTGGAGTGGTTATTATAGACCTACGTACTACTTTGACTACTGG	CAKDLWIYDFWSGYYRPTYYFDYW	IGHV3-NL1	IGHJ4
TGTACGGGACCTCGAGATATTGTAGTGGTGGTAGCTGCTAGAAAGTACAACTGGTTCGACCCCTGG	CTGPRDIVVVVAARKYNWFDPW	IGHV3-49	IGHJ5
TGTGCGAAAGGGTGCTTGTATTACGATTTTTGGAGTGGTTATTCGAATGCTTTTGATATCTGG	CAKGCLYYDFWSGYSNAFDIW	IGHV3-23	IGHJ3
TGTGCGAGAGATTTTGCGGAGCAGTGGCTGGTACAACCCATCACTTCCAACGTTCAAGAAACTCCCGGCTGGTTCGACCCCTGG	CARDFAEQWLVQPITSNVQETPGWFDPW	IGHV1-2	IGHJ5
TGTGCGAACCAGGGCCCAGCCTCCTACTTTGACTACTGG	CANQGPASYFDYW	IGHV3-23	IGHJ4
TGTGCGAGGCGGAGTAGATCGAGTATAGCAGCTCTACCCCTCTCGTGGTACTTTGACTACTGG	CARRSRSSIAALPLSWYFDYW	IGHV4-4	IGHJ4
TGTGCACGGATACGAGACATAGGATATTGTAGTAGTACCAGCTGCTATGTGTTTACGCTGGGCGCGACTTACTACTACTACTACTACATGGACGTCTGG	CARIRDIGYCSSTSCYVFTLGATYYYYYYMDVW	IGHV2-70	IGHJ6
TGTGCAAGACTTACTCAATATTGTAGTAGTACCAGCTGCTATTTTAGGTACTACTACTACTACATGGACGTCTGG	CARLTQYCSSTSCYFRYYYYYMDVW	IGHV1-45	IGHJ6
TGTGCGAGAGATCCCCGTAATAATATTGTAGTGGTGGTAGCTGCTACTAACAGGGGGTCAGAGTGG	CARDPRNNIVVVVAATNRGSEW	IGHV3-64	IGHJ3
TGTGCGAGATCTTTGGAGTGGCACTACTACTACTACATGGACGTCTGG	CARSLEWHYYYYMDVW	IGHV4-59	IGHJ6
TGTGCGAGAGATAGGGTGGCAGCAGCTGGTTCTGTCTACTTTGACTACTGG	CARDRVAAAGSVYFDYW	IGHV3-11	IGHJ4
TGTGCGAGAGCTGGAAGTACCAAGGATATTGTAGTAGTACCAGCTGCTAAAGTCTGCAATCACAACTGGTTCGACCCCTGG	CARAGSTKDIVVVPAAKVCNHNWFDPW	IGHV3-11	IGHJ5
TGTGCGAGAGTTAAGGGTATAGCAGCAGCTGGCAACGGCCGGAAGCCCCTAATAGACTACTGG	CARVKGIAAAGNGRKPLIDYW	IGHV1-3	IGHJ4
TGTGCGAGACCGACAGGGCGGAGTATGACTACAGTAACATGCCCAGATAATTACTACTACTACTACTACATGGACGTCTGG	CARPTGRSMTTVTCPDNYYYYYYMDVW	IGHV3-53	IGHJ6
TGTGCGAAAGATATGCCCATAGTATTACGATATTTTGACTGGTTCTACTACTACTACTACATGGACGTCTGG	CAKDMPIVLRYFDWFYYYYYMDVW	IGHV3-23	IGHJ6
TGTGCGAGTTACTCGCTTCAGGGAGTTATAGGGGGCTTTGACTACTGG	CASYSLQGVIGGFDYW	IGHV1-3	IGHJ4
TGTGCGAGAGATCGGGGTGTGAAGAGTCCTAAACGGCTCCCCGGGTATAGCAGCTCTACTAACTGGTTCGACCCCTGG	CARDRGVKSPKRLPGYSSSTNWFDPW	IGHV1-69	IGHJ5
TGTGGCCTGGAAGTCGACATGCTTATTGTAGTGGTGGTAGCTGCTTATTGTAACGATGCTTTTGATATCTGG	CGLEVDMLIVVVVAAYCNDAFDIW	IGHV3-30-3	IGHJ3
TGTGCGAAAGATCCCCGCGTATTACGATTTTTGGAGTGGTTATTATATGGCCGTCACTACTTTGACTACTGG	CAKDPRVLRFLEWLLYGRHYFDYW	IGHV3-NL1	IGHJ4
TGTGCGAGAGTATATTGTAGTAGTACCAGCTGCTACACGGATGTTGGTGCTTTTGATATCTGG	CARVYCSSTSCYTDVGAFDIW	IGHV1-46	IGHJ3
TGTGCGAGAGATCCCTATAACTGTATTACGATTTTTGGAGTGGTCTCCTACTACTACTACTACATGGACGTCTGG	CARDPYNCITIFGVVSYYYYYMDVW	IGHV1-18	IGHJ6
TGTGCGAAAGATAAATTGGGGAGCTATGGTTCAGGGAGTTATTACTTGACCTACTACTTTGACTACTGG	CAKDKLGSYGSGSYYLTYYFDYW	IGHV3-NL1	IGHJ4
TGTGCGAAAAGGAGACAAGAAGCAGCTCGGAAGACGCTTGGTACGGTGTTCATGGACGTCTGG	CAKRRQEAARKTLGTVFMDVW	IGHV3-NL1	IGHJ6
TGTGCGTTTATAGCAGCAGCTGGTAAGTACTACTTTGACTACTGG	CAFIAAAGKYYFDYW	IGHV4-34	IGHJ4
TGTGCAAGAGGGCGGGCTCCTTCGATGACAGGATATTGTAGTAGTACCAGCTGCCCCCCCATCCGGGGAATGACCAAGATAATGGACGTCTGG	CARGRAPSMTGYCSSTSCPPIRGMTKIMDVW	IGHV1-45	IGHJ6
TGTACCACGGGGGCTTCACCGGTGAAGACGGGGATAGTGGTGGTAGCTGCTACTCCTTGTTCTATCTGGTTCGACCCCTGG	CTTGASPVKTGIVVVAATPCSIWFDPW	IGHV3-15	IGHJ5
TGTGCTAGAGTCCACTTTCTCCCCACGTATTACTATGATAGTAGTGGTTATTATTGGGGGGAATACTTCCAGCACTGG	CARVHFLPTYYYDSSGYYWGEYFQHW	IGHV3-72	IGHJ1
TGTGCGAAAGATTCCCGGCATGACTACAGTAACTGCAAAGGGTTTGACTACTGG	CAKDSRHDYSNCKGFDYW	IGHV3-NL1	IGHJ4
TGTGCGAGTGGTAGTGGTGGTAGCGGACAAACAATCGGGGACTACTGG	CASGSGGSGQTIGDYW	IGHV1-46	IGHJ4
TGTGCGAGAAGGCTTACGGTGACTAGGTTCTGGACCGATGCTTTTGATATCTGG	CARRLTVTRFWTDAFDIW	IGHV4-38-2	IGHJ3
TGTGCGAGAGAGTCCTATTGTAGTGGTGGTAGCTGCCGCCCATTTGACTACTGG	CARESYCSGGSCRPFDYW	IGHV4-59	IGHJ4
TGTGCGAGAGATTGGGAATGTAGTGGTGGTAGCTGCTACTACTTTCAGGGTTTCTACTGG	CARDWECSGGSCYYFQGFYW	IGHV1-18	IGHJ4
TGTGCGAGAGATCACCCCCCAGTGGTTATTACTACTGATGATGCTTTTGATATCTGG	CARDHPPVVITTDDAFDIW	IGHV1-69	IGHJ3
TGTGCGAGAGATGATCCCTCGCTATGGTTCAGGGAGTTATTAGGAAGTTCGCTCTACTGG	CARDDPSLWFRELLGSSLYW	IGHV3-53	IGHJ4
TGTGCGAGAGTTATAGTCTATAACTGGAACGACGACGTCGAATGCCGCTCCTGG	CARVIVYNWNDDVECRSW	IGHV5-51	IGHJ3
TGTACCACAGATCCTCACCTAGCGCCGCACTTTGACTACTGG	CTTDPHLAPHFDYW	IGHV3-15	IGHJ4
TGTGCGAGATCCCTGCGGCCCGTCATATTGTGCCGTGACTACTGG	CARSLRPVILCRDYW	IGHV1-18	IGHJ4
TGTGCGAGAAGGGGAGCACCTTGTACTAATGGTGTCCTGGTGCCCTGCTTTGACTACTGG	CARRGAPCTNGVLVPCFDYW	IGHV1-2	IGHJ4
TGTGCGAGAGGCCTATGTTCCGGGAGGGATATTGTAGTAGTACCAGCTGCTATGGTAAAAAGGCGTGCTTTAAGCTCTAACGTCATAAACTACTTTGACTACTGG	CARGLCSGRDIVVVPAAMVKRRALSSNVINYFDYW	IGHV3-53	IGHJ4
TGTGCAAAAGATAACCACAGAGGATTGCATGATTACATTTGGGGGAGTTATCGTGAGGCCAAAGTTCATTTTGACTACTGG	CAKDNHRGLHDYIWGSYREAKVHFDYW	IGHV3-43	IGHJ4
TGTGCAAGAGCGCCGGGTATAGCAGTGGCTGGTGAGAGTGCTTTTGATATCTGG	CARAPGIAVAGESAFDIW	IGHV3-13	IGHJ3
TGTGCGAGAGATGAGTTTACCGGGGACTACAGTAACGGGGCGTACCGTGACGTTTACTACTTTGACTACTGG	CARDEFTGDYSNGAYRDVYYFDYW	IGHV1-18	IGHJ4
TGTGCGAACCTCCCCCTTACGATTTTTGGAGTGGTTATTATAACGTACTACTACTACTACATGGACGTCTGG	CANLPLTIFGVVIITYYYYYMDVW	IGHV3-23	IGHJ6
TGTACTAGACGATTTAAATTAGTATTACTATGGTTCAGGGAGTTATTATGGATAATTAGGGGGGCTTTTGATATCTGG	CTRRFKLVLLWFRELLWIIRGAFDIW	IGHV3-73	IGHJ3
TGTGCGAGAGCCGGGGTACAGTATAACTGGAACTACGTAGATTACTACTACTACTACTACATGGACGTCTGG	CARAGVQYNWNYVDYYYYYYMDVW	IGHV1-3	IGHJ6
TGTACTAGAGAGAGAGCTGGCCATTCCACCGGCGCTAGTAGTGGTTCCTCGACCTACTTTGACTACTGG	CTRERAGHSTGASSGSSTYFDYW	IGHV3-49	IGHJ4
TGTGCGAGATATAGCAGTGGCTGGCGGGACTACTGG	CARYSSGWRDYW	IGHV5-10-1	IGHJ4
TGTGCGAGAGCTATTGTAGTAGTACCAGCTGCTATGTGCCTTCGAGTATACGGATACTACTACTACTACATGGACGTCTGG	CARAIVVVPAAMCLRVYGYYYYYMDVW	IGHV3-53	IGHJ6
TGTGCGGGGCAGAGTATAGCAGTGGCTGGTACTACTACCCGCTGTTTTGACTACTGG	CAGQSIAVAGTTTRCFDYW	IGHV1-3	IGHJ4
TGTACCACAGATCCTGAGGAGTTCTATAGCAGCGAAAAAGGCTTTGACTACTGG	CTTDPEEFYSSEKGFDYW	IGHV3-15	IGHJ4
TGTGCAAGAGCGATCGACCCCCCGGATTATGATTACATTTGGGGGAGTTATCGTTATTCCTACTGG	CARAIDPPDYDYIWGSYRYSYW	IGHV3-74	IGHJ4
TGTGCGAGACCGGGAGGGCCTATGATAGTAGTGGTTATGGGCTACTACTTTGACTACTGG	CARPGGPMIVVVMGYYFDYW	IGHV5-51	IGHJ4
TGTGCGACAGCGGTGGTAGCTGCTACTCGGACGGTGGACTACTGG	CATAVVAATRTVDYW	IGHV7-4-1	IGHJ4
TGTGCGAAAGGATCGACCCACGATTTTTGGAGTGGTTTAACGGGCCACTGG	CAKGSTHDFWSGLTGHW	IGHV3-23	IGHJ5
TGTACCACAGGATCGGAGACCAGCTGCTACGGAGTCGACCCCTGG	CTTGSETSCYGVDPW	IGHV3-15	IGHJ5
TGTGCGAGAGAAATTATTGTAGTAGTACCAAACGGGGGACGTAGCCGGTGGGCGCTAATTGCTTTTGATATCTGG	CAREIIVVVPNGGRSRWALIAFDIW	IGHV3-20	IGHJ3
TGTGCGAGTTACGATTTTTGCCGGGGGACCGTCATTAACTACTACTACATGGACGTCTGG	CASYDFCRGTVINYYYMDVW	IGHV1-3	IGHJ6
TGTACCACAGACCAGGTCGTTATTACTATGGTTCAGGGAGTTATTATAACGGGGTCCTATGACTACTGG	CTTDQVVITMVQGVIITGSYDYW	IGHV3-15	IGHJ4
TGTGCAAGAGGCCCTAAGCCCATAGCAGTGGCTGGTAGGGATAAAACCTGGTTCGACCCCTGG	CARGPKPIAVAGRDKTWFDPW	IGHV3-13	IGHJ5
