TGTGCGAGAGGAAATAGCAGTGGCTGTTGGGTACTTGCATACTACTTTGACTACTGG	CARGNSSGCWVLAYYFDYW	IGHV3-21	IGHJ4
TGTGCGAGAGATGGATTAGGCGTATTACTATGGTTCAGGGAGTTAGCTTACTACTTTGACTACTGG	CARDGLGVLLWFRELAYYFDYW	IGHV1-3	IGHJ4
TGTGCGAGAGATGGTGGATCCAGTGGTGGTAGCTGCAACGTGGCCCTATTTGACTACTGG	CARDGGSSGGSCNVALFDYW	IGHV3-7	IGHJ4
TGTGCGAACCTATTACGATTTTTGGAGTGGTTATTATTTTGGGGTCAGGGTACGGGCCGTCTCATACATTACTACTACTACTACTACATGGACGTCTGG	CANLLRFLEWLLFWGQGTGRLIHYYYYYYMDVW	IGHV3-74	IGHJ6
TGTGATCTTTCGGGTTTCAGTAGTGGTTATTACTTCCTTTACCCGGGGCGTCGCGCCGGAGATGATGCTTTTGATATCTGG	CDLSGFSSGYYFLYPGRRAGDDAFDIW	IGHV3-30	IGHJ3
TGTGCGAGAGATTTAGTCCCATGGTTCAGGGAGTTAAGTCTGTGGGCTGAGCGGCGGGCTAATTTGGATGCTTTTGATATCTGG	CARDLVPWFRELSLWAERRANLDAFDIW	IGHV3-48	IGHJ3
TGTGCGAGAGCTCTATTGGATATTGTAGTGGTGGTAGCTGCTACGTTACGCCCGCGCTTAACTGCTTTTGATATCTGG	CARALLDIVVVVAATLRPRLTAFDIW	IGHV3-11	IGHJ3
TGTGCGAGTAGATACCATGAAGGCGATAGTGGCTACGATGGTGTGGCCTACTACATGGACGTCTGG	CASRYHEGDSGYDGVAYYMDVW	IGHV1-18	IGHJ6
TGTGCAAGAGATTGGGGGGGAGAATATTACTATGATAGTAATGGGGGGGTTTGCGAGAACTTTGACTACTGG	CARDWGGEYYYDSNGGVCENFDYW	IGHV3-74	IGHJ4
TGTGCAAGAGATCCCGGGACTGATGTTGGTTATTACGTGTACAACTGGTTCGACCCCTGG	CARDPGTDVGYYVYNWFDPW	IGHV6-1	IGHJ5
TGTGCGAGAGCTTTCCGGCCGGGTAGCTGCTACTCCCCTGAACGTTGCACTTGCTACTACTACTACATGGACGTCTGG	CARAFRPGSCYSPERCTCYYYYMDVW	IGHV1-3	IGHJ6
TGTGCGAGAGAGATATTATATTACGATTTTTGGAAAAACTGGTTCGACCCCTGG	CAREILYYDFWKNWFDPW	IGHV4-34	IGHJ5
TGTGGAAACGATATAGTGGCTACGAGGGGGACTCTTGATGCTTTTGATATCTGG	CGNDIVATRGTLDAFDIW	IGHV3-20	IGHJ3
TGTGCGAGGGGGGATAGCAGTGGGAATGGTACCAACTTTGACTACTGG	CARGDSSGNGTNFDYW	IGHV7-4-1	IGHJ4
TGTGCACATCGGGAACATTACGATTTTTGGAGTGGTGGGTTAAGGTACTACTACTACATGGACGTCTGG	CAHREHYDFWSGGLRYYYYMDVW	IGHV2-5	IGHJ6
TGTGCGAAAGATCACTTACGATTTTTGGAGTGGTTATTATTATTTGGACTATGG	CAKDHLRFLEWLLLFGLW	IGHV3-NL1	IGHJ5
TGTGCGAGAGATCTTGTGGATATTGTAGTAGTACCAGCTGGACCTAACTACTACTACTACTACATGGACGTCTGG	CARDLVDIVVVPAGPNYYYYYMDVW	IGHV3-64	IGHJ6
TGTGCAAGAGATCCCCCCGAACTGGGGATCGTTTACTACTACTACTACTACATGGACGTCTGG	CARDPPELGIVYYYYYYMDVW	IGHV3-74	IGHJ6
TGTACTAGAGGCCCTGGAAGTAGCCTCTTACGGGGTTTTTGGAGTGGTTATTGTTTGTCCAATGTGGATTGGACGACTGGTCCCGACTGGTTCGACCCCTGG	CTRGPGSSLLRGFWSGYCLSNVDWTTGPDWFDPW	IGHV3-49	IGHJ5
TGTGCGAGAGATGTAGTAGTACCAGCTGCTATGCTCCAGTTTTACTACTACTACTACTACATGGACGTCTGG	CARDVVVPAAMLQFYYYYYYMDVW	IGHV1-2	IGHJ6
TGTGCGAGAATTGTTGTAGTAGTACCAGCTGCTATGGCATTCCTGCTGTACTACTACTACTACATGGACGTCTGG	CARIVVVVPAAMAFLLYYYYYMDVW	IGHV5-10-1	IGHJ6
TGTGCGAGACGAACTCCTGGATATTGTAGTGGTGGGACCTGGTTCGACCCCTGG	CARRTPGYCSGGTWFDPW	IGHV5-10-1	IGHJ5
TGTGCGAGAGATAGGACCCCGACGGCCCGGTTCTACTGG	CARDRTPTARFYW	IGHV4-59	IGHJ4
TGTGCACACGTACGTAACTACACCGATAGACACCGGACGAGTATCTACTGG	CAHVRNYTDRHRTSIYW	IGHV2-5	IGHJ4
TGTGCGATAAACTCAGCCCGAACGGTGACTGGGGCTGCTTTTGATATCTGG	CAINSARTVTGAAFDIW	IGHV1-46	IGHJ3
TGTGCGAAACTTGCCAGCTGTGTAAGCCATCGAACCGGACACTGGGGGCAAGTTATAGCAGCGCGAGCCCGTCTCAACTGGTTCGACCCCTGG	CAKLASCVSHRTGHWGQVIAARARLNWFDPW	IGHV3-NL1	IGHJ5
TGTGCGAGGCCGTATAGTATGATGGTGACTGCTATTCTTGACTACTGG	CARPYSMMVTAILDYW	IGHV3-53	IGHJ4
TGTGCGAAAGGGAATTACTATGATAGTAGTGGTTATTACTACGGAAAAGAACGCCATGGGGCCCTATACTTTGACTACTGG	CAKGNYYDSSGYYYGKERHGALYFDYW	IGHV3-NL1	IGHJ4
TGTGCGAAAGATCTGGTTGTAGTGGTGGTAGCTGCTACTCCGCCCTACTTTGACTACTGG	CAKDLVVVVVAATPPYFDYW	IGHV3-23	IGHJ4
TGTGCGAGAGAGTTTTTGCGATTTTTGGAGTGCATCCGTGAGTGG	CAREFLRFLECIREW	IGHV1-69	IGHJ4
TGTGCGAGACCTTACGGCTTAAAACCTACGGTGACTACGAGTGATGACTACTGG	CARPYGLKPTVTTSDDYW	IGHV5-51	IGHJ4
TGTGCCAGTGTCCGGGGGCACACACGCGGGGGACCCCACGAGAGTGTTAGTCTGGGCATTGTAGTAGTACCAGCTGCCACCGGGGGGAGAAGAATCTGGTTCGACCCCTGG	CASVRGHTRGGPHESVSLGIVVVPAATGGRRIWFDPW	IGHV1-46	IGHJ5
TGTGCGAGATATCCATCTGGGTTAAAACCGTTAATTTTGACGAGCCTTGACTACTGG	CARYPSGLKPLILTSLDYW	IGHV4-38-2	IGHJ4
TGTACCACAGAGATAGCAGCAGCTGGTAACCTTCCGAGGTTTGACTACTGG	CTTEIAAAGNLPRFDYW	IGHV3-15	IGHJ4
TGTGCGAGATTACTATGGTTCGGGGAGGAGGACAACTGGTTCGACCCCTGG	CARLLWFGEEDNWFDPW	IGHV1-2	IGHJ5
TGTGCGAGACAATCCCGAGTATTACGATTTTTGGAGTGGCGGGGGCTCGATGATGCTTTTGATATCTGG	CARQSRVLRFLEWRGLDDAFDIW	IGHV4-34	IGHJ3
TGTGCGAAAGATCTTTCAGAGTTGAACTTTTGGAGTGGTTATTATATCCGGCCGGTCTGGAACAACTGGTTCGACCCCTGG	CAKDLSELNFWSGYYIRPVWNNWFDPW	IGHV3-NL1	IGHJ5
TGTGCGAGTATCAGAATCACGATTTTTGGAGTGGTTATTATACGCAGAGTCGTTGACTACTGG	CASIRITIFGVVIIRRVVDYW	IGHV3-7	IGHJ4
TGTGCGAGGCGGACGATATTACGATATTTTGACTGGTTATTCGAACTTTGG	CARRTILRYFDWLFELW	IGHV1-2	IGHJ4
TGTGCGAAAGATCCCCGTAGTGGTGGTAGCTGCTGTTACTGGTTCGACCCCTGG	CAKDPRSGGSCCYWFDPW	IGHV3-23	IGHJ5
TGTGCGAGACCCTTGGCAGTACCAGATTGGGAGGGGGGGGCGATTGAACGAATCAGTTTAGGATATTGTAGTGGTGGTAGCTGCTACGTCCGGTATTTTGAGTACTACTTTGACTACTGG	CARPLAVPDWEGGAIERISLGYCSGGSCYVRYFEYYFDYW	IGHV5-51	IGHJ4
TGTGCAACCTCAAACGGGCCGTCGGGAATTGATGCTTTTGATATCTGG	CATSNGPSGIDAFDIW	IGHV6-1	IGHJ3
TGTGCACACAGACAGAGCGCCGAATGGTTCAGGACGAGCTACTACTACTACTACATGGACGTCTGG	CAHRQSAEWFRTSYYYYYMDVW	IGHV2-5	IGHJ6
TGTGCGAGAGTCGGCATTATATATTGTAGTGGTGGTAGCTGCTTGTTATCTGAATACTACTACTACTACTACATGGACGTCTGG	CARVGIIYCSGGSCLLSEYYYYYYMDVW	IGHV3-21	IGHJ6
TGTGCGAGAGGCGCTATATTCCATTACGATATTTTGACTGGTTATTATACAACCGGGAGGTGGGCAGCTTTTGATATCTGG	CARGAIFHYDILTGYYTTGRWAAFDIW	IGHV4-34	IGHJ3
TGTGCGAGAGAGGGCGGGGGGGCCGCGTATAGCAGCAGCTGTGACTTTGACTACTGG	CAREGGGAAYSSSCDFDYW	IGHV1-46	IGHJ4
TGTGCGAGAAGGTGGTATAGCAGCAGCTGGTACGATAGGGGACTGTCGTACTACTTTGACTACTGG	CARRWYSSSWYDRGLSYYFDYW	IGHV4-38-2	IGHJ4
TGTGCGAGAGATATTGGATTTTTGGAGTGGTTATTCTTTGTTGACTACTGG	CARDIGFLEWLFFVDYW	IGHV3-7	IGHJ4
TGTGCGAGAGATCCAGGACTCCTTACTATGGTTCAGGGAGTTATTATAATCCGGAAATACTACATGGACGTCTGG	CARDPGLLTMVQGVIIIRKYYMDVW	IGHV3-53	IGHJ6
TGTACCACAGGCATCCCATATTGTAGTGGTGGTAGCTGCTTTGACTACTGG	CTTGIPYCSGGSCFDYW	IGHV3-15	IGHJ4
TGTGCGAGAGATGACATAGCAGTGGCTGGGATGGACGTCTGG	CARDDIAVAGMDVW	IGHV4-61	IGHJ6
TGTGCGAGAGATCTTCCGTATTATGATTACATTTGGGGGAGTTATACCGGTTACTACATGGACGTCTGG	CARDLPYYDYIWGSYTGYYMDVW	IGHV3-53	IGHJ6
TGCCCGAACAGGGTTCGGGGAGTTAGTCATAGGGATGCTTTTGATATCTGG	CPNRVRGVSHRDAFDIW	IGHV4-39	IGHJ3
TGTGCGAGACGGATTTTTGGAGTGGTTATTGGGTGGGGGGATGCTTTTGATATCTGG	CARRIFGVVIGWGDAFDIW	IGHV5-51	IGHJ3
TGTGCGAGAGATCGGGTCAAGTTGAATTACTATGATAAGTTGTTTGACTACTGG	CARDRVKLNYYDKLFDYW	IGHV3-66	IGHJ4
TGTGCGAGATCTTCACCGAGCCTTCTAGGAGCACCGTCGAGGGACGTATTACTATGGTTCAGGGAGTTATTATGTTTCGGTTTCCTCCGGGATGAACGGTACTACTACTACTACATGGACGTCTGG	CARSSPSLLGAPSRDVLLWFRELLCFGFLRDERYYYYYMDVW	IGHV4-61	IGHJ6
TGTGCGAGTCAAGGGGTAGTAGTACCAGCTGCTAGCCGCCGACGGACGGCCCCCTATGACTACTGG	CASQGVVVPAASRRRTAPYDYW	IGHV3-21	IGHJ4
TGTGCGAGACCCAGCGTGCTCGTCCGAAGGATCCCTTCGTACTACTACTACTACATGGACGTCTGG	CARPSVLVRRIPSYYYYYMDVW	IGHV5-51	IGHJ6
TGTGCGAGAGAGTCGGGGGGAGCCGCAGCGCATTTACGATTTTTGGAGTGGTTATTATACCGAGGAAGGTACTTTGACTACTGG	CARESGGAAAHLRFLEWLLYRGRYFDYW	IGHV4-59	IGHJ4
TGTGCAAGAGAGGGTATTGTAGTGGTGGTAGCTGCTAAGGGGATTGACTACTGG	CAREGIVVVVAAKGIDYW	IGHV3-74	IGHJ4
TGTGCGAAAAGTTGGGAGACTATGGTTCGGGGAGTTATTATATCTGAACCAATGTTAAACTGGTTCGACCCCTGG	CAKSWETMVRGVIISEPMLNWFDPW	IGHV3-NL1	IGHJ5
TGTGCGAAAAGCAGTGGCTGGTACCCTATTGACTACTGG	CAKSSGWYPIDYW	IGHV3-23	IGHJ4
TGTGCGAATCTAGGGTGTCTGGTGGTGTATACAACCTACTTTGACTACTGG	CANLGCLVVYTTYFDYW	IGHV3-21	IGHJ4
TGTGCGAGAGAACCCACCAGGGGCCAGTATTACGATTTTTGGAGTGGAGTTTTCTTCTACTGG	CAREPTRGQYYDFWSGVFFYW	IGHV3-53	IGHJ4
TGTGCGAGAGATCTACGGGAACCCGTATTACTATACCTTCATTACTACTACTACTACTACATGGACGTCTGG	CARDLREPVLLYLHYYYYYYMDVW	IGHV3-30	IGHJ6
TGTGCGAGACTCGATATTGTAGTGGTGGTAGCTGCTACTCCGAAGTTCCGACCCAGCTCCTACTGG	CARLDIVVVVAATPKFRPSSYW	IGHV4-59	IGHJ4
TGTGCGAGATGCTCCCGTCGGATTACTATGACCCTTAAGTTCACCTACTACTTTGACTACTGG	CARCSRRITMTLKFTYYFDYW	IGHV7-4-1	IGHJ4
TGTGCGAGAGATGAAGACCAGTCATTACGATTTTTGGAGTGGTTATCGGTATTTGACTACTGG	CARDEDQSLRFLEWLSVFDYW	IGHV1-18	IGHJ4
TGTGCGAGACCAATTCGATATTGTAGTAGTACCAGCTGCTATGTCGTACCATATAACTGGTTCGACCCCTGG	CARPIRYCSSTSCYVVPYNWFDPW	IGHV4-34	IGHJ5
TGTGCGAGAACTTATACATACTGGTACTTCGATCTCTGG	CARTYTYWYFDLW	IGHV4-28	IGHJ2
TGTGCGAGAGGGAGTGTAAAGAGGAACCCCAAAGAGTATAGCAGCAGCTGGTACATAGATATCTGG	CARGSVKRNPKEYSSSWYIDIW	IGHV3-21	IGHJ3
TGTGCGAAAGATCCGCCAGCCGGTTTCGATAGTAGTGGTTATTACTTGGCCGATCACCTGTACTACTTTGACTACTGG	CAKDPPAGFDSSGYYLADHLYYFDYW	IGHV3-23	IGHJ4
TGTGCGAAACCGGTTACTATGGTTCGGGGAGTTATTCTTTACATTGACTACTGG	CAKPVTMVRGVILYIDYW	IGHV3-23	IGHJ4
TGTGCGAGACTCCCCCCTATTACTATGGTTCAGGGAGTTATTCTCTGGTTCGACCCCTGG	CARLPPITMVQGVILWFDPW	IGHV1-46	IGHJ5
TGTGCGAGAGACCTGGTGGTAGCTGCTACCCCCTACTACTACTACATGGACGTCTGG	CARDLVVAATPYYYYMDVW	IGHV3-11	IGHJ6
TGTGCAAGAGGTGTAGTACCAGCTGCTCTGCTCCCGTATGCTTTTGATATCTGG	CARGVVPAALLPYAFDIW	IGHV3-74	IGHJ3
TGTACCACAGATCTGTGTGGTGGTGACTGCTATTCTCACTACTTTGACTACTGG	CTTDLCGGDCYSHYFDYW	IGHV3-15	IGHJ4
TGTGCAAGAGCCAGCCCGGCAGTGGCTGGCTTTGACTACTGG	CARASPAVAGFDYW	IGHV3-13	IGHJ4
TGTGCGAGCTTGTGTCGCAGCTGGTACAGCGTGCAGGAACGCTGG	CASLCRSWYSVQERW	IGHV4-4	IGHJ5
TGTACCACAGATAGACCAGGTATAGCAGCTCGTCCGATCTCCAACTACGTCTACTGG	CTTDRPGIAARPISNYVYW	IGHV3-15	IGHJ4
TGTGCGAGAGATCCATCTACAGTCGTATCTGACCCATATAGAACTAACTGGTTCGACCCCTGG	CARDPSTVVSDPYRTNWFDPW	IGHV1-2	IGHJ5
TGTAACGGTGATATTGTAGTAGTACCAGCTGCTATCCTTGGGGACTACTACTACTACTACATGGACGTCTGG	CNGDIVVVPAAILGDYYYYYMDVW	IGHV3-30-3	IGHJ6
TGTGCGAGACGGCCCACAAGGCGTATTACGATTTTTGGAGTGGTTATTATCGATGGGTTCCCCTACTGG	CARRPTRRITIFGVVIIDGFPYW	IGHV4-38-2	IGHJ4
TGTGCGAGATCTTGTCCGGTATTACTATGGTTCGGGGAGTTATTATGGTTCGACCCCTGG	CARSCPVLLWFGELLWFDPW	IGHV1-3	IGHJ5
TGTGCGAAAGAGCCCCTACCAAGATTGGTCTCGCCCCCATATAGCAGTGGCTGTCAATTTCACAATGACTACTGG	CAKEPLPRLVSPPYSSGCQFHNDYW	IGHV3-NL1	IGHJ4
TGTGCGAGACGCAAACTATGGTTCAGGGAGTTATGCTTTGACTACTGG	CARRKLWFRELCFDYW	IGHV5-51	IGHJ4
TGTGCGAAACGGTCCAGGTTAGCAGTGGCGCCCATATGGTTCGACCCCTGG	CAKRSRLAVAPIWFDPW	IGHV3-23	IGHJ5
TGTGCGAGATTTAGTGGGAGCTACGGCTACTGG	CARFSGSYGYW	IGHV4-38-2	IGHJ4
TGTGCGAGAGTTTTTGGAGTGGTTATTATCGAGTACTACATGGACGTCTGG	CARVFGVVIIEYYMDVW	IGHV3-7	IGHJ6
TGTGCGAGACATAGAGACCGCCCAGCAGTGGCTGCCCACTGGTTCGACCCCTGG	CARHRDRPAVAAHWFDPW	IGHV4-39	IGHJ5
TGTGCGAGTAACCCTGGCACGGAGACCACATACTACTACTACTACATGGACGTCTGG	CASNPGTETTYYYYYMDVW	IGHV5-51	IGHJ6
TGTGCGCCGAACGATATTGTAGTGGTGGTAGCTGCTACTAGGGGGGGCTACTGG	CAPNDIVVVVAATRGGYW	IGHV4-39	IGHJ4
TGTGCGAGAATTACTATGATAGTAGTGGTTATCGTTGACTACTGG	CARITMIVVVIVDYW	IGHV4-38-2	IGHJ4
TGTGCGAGAGAACCTGGACTCTGCACGTATTACTATGGTTCAGGGAGTTATTACTCGAACTGGTTCGACCCCTGG	CAREPGLCTYYYGSGSYYSNWFDPW	IGHV1-69	IGHJ5
TGTGCGAGATTATTACGATTTTTGGAGTGGTTATTATACGGGTTGTCAGGCTCTGTGTCCTGGGCCGTTTGGAGAAAGTTTGACTACTGG	CARLLRFLEWLLYGLSGSVSWAVWRKFDYW	IGHV4-39	IGHJ4
TGTGCGAGGTGGGGCTGGACTGATAGCAGCTCGTGCTTTCGTTTTGACTACTGG	CARWGWTDSSSCFRFDYW	IGHV4-39	IGHJ4
TGTGCGAGATGTAGAGATGGCTACAATGAATTTGACTACTGG	CARCRDGYNEFDYW	IGHV7-4-1	IGHJ4
TGTACTAGACGTTGCCGGCCCATTACGATTTTTGGAGTGGTGGGATACTACTTTGACTACTGG	CTRRCRPITIFGVVGYYFDYW	IGHV3-73	IGHJ4
TGTGCGAAAGGGGGCTACGTATTACGATTTTTGGAGTGGTTACGCTACTACTTTGACTACTGG	CAKGGYVLRFLEWLRYYFDYW	IGHV3-23	IGHJ4
TGTGCGAAAGATACTGGCAGAGGATATTGTAGTAGTACCAGCTGCTATGGTCACTACTACTACATGGACGTCTGG	CAKDTGRGYCSSTSCYGHYYYMDVW	IGHV3-NL1	IGHJ6
