TGTGCGAGACCTCCTGGGGCGAGATGGCTACAATTTAGTACATGTGTTGGGGCTGACTACTGG	CARPPGARWLQFSTCVGADYW	IGHV7-4-1	IGHJ4
TGTGCGAGTGGCCCCGGGGTAGCTGCTACCTCGCGGCCCCGCGAACCGGGGGGGGACACCCAGGATTACTACTTTGACTACTGG	CASGPGVAATSRPREPGGDTQDYYFDYW	IGHV4-39	IGHJ4
TGTGCGAGTTCGCATTACGATATTTTGACTGGTTGGGTAATAGGGGGATGGTTCGACCCCTGG	CASSHYDILTGWVIGGWFDPW	IGHV1-2	IGHJ5
TGTGCGAGAGATCCCCCCACTTTGCACCAAGTATTACGATTTTTGGAGTGGTTATTATGGGAAACCAAGGGCTTTGACTACTGG	CARDPPTLHQVLRFLEWLLWETKGFDYW	IGHV3-21	IGHJ4
TGTGCGAAAGATCCAAAAGGGGAGACTACGGTGACTACTTTTTACTACATGGACGTCTGG	CAKDPKGETTVTTFYYMDVW	IGHV3-23	IGHJ6
TGTGCACACAGACGCTCGGTTGGTTTGGGGGCCTCCTTTGACTACTGG	CAHRRSVGLGASFDYW	IGHV2-5	IGHJ4
TGTGCGAGAGACCCGCTTATAGCAGCTCACGACTTTGACTACTGG	CARDPLIAAHDFDYW	IGHV4-34	IGHJ4
TGTGCGAGAGGACCGTGGTCTACGGTGACTACAGGGCGGCCTTGCTACTGG	CARGPWSTVTTGRPCYW	IGHV4-34	IGHJ4
TGTGCGAGAGTAAGGATGGATATTGTAGTGGTGGTAGCTGCTACTTCTTCCTTTGATGCTTTTGATATCTGG	CARVRMDIVVVVAATSSFDAFDIW	IGHV3-20	IGHJ3
TGTGCGAGACCCTACCGACACCACTACGGTGACTACGTACATATGTTCCAGCACTGG	CARPYRHHYGDYVHMFQHW	IGHV4-39	IGHJ1
TGTGCGAGAGGACGGGTTCGGGGAGTTAACGCTCGGGGGGCGCCGTTATTTCAATTTCGTCCTGTTTTCCGGTATGCTTTTGATATCTGG	CARGRVRGVNARGAPLFQFRPVFRYAFDIW	IGHV1-3	IGHJ3
TGTGCGAGAGTTTACGATATTTTGACTGGTTATTACCGTAATCGGGCCAATCACTTTGACTACTGG	CARVYDILTGYYRNRANHFDYW	IGHV3-53	IGHJ4
TGTGCTTTAATAGTAGTGGTTAGAATGAGGGCCATTCCCGCAGCCTGG	CALIVVVRMRAIPAAW	IGHV3-13	IGHJ4
TGTGCTCCCGGCAGCCGGAGCAGCAGCTGCTGGAGCTACTGG	CAPGSRSSSCWSYW	IGHV5-10-1	IGHJ4
TGTGCGAGAGTCGTTGGGGATATAGCAGTGGCTGGTTGTCCCTACTTTGACTACTGG	CARVVGDIAVAGCPYFDYW	IGHV3-66	IGHJ4
TGTGCGAGAGCTTTAATAGGGTGGATACAGCTATGGTGGTTGAACTGGTTCGACCCCTGG	CARALIGWIQLWWLNWFDPW	IGHV1-18	IGHJ5
TGTGCGAGACATGCGGCAGTGGCTGGTATGCAAGACCCAAGTGACTACTGG	CARHAAVAGMQDPSDYW	IGHV5-51	IGHJ4
TGTGCGAGAGATGGCGACGGTGACTACGCCACTATTTTTGACTACTGG	CARDGDGDYATIFDYW	IGHV3-7	IGHJ4
TGTGCGAGAGGCGAGTCCGCAGTGAGGTTATTAGTGGGGGGGCGGTTTGACTACTGG	CARGESAVRLLVGGRFDYW	IGHV3-21	IGHJ4
TGTACCGGACCCCAATATTGTAGTAGTACCAGCTGCGCCCCCTGGTTCGACCCCTGG	CTGPQYCSSTSCAPWFDPW	IGHV3-9	IGHJ5
TGTGCGAAAGACTTTGGACGGGGTAACTCCACCCGCTACTGG	CAKDFGRGNSTRYW	IGHV3-NL1	IGHJ4
TGTGCGAGAGATCCGGGGAGGAGTGTGGGTAAATACCTCTACTACTACTACATGGACGTCTGG	CARDPGRSVGKYLYYYYMDVW	IGHV1-69	IGHJ6
TGTGCGAGAGATCACCCCGGTAGTACCAGCTGCCCACTGAACTTAATCTTGTTTGACTACTGG	CARDHPGSTSCPLNLILFDYW	IGHV1-2	IGHJ4
TGTGCGAGAGAAGGACCGCGTAGGCACTTTCGGGATTCGCAACTTTATAAGTACTACTTTGACTACTGG	CAREGPRRHFRDSQLYKYYFDYW	IGHV3-30	IGHJ4
TGTGCACGTGTTCGGTTTGTAGTAGTACCAGCTGCTGGGTACTTCGATCTCTGG	CARVRFVVVPAAGYFDLW	IGHV2-26	IGHJ2
TGTACTAGAGAACTCGTCAAGGCCCATATTGTAGTGGTGGTAGCTGCTCGGAAAGGGCGAGACAACGATGCTTTTGATATCTGG	CTRELVKAHIVVVVAARKGRDNDAFDIW	IGHV3-49	IGHJ3
TGTGCGAGAGAGAGCCCCGGGGTTAGCAGGGTATTACTAGGATATTGTACTGGTGGTGTATGCTATACTGACTACTGG	CARESPGVSRVLLGYCTGGVCYTDYW	IGHV3-7	IGHJ4
TGTGCGAGAGCAAGCTTCGGCTACGATTCCCCCTCCTTTGACTACTGG	CARASFGYDSPSFDYW	IGHV4-34	IGHJ4
TGTGCGAGCTTGACTAATGGTGTATGCAGGGTAATACGGAACTGGTTCGACCCCTGG	CASLTNGVCRVIRNWFDPW	IGHV3-7	IGHJ5
TGTGCGAGACTGGATTTTCTAGGTTCGATCGGATATTGTAGTAGTACCAGCCCTTGGTACCGAAAAGACTACTGG	CARLDFLGSIGYCSSTSPWYRKDYW	IGHV5-51	IGHJ4
TGTACTAGACCGATTACTATGATAGTAGTGGTTAGGGCGTTTAGGATATACTACTGG	CTRPITMIVVVRAFRIYYW	IGHV3-73	IGHJ4
TGTGCGAGAAATCTCGGCGGGGAGGGGTGGCTGGTACGGGAGCAACCCGAGTTGTACTGG	CARNLGGEGWLVREQPELYW	IGHV3-53	IGHJ4
TGTGCGAAAGATCTCCCCCTAGTTCAGTGGGAGCTACCCTTTAGGGGCTACTGG	CAKDLPLVQWELPFRGYW	IGHV3-NL1	IGHJ4
TGTGCGAGAGGGAAGGATATTGTAGTGGTGGTAGCTGCTACTCCTCAGTTCACCCGTAATGCTTTTGATATCTGG	CARGKDIVVVVAATPQFTRNAFDIW	IGHV1-69	IGHJ3
TGTGCGAGAGGGTATCGGCTCGTCCGGGACTACTTTGACTACTGG	CARGYRLVRDYFDYW	IGHV4-59	IGHJ4
TGTGCGAGGTCCAGTTTTGGGGTTCAGGGAGTTATTATAACGGATTGTGACTACTGG	CARSSFGVQGVIITDCDYW	IGHV4-4	IGHJ4
TGTGCGAAAGATCTGAACGATTTTTGGAGTGGTTATTATGATGCGTGGAAATTTGAGGGTCGGGAGTACTACTTTGACTACTGG	CAKDLNDFWSGYYDAWKFEGREYYFDYW	IGHV3-23	IGHJ4
TGTGCGAGCGCCGGTTCCGTACCGGTGGTAGCTGCTAACTGGTTCGACCCCTGG	CASAGSVPVVAANWFDPW	IGHV3-21	IGHJ5
TGTGCGAAAGATCTGACAGTGGCTGGGGGCTTCTGGTTTTACTGGTACTTCGATCTCTGG	CAKDLTVAGGFWFYWYFDLW	IGHV3-23	IGHJ2
TGTGCGACCCCGGAGCCCTACCCACGATATTGTAGTGGTGGTAGCTGCTACGTTGTCGAACCTTTCCAGCACTGG	CATPEPYPRYCSGGSCYVVEPFQHW	IGHV4-4	IGHJ1
TGTGCGAAAGATGGGGCCCAGCAGCTGCCAGCCCACGCATTTGACTACTGG	CAKDGAQQLPAHAFDYW	IGHV3-NL1	IGHJ4
TGTGCGAAAGATCGCTATAACTGGAACTACCTGATAGGTGACTACTGG	CAKDRYNWNYLIGDYW	IGHV3-23	IGHJ4
TGTGCGAGTGAAGCAGCAGCTGGTCCTGTGGTAGTGTACTACTTTGACTACTGG	CASEAAAGPVVVYYFDYW	IGHV3-21	IGHJ4
TGTGCGAAGCGATATTTTGACTGGTTACCAGTGGGAGGAGCCTGTGACTACTGG	CAKRYFDWLPVGGACDYW	IGHV1-46	IGHJ4
TGTGCGAAAGGCCCAGGGGAGGGATATTGTAGTAGTACCAGCTGCCCTGGTCGGATGTCTCATCTCTTCGGGAGGATGTACAACTGGTTCGACCCCTGG	CAKGPGEGYCSSTSCPGRMSHLFGRMYNWFDPW	IGHV3-NL1	IGHJ5
TGTGGGCTTAGGATATTGTACTGGTGGTGTATGCGTTTGGTGAAATGGTTCGACCCCTGG	CGLRILYWWCMRLVKWFDPW	IGHV3-30-3	IGHJ5
TGTGCAAGAGACTGGTATTACTATTGTAGTAGTACCAGCTGCTATGAAATCATTGCCTCCTGGAACCACGGTTACTGGTTCGACCCCTGG	CARDWYYYCSSTSCYEIIASWNHGYWFDPW	IGHV6-1	IGHJ5
TGTGCGAAACTAAGACCGTCAGATATTGTAGTGGTGGTAGCTGCTACTAGAGGATTTGACTACTGG	CAKLRPSDIVVVVAATRGFDYW	IGHV3-NL1	IGHJ4
TGTGCGAGACGAAGCGTTAACCAGGCCCATAACTCTGTTTTGGACTTTGACTACTGG	CARRSVNQAHNSVLDFDYW	IGHV5-51	IGHJ4
TGTGCGAGAGGCTTCCCGGGGCCATACTATGGTTCAGGGAGTTATTATAACCCCAAAATTGACTACTGG	CARGFPGPYYGSGSYYNPKIDYW	IGHV1-46	IGHJ4
TGTGCGAGACCTCGTACAGCTATGGTCCTCCGAAGTGGATCCTACGGGAGTGACTACTGG	CARPRTAMVLRSGSYGSDYW	IGHV4-59	IGHJ4
TGTGCTAGAGATCCCCGGGAAATTGGTACTATGAACAGCTTCTACTACTTTGACTACTGG	CARDPREIGTMNSFYYFDYW	IGHV3-72	IGHJ4
TGTGCGAGAGATTCCTCGTTCTTGTATTACGCCCGTAAGCAAAGTATTACGATTTTTGGAGTGGTTATTATGTACTACTACTACTACTACATGGACGTCTGG	CARDSSFLYYARKQSITIFGVVIMYYYYYYMDVW	IGHV1-69	IGHJ6
TGTGCAAGAGATCTAGCAGTGGCTGGTCACAACTGGTTCGACCCCTGG	CARDLAVAGHNWFDPW	IGHV3-13	IGHJ5
TGTGCGAGAGGGCGATTTGACTACTGG	CARGRFDYW	IGHV3-53	IGHJ4
TGTGCAAGAGCCCCGGAGCAGTGGCTGATGACGGGGGGAGCGTTCGACCCCTGG	CARAPEQWLMTGGAFDPW	IGHV3-13	IGHJ5
TGTGCGAGAAGAGCGAAGGATCAACAATCCTACGGTGACTACGTCTCGGGAGGCTGGTACTTCGATCTCTGG	CARRAKDQQSYGDYVSGGWYFDLW	IGHV3-53	IGHJ2
TGTGCACGGATCCGCAGACGATTCAGCTGCCACTTTTTGCTCGACCCCTGG	CARIRRRFSCHFLLDPW	IGHV2-26	IGHJ5
TGTGCGAAAGATTTAAAACTGGAACTGCACCGGAACTGGTTCGACCCCTGG	CAKDLKLELHRNWFDPW	IGHV3-NL1	IGHJ5
TGTGCGAGAGTGCCTCGATCTTATTGTAGTAGTACCAGCTGCTGGTCCTGGTTCGACCCCTGG	CARVPRSYCSSTSCWSWFDPW	IGHV3-11	IGHJ5
TGTACCACAGATCCCCAGACGGTGACGGAAAAGGCCTACTACTACATGGACGTCTGG	CTTDPQTVTEKAYYYMDVW	IGHV3-15	IGHJ6
TGTGCGAGACGGGGCGCTTGGGATTACTATGATAGTAGTGGTTATCATCGATACTACTTTGACTACTGG	CARRGAWDYYDSSGYHRYYFDYW	IGHV3-20	IGHJ4
TGTACTAGAAGAGGACTCTGGAGTTCGTATAGCAGCAGCTGGGTAGACTACTGG	CTRRGLWSSYSSSWVDYW	IGHV3-49	IGHJ4
TGTGCGAGACAGGGCAGCAGCATCCACTGTTACTGG	CARQGSSIHCYW	IGHV1-3	IGHJ4
TGTACCACAAATTGTATTACGATTTTTGGAGTGGTTATTATCGGAATACATTACTACTACTACTACTACATGGACGTCTGG	CTTNCITIFGVVIIGIHYYYYYYMDVW	IGHV3-15	IGHJ6
TGTGCGAGAGATGGGTTTTGTGGATACAGCTATGGTCTAGACTCCATAATTGGCTTTGACTACTGG	CARDGFCGYSYGLDSIIGFDYW	IGHV3-7	IGHJ4
TGTGCGCATCCCTTTATTGTACTGGTGGTGTATGCTTTAACATACTACTACTACTACATGGACGTCTGG	CAHPFIVLVVYALTYYYYYMDVW	IGHV3-20	IGHJ6
TGTGCTATAGCAGCAGCTGGTGATGACTACTTTGACTACTGG	CAIAAAGDDYFDYW	IGHV3-30	IGHJ4
TGTGCGAGAGGGGGTACGGGGACAGCCCTACTATGGTTCGGGGAGTTAAGCCTTTTCCTTGACTACTGG	CARGGTGTALLWFGELSLFLDYW	IGHV4-34	IGHJ4
TGTGCGAGAGATCTGGGCACGTATTACGATTTTTGGAGTGGTTATGCTTACTACATGGACGTCTGG	CARDLGTYYDFWSGYAYYMDVW	IGHV3-7	IGHJ6
TGTGCGAAACTGTTCAAGGTACGGGGTGGTAAGGGTGCTTTTGATATCTGG	CAKLFKVRGGKGAFDIW	IGHV3-23	IGHJ3
TGTGCGAGAGATCCTGTAAGTAGTACCAGCTGCTATTACCTCTACTACTACTACTACATGGACGTCTGG	CARDPVSSTSCYYLYYYYYMDVW	IGHV3-7	IGHJ6
TGTGCGAAAGGGGCCCGCACAGGTGGTGGTAGCTGCTACTCCCGAGACTACTGG	CAKGARTGGGSCYSRDYW	IGHV3-NL1	IGHJ4
TGTGCGAGAGAGGAAGGAGAGATCCTTTCATGCAACTGGTTCGACCCCTGG	CAREEGEILSCNWFDPW	IGHV1-3	IGHJ5
TGTGCGAATATTACTATGATAGTAGTGGTTACACCTTACTGG	CANITMIVVVTPYW	IGHV4-38-2	IGHJ4
TGTGCGAGAGTTTGTACGTATTACGATTTTTGGAGTGGTCAGTGCGCTCCTGGTAAACGTCTTGACTACTGG	CARVCTYYDFWSGQCAPGKRLDYW	IGHV4-59	IGHJ4
TGTGCGAAAGCCCGGATGCGGTCCCCTGGTACTTTGGACTACTGG	CAKARMRSPGTLDYW	IGHV3-NL1	IGHJ4
TGTGCGAAAGATGGGTCGGTTTATATTGTAGTAGTACCAGCTGCTAACCCAAGACTGGGCGTCCCCTGCTTTGACTACTGG	CAKDGSVYIVVVPAANPRLGVPCFDYW	IGHV3-NL1	IGHJ4
TGTGGTGACTATGGTTCGGGGCCGGTTGACTACTGG	CGDYGSGPVDYW	IGHV3-49	IGHJ4
TGTGCGAGCCTCCTATTACTGCCCTGCGCCTACTACTACTACTACATGGACGTCTGG	CASLLLLPCAYYYYYMDVW	IGHV3-21	IGHJ6
TGTGCGAGAGAGGCTGCCCAAATTGTAGTAGTACCAGCTGCTATGCTTTATCGACTTTCTGCCTGTAGCGGAAACTGGTTCGACCCCTGG	CAREAAQIVVVPAAMLYRLSACSGNWFDPW	IGHV1-3	IGHJ5
TGTGCGAGAGGTCTTGCGCAGGCAGGTACGGTGACTACTCGCACATTGGCGGAACCGCCTTTTGACTACTGG	CARGLAQAGTVTTRTLAEPPFDYW	IGHV1-69	IGHJ4
TGTGCACGGCTTGGTACTTGGGTTGTGGTGGTGACTGCTATATTCCTCCTCTTTGACTACTGG	CARLGTWVVVVTAIFLLFDYW	IGHV2-26	IGHJ4
TGTGAGGGGAAGCTCAATGACTACGGTGACTACTACCGGCAAGAGTACTGG	CEGKLNDYGDYYRQEYW	IGHV3-NL1	IGHJ4
TGTGCGAAAGACCTACAGACCAGGGTTGCTTTTGATATCTGG	CAKDLQTRVAFDIW	IGHV3-NL1	IGHJ3
TGTGCGAGAGATATCCCGGGATATTGTAGTAGTACCAGCTGCTATGCCCAGTGGGGCCGCCGCGCGGATGATGCTTTTGATATCTGG	CARDIPGYCSSTSCYAQWGRRADDAFDIW	IGHV1-18	IGHJ3
TGTGCGAGAGCTGGAGATTGTAGTAGTACCAGCTGCCCTTACTACTTTGACTACTGG	CARAGDCSSTSCPYYFDYW	IGHV1-2	IGHJ4
TGTGCGAAGAAAGAATACGTATTACTATGGTTCGGGGAGTTATTGTTTGACTACTGG	CAKKEYVLLWFGELLFDYW	IGHV3-NL1	IGHJ4
TGTGCACACAAGATAAGAACCCGGCCCCCAGGGTATAGCAGTGGCTGGTACAGAGGCTACTGG	CAHKIRTRPPGYSSGWYRGYW	IGHV2-5	IGHJ4
TGTGCGAAACGGGAGCCCCTCAGGCGAGAACCCATTGTAGTAGTACCAGCTGCTTTGTACCCCTACTACTACTACTACTACATGGACGTCTGG	CAKREPLRREPIVVVPAALYPYYYYYYMDVW	IGHV3-23	IGHJ6
TGTGCGAGAGATGAGGGAAGCTGGTTGTTTCCTGCTTTTGATATCTGG	CARDEGSWLFPAFDIW	IGHV3-11	IGHJ3
TGTGCGAGAGATTCTAGCAGCAGCTGGTACGCCCCCAATAGAACCTGGTTCGACCCCTGG	CARDSSSSWYAPNRTWFDPW	IGHV3-66	IGHJ5
TGTGCGAGAGATGGCCCTATTGTAGTGGTGGTAGCTGAAAGGAACTGGTTCGACCCCTGG	CARDGPIVVVVAERNWFDPW	IGHV4-59	IGHJ5
TGTGCAAGAGGAATGGTATTACTATGGTTCAGGGAGTTAGGTGGCCCCTACTACTTTGACTACTGG	CARGMVLLWFRELGGPYYFDYW	IGHV3-13	IGHJ4
TGTGCACACATGTGGATGGTTCGGGGAGTTAGGGGGAACTGGTTCGACCCCTGG	CAHMWMVRGVRGNWFDPW	IGHV2-5	IGHJ5
TGTGCGACTTGGGGCTGCCATTACGATATTTTGACTGGTTTTCCCGCTTTTGATATCTGG	CATWGCHYDILTGFPAFDIW	IGHV3-11	IGHJ3
TGTGCGAGCCTTGGCAAATTTCTAAGTATAGCAGCAGCCTATCCCACCGATGCTTTTGATATCTGG	CASLGKFLSIAAAYPTDAFDIW	IGHV3-11	IGHJ3
TGTGCGAGATTTGGGTATATTGTAGTGGTGGTAGCTGCTAAAGGTTGGAACTGGTTCGACCCCTGG	CARFGYIVVVVAAKGWNWFDPW	IGHV7-4-1	IGHJ5
TGTGCGAGGGATACGATTTTTGGAGTGGTTATTTGTCAGACCTACTACTACTACTACATGGACGTCTGG	CARDTIFGVVICQTYYYYYMDVW	IGHV4-28	IGHJ6
TGTGCACGGGAACTGGGTCCTATGATAGTAGTGGTTAACTTGATATACTTTGACTACTGG	CARELGPMIVVVNLIYFDYW	IGHV2-70	IGHJ4
