TGTGCGAGCACGTTCCCTGGTAATCCACTCGTTCGCTACTGG	CASTFPGNPLVRYW	IGHV1-3	IGHJ4
TGTGCGAAAGATACCCTTCAGGGGGTACCAGCTGCTATCTCCTACTTTGACTACTGG	CAKDTLQGVPAAISYFDYW	IGHV3-23	IGHJ4
TGTGCGAGAGATCCTTCATTTACATTTGGGGGAGTTATCGACCCACTGGGTGGCTGGTTCGACCCCTGG	CARDPSFTFGGVIDPLGGWFDPW	IGHV3-48	IGHJ5
TGTGCGAGATTGCAGCAGCTGGTACTACCTCCTTTTGACTACTGG	CARLQQLVLPPFDYW	IGHV1-69	IGHJ4
TGTGCGAGATATTTGTGCTATGGTTCGGGGAGTCGTTTTCCCTATTTCGGGTATGCTTTTGATATCTGG	CARYLCYGSGSRFPYFGYAFDIW	IGHV7-4-1	IGHJ3
TGTGCGAGAGGGCCCCCTTCTCAGGATATTGTAGTAGTACCAGCTGCTATGCTATACTACTACTACATGGACGTCTGG	CARGPPSQDIVVVPAAMLYYYYMDVW	IGHV3-20	IGHJ6
TGTTCCAGAAACCTTATAGTGGGAGCTACTAGCTACCTCCCCTGG	CSRNLIVGATSYLPW	IGHV3-30-3	IGHJ5
TGTGCACGGATAAGAATATCGTGGCTGGTCCCCGGGAGAATTTACTACTACTACTACTACATGGACGTCTGG	CARIRISWLVPGRIYYYYYYMDVW	IGHV2-70	IGHJ6
TGTGCGAGGGTAATTTATGATAGTAGTGGTTATTACTACCGAAGGTATGACTACTGG	CARVIYDSSGYYYRRYDYW	IGHV3-7	IGHJ4
TGTGCGAAATCGCTTAACGATGCTTTTGATATCTGG	CAKSLNDAFDIW	IGHV3-NL1	IGHJ3
TGTACTAGAGACGAGCCTATTGTAGTGGTGGTAGCTGCTACTCTTTACCCCCCAACCCGCACCTCTAAGGGGCCGACAACTCGCTACTACTACTACTACATGGACGTCTGG	CTRDEPIVVVVAATLYPPTRTSKGPTTRYYYYYMDVW	IGHV3-49	IGHJ6
TGTACCACAGTGTGTATGGTTCAGGGAGTTATTAACGACATGGACGTCTGG	CTTVCMVQGVINDMDVW	IGHV3-15	IGHJ6
TGTGCGAGAGTCTCACTCCGAGACCATAGCAGCAGCTGGTACCACGAGTCCAATGTGAGAGGATACCCCCTTTCCGATGACTACTGG	CARVSLRDHSSSWYHESNVRGYPLSDDYW	IGHV3-11	IGHJ4
TGTGCGAAAGACATTAGTATTGTAGTAGTACCAGCTGCTATGGGTTCGGTTGGGGTCGAGTACTACTTTGACTACTGG	CAKDISIVVVPAAMGSVGVEYYFDYW	IGHV3-23	IGHJ4
TGTGCGAGACACACAAACTGGTTCGACCCCTGG	CARHTNWFDPW	IGHV5-51	IGHJ5
TGTGCGAAAGATCCCTGGGACCTTATTGTAGTGGTGGTAGCTCTCCCTGACTACTGG	CAKDPWDLIVVVVALPDYW	IGHV3-NL1	IGHJ4
TGTGCGAGAGTGCCTACGATTTTTGGAGTGGTTATTATAATAGTTGACTACTGG	CARVPTIFGVVIIIVDYW	IGHV7-4-1	IGHJ4
TGTGCACGTAGGGGTGAAACTACAGTAACCTTCGACTACTGG	CARRGETTVTFDYW	IGHV2-5	IGHJ4
TGTACTAGACATCCCCATTACTATGATAGTGAACCAATTCAACTATTTGACTACTGG	CTRHPHYYDSEPIQLFDYW	IGHV3-73	IGHJ4
TGTGCGAGACGGCGCCATATAGCAGCTCGTCGCACTCAGAGGTGG	CARRRHIAARRTQRW	IGHV4-39	IGHJ2
TGTACTAGTTGGACCTGTGGAAATCGGGTTATGGGGGCTTGCTCCGATCCGGTAAGTTATTGTAGTAGTACCAGCTGCTATGGTTACTACTACTACTACATGGACGTCTGG	CTSWTCGNRVMGACSDPVSYCSSTSCYGYYYYYMDVW	IGHV3-73	IGHJ6
TGTGCGAGCGTCTCATTACTATGGTTCGGGGAGTTATACCATATGAACTGGTTCGACCCCTGG	CASVSLLWFGELYHMNWFDPW	IGHV5-51	IGHJ5
TGTGCGAGTTATTCCAATTGTACTGGTGGTGTATGCTGGGCAGCTAATTTATACTACTACTACTACATGGACGTCTGG	CASYSNCTGGVCWAANLYYYYYMDVW	IGHV4-61	IGHJ6
TGTGCGAATTGTGAGTATATATTGTACTGGTGGTGTATGCATAAGGGCAACTACTACTACATGGACGTCTGG	CANCEYILYWWCMHKGNYYYMDVW	IGHV3-NL1	IGHJ6
TGTGCAAAAGATATGGAGGGGATAGCAGTGGCTGGTACCCAAAACAACTTTGACTACTGG	CAKDMEGIAVAGTQNNFDYW	IGHV3-43	IGHJ4
TGTGCGAGAGGGTTCCCATCCCCAAATTACGATTTTTGGAGTGGTTACTTCTGGTTCGACCCCTGG	CARGFPSPNYDFWSGYFWFDPW	IGHV3-48	IGHJ5
TGTGCGAGAGGCGTGCTCGTACCGTGGCTACGATATGTTGACTACTGG	CARGVLVPWLRYVDYW	IGHV7-4-1	IGHJ4
TGTGGTGGATGGAATACCACGGCAGTAACTACGAACGGAAAAAAACATGCTTTTGACTACTGG	CGGWNTTAVTTNGKKHAFDYW	IGHV3-30-3	IGHJ4
TGTGCGAAAGTAACTAGCAGCAGCTGGTACCGGGTTAGGAACTGGTTCGACCCCTGG	CAKVTSSSWYRVRNWFDPW	IGHV3-23	IGHJ5
TGTGCGAGAACCCATCATTGTAGTGGTGGTAGCTGCGACCCGTGGGGGCGCTACTACTACTACATGGACGTCTGG	CARTHHCSGGSCDPWGRYYYYMDVW	IGHV3-33	IGHJ6
TGTGCGAGGAGTATTGTAGTGGTGGTAGCTGCTACTCCGACCAGTTTAGCCGACCGCGTTGACTACTGG	CARSIVVVVAATPTSLADRVDYW	IGHV4-38-2	IGHJ4
TGTGCGAGAGCTGTGGCCCCCCGCCACCTAGACGCCCGGAATTACTATGGTTCAGGGAGTTGGCCTGACTACTGG	CARAVAPRHLDARNYYGSGSWPDYW	IGHV4-34	IGHJ4
TGTGCGGCTCCGGTGGTGGTGACTGCCCCCCGACGCTGGAACTGGTACTTCGATCTCTGG	CAAPVVVTAPRRWNWYFDLW	IGHV3-11	IGHJ2
TGTGCGAGAGACGCGCTCAAGGTGGTGACTGCTACCAATGATGCTTTTGATATCTGG	CARDALKVVTATNDAFDIW	IGHV4-4	IGHJ3
TGTACTAGACCACCCTGCTTCTTTCCCACGATTTTTGGAGTGGTTACGGGGGGTATTGACTACTGG	CTRPPCFFPTIFGVVTGGIDYW	IGHV3-73	IGHJ4
TGTGCGAGAGGACCCTATGCTAAATGGTTCGACCCCTGG	CARGPYAKWFDPW	IGHV1-2	IGHJ5
TGTGCGAGAGATCCTAGGCGGCTTCAAGATGGTTGGGTTTTACGATTTTTGGAGTGGTTATTCAACTACTACTACTACATGGACGTCTGG	CARDPRRLQDGWVLRFLEWLFNYYYYMDVW	IGHV1-3	IGHJ6
TGTGCAAGAGATTCCTCGACTACGGTGACTACTCCCTTTGACTACTGG	CARDSSTTVTTPFDYW	IGHV3-74	IGHJ4
TGTGCGAGAACGGATATTGTAGTAGTACCAGCTGCTATCCTGGTAGAATCAGACTACTGG	CARTDIVVVPAAILVESDYW	IGHV5-10-1	IGHJ4
TGTGCACGGATACGTGTATTACTGGTGGATGCGCCGAACTTTGACTACTGG	CARIRVLLVDAPNFDYW	IGHV2-26	IGHJ4
TGTGCGAGAGAGATGGTTGTACTAATGGTGTATGCTCCAGACTACTGG	CAREMVVLMVYAPDYW	IGHV1-3	IGHJ4
TGTGCGAGAGCAGGACTTTCAATGCGTATGGTTCAGGGAGTTTCCAACGGTAACTACTACTACTACTACATGGACGTCTGG	CARAGLSMRMVQGVSNGNYYYYYMDVW	IGHV4-61	IGHJ6
TGTGCGAGCGGATATTGTAGTGGTGGTAGCTGCTACTCTACGGTAACCCCAAACTGGTTCGACCCCTGG	CASGYCSGGSCYSTVTPNWFDPW	IGHV5-51	IGHJ5
TGTGCGCCTTATGTTTATTCCCTGACTATTGACTACTGG	CAPYVYSLTIDYW	IGHV3-20	IGHJ4
TGTGCGAGAGTAGCAGTGGCACCCGACGGGAGACTTCCCCGGATGGAGGATCCCGGAAACTTTGACTACTGG	CARVAVAPDGRLPRMEDPGNFDYW	IGHV3-20	IGHJ4
TGTGCGAGCTCTGCTACTATGGTTCAGGGAGTTATTACGGGCCACCGCGATTGCTACTGG	CASSATMVQGVITGHRDCYW	IGHV1-2	IGHJ4
TGTGCGAGAGATACGCAGATGCCCCTGTGGTGGTTTGGGTACTACTTTGACTACTGG	CARDTQMPLWWFGYYFDYW	IGHV1-69	IGHJ4
TGTGCGAGAGGAAGGCGGCAGTACTACCAGCTGCTATGCCACCGTCTTTACTACTTTGACTACTGG	CARGRRQYYQLLCHRLYYFDYW	IGHV4-59	IGHJ4
TGTGCGAGAGAGGAAGTTGGGGCCCGCTGG	CAREEVGARW	IGHV3-53	IGHJ5
TGTGCGAGAGAGGGGGAGGCCTGGAACGACTCCATGGGCCCAGCTTTTGATATCTGG	CAREGEAWNDSMGPAFDIW	IGHV1-3	IGHJ3
TGTGCGAAACCCCCGTTGGGGCATACGATAGCAGTGGCTGCGCGGGGGCGTTACTACTACTACTACTACATGGACGTCTGG	CAKPPLGHTIAVAARGRYYYYYYMDVW	IGHV4-39	IGHJ6
TGTGCGAGACCCCCTATGTATAGCAGTGGCTGGGAAGCCGACTGG	CARPPMYSSGWEADW	IGHV5-51	IGHJ4
TGTGCGAAATTGGGATCCTCTTTTTCATCTATAGCAGCAGCTGGTACAACCGACTCGTCCCGTGGCCCCTGG	CAKLGSSFSSIAAAGTTDSSRGPW	IGHV3-23	IGHJ5
TGTGCGAGATGCAGCTGCTATACGTTGTTGCCCCGTTTTGACTACTGG	CARCSCYTLLPRFDYW	IGHV1-18	IGHJ4
TGTGCGAGAGGTTCGGGGGGTTATATTGTACTGGTGGTGTATGCTATTGGAATTGATGCTTTTGATATCTGG	CARGSGGYIVLVVYAIGIDAFDIW	IGHV4-4	IGHJ3
TGTGTTCTACCTATGATAGTAGTGGTTATTACTACGTCTACGGCCCTCCAAATTGACTACTGG	CVLPMIVVVITTSTALQIDYW	IGHV1-45	IGHJ4
TGTGCGAAAATATATACTATGATAGTAGTGGTTATTAATCCCCTTAACTACTGG	CAKIYTMIVVVINPLNYW	IGHV3-NL1	IGHJ4
TGTACCACGGGTGGGTCTATTGACTACGGTGACTACAGCGACCCTTATGACTGG	CTTGGSIDYGDYSDPYDW	IGHV3-15	IGHJ4
TGTGCGAGAGAGAATAGCAGCTCGTGGGCGGGGGTTTACTACTACTACTACTACATGGACGTCTGG	CARENSSSWAGVYYYYYYMDVW	IGHV4-38-2	IGHJ6
TGTGCGAGCGGAAAGGAGCTACACGAGGTAGTGGCTACGATTACCCGCTACTGG	CASGKELHEVVATITRYW	IGHV4-59	IGHJ4
TGTGCGAAAGATGGGCGGGTATCTGACTACTGG	CAKDGRVSDYW	IGHV3-NL1	IGHJ4
TGTGCGAGAGGCCCCCGCGTCGGGAGGGTAGCTGCTACAGGCTACTACTACTACTACATGGACGTCTGG	CARGPRVGRVAATGYYYYYMDVW	IGHV5-10-1	IGHJ6
TGTGCGAGTAGCCTTGAGAGTATAGCAGCTCGTCACCTCGACTACTGG	CASSLESIAARHLDYW	IGHV5-10-1	IGHJ4
TGTACTAGATCCGAGGATATAGTGGCTACGATTACAGGGGTATACTACTACTACTACATGGACGTCTGG	CTRSEDIVATITGVYYYYYMDVW	IGHV3-49	IGHJ6
TGTGCGCCTATAAACACTATGATAGTAGCTAGTCGCATTGACTACTGG	CAPINTMIVASRIDYW	IGHV4-61	IGHJ4
TGTGCGAGAGATACGGTGACTACCACGGGCCCTGCCCTCCTCTGGTTCGACCCCTGG	CARDTVTTTGPALLWFDPW	IGHV1-46	IGHJ5
TGTGCGAGACCCCGAATTTTTACTAATGGTGTATGCTATACCTACTTTGACTACTGG	CARPRIFTNGVCYTYFDYW	IGHV3-11	IGHJ4
TGTGCGAGATCTGCTTCCGTTTGCGGTATTATGATTACATTTGGGGGAGTTATCGGCCACACCTACTGG	CARSASVCGIMITFGGVIGHTYW	IGHV1-69	IGHJ4
TGTGCGAACGATCTGGGTGGTGTATGCTATATGGCTGGGGCCTACTACTACTACTACATGGACGTCTGG	CANDLGGVCYMAGAYYYYYMDVW	IGHV3-NL1	IGHJ6
TGTACCACAGATAGAGAACAGGTTTGTAGTGGTGGTAGCTGCTACAATAGGGATTGGCCCGAGTTCAACGCTTTGTACTTTGACTACTGG	CTTDREQVCSGGSCYNRDWPEFNALYFDYW	IGHV3-15	IGHJ4
TGTGCGAGAGACGGTATCGAACTTACGATTTTTGGAGTGGTTAGCCTAAGGTACTACTACTACATGGACGTCTGG	CARDGIELTIFGVVSLRYYYYMDVW	IGHV4-34	IGHJ6
TGTGCGAGCCCTAGCAGTGGCTGGTCTCTGTGGTTCGACCCCTGG	CASPSSGWSLWFDPW	IGHV4-39	IGHJ5
TGTACTAGAGATCAGCGGCGAGGACTATGGTTCAGGGAGTTATTACGTATAGTTGTTGACTACTGG	CTRDQRRGLWFRELLRIVVDYW	IGHV3-49	IGHJ4
TGTGCGAGAGATCGGAGTCTAGGGGTTAAGCGGTCCTACTACTACTACATGGACGTCTGG	CARDRSLGVKRSYYYYMDVW	IGHV3-64	IGHJ6
TGTGCACACACCCGAAACAGGTTGAGCGTTTACGATTTTTGGAGTGGGGCGACATACTACTACATGGACGTCTGG	CAHTRNRLSVYDFWSGATYYYMDVW	IGHV2-5	IGHJ6
TGTGCGAGAGCTGGTATTGTAGTGGTGGTAGCTGGGAGGTTTGACTACTGG	CARAGIVVVVAGRFDYW	IGHV7-4-1	IGHJ4
TGTGCAATCCCTGATTGTACTGGTGGTGTATGCGAAGAGGTGACCGGGGACTTTGACTACTGG	CAIPDCTGGVCEEVTGDFDYW	IGHV4-38-2	IGHJ4
TGTGCACACCATATTGTAGTAGTACCAGCTGCACTTGGAAGGATTCTGTACTACTACTACTACTACATGGACGTCTGG	CAHHIVVVPAALGRILYYYYYYMDVW	IGHV2-5	IGHJ6
TGTGCGAGACCCGGGTTACACCATGACTACTGG	CARPGLHHDYW	IGHV5-51	IGHJ4
TGTGCGAAAGGGATATTGGCATTACTATGGTTCAGGGAGTTATCCGGCTGGTTCGACCCCTGG	CAKGILALLWFRELSGWFDPW	IGHV3-23	IGHJ5
TGTGCGAGAGAGGGATATTGTAGTAGTACCAGCTGCTATGACAGGCTACCCAACTACTTTGACTACTGG	CAREGYCSSTSCYDRLPNYFDYW	IGHV1-3	IGHJ4
TGTGCGAGAGATTATAGCAGCAGCTGTTTTTCCCGCTTTGACTACTGG	CARDYSSSCFSRFDYW	IGHV3-20	IGHJ4
TGTGCGAAAGATCGGCCGTATAGTGGTGGTAGCTGCTATGGGTTAAGCTTTGACTACTGG	CAKDRPYSGGSCYGLSFDYW	IGHV3-NL1	IGHJ4
TGTGCGAGAAGGGGGAAGAGTATAGCAGCAGCTGGTACGAGTTGGCGCAACTGGTTCGACCCCTGG	CARRGKSIAAAGTSWRNWFDPW	IGHV3-53	IGHJ5
TGTGCGAGAGATAACCCCGATGACTACGGTGACTACCATGATGCTTTTGATATCTGG	CARDNPDDYGDYHDAFDIW	IGHV1-2	IGHJ3
TGTGCGAGAGACGGGTGTGATGGCCAGTGGTTCGACCCCTGG	CARDGCDGQWFDPW	IGHV3-53	IGHJ5
TGTGCGAGACGCATATTGATGGATATTGTAGTGGTGGTAGCTGCTCCAATAGACTACTACTTTGACTACTGG	CARRILMDIVVVVAAPIDYYFDYW	IGHV5-10-1	IGHJ4
TGTACCACAAATGGCCCTAATTATGATTACATTTGGGGGAGTTATCTAGGGACCCGCTACTACATGGACGTCTGG	CTTNGPNYDYIWGSYLGTRYYMDVW	IGHV3-15	IGHJ6
TGTGCGAAAGATCGGGTACGATATTTTGACTGGTTAGTGCCCAACTGCTGGTTCGACCCCTGG	CAKDRVRYFDWLVPNCWFDPW	IGHV3-NL1	IGHJ5
TGTGCGAGACAACCCACTTGTATTACTATGATAGTAGTGGTTTGGAAGCAGCACTGG	CARQPTCITMIVVVWKQHW	IGHV1-2	IGHJ1
TGTGCGAAAGCTGTATTACTATGGTTCGGGGAGTGTGTTGACTACTGG	CAKAVLLWFGECVDYW	IGHV3-23	IGHJ4
TGTACTAGAGCGATTATAGCAGCTCGTCCTAACTGGTTCGACCCCTGG	CTRAIIAARPNWFDPW	IGHV3-49	IGHJ5
TGTGCGAGTCTTGGTATTGTAGTGGTGGTAGCTGCCAAAATGCCGGTTGACTACTGG	CASLGIVVVVAAKMPVDYW	IGHV4-38-2	IGHJ4
TGTGCGAAAGATAGTATAGCAGCGGTTGACTACTGG	CAKDSIAAVDYW	IGHV3-NL1	IGHJ4
TGTGCGAAAGAAAATAAGAGGACTGTGGCCTCGCAGCTCGTATTCTCACCTGACTACTGG	CAKENKRTVASQLVFSPDYW	IGHV3-NL1	IGHJ4
TGTGCGAGAGCCATCGGTGCAGTGGCCCGCTACTGG	CARAIGAVARYW	IGHV3-11	IGHJ4
TGTGCAAGAGATCTAGGGCGGGTCGTGGATATTGTAGTGGTGGTAGCTGCTACACACTTATCCCCACGAGGAGGGCGTATAAAGTTCAAGCGCCCAGCTAGACGCCCAACCAGCTACTACTACTACTACATGGACGTCTGG	CARDLGRVVDIVVVVAATHLSPRGGRIKFKRPARRPTSYYYYYMDVW	IGHV3-74	IGHJ6
TGTGCGAGAGATACAGTTAGCCAGAGGCGTAATGGGTATAGCAGTGGCTGGCCCCTAGAGGATCGGTCGGAGAATGCTAACATGTTCCTAGACGCCGGATTTGACTACTGG	CARDTVSQRRNGYSSGWPLEDRSENANMFLDAGFDYW	IGHV3-7	IGHJ4
TGTGGTCTTATGATTACATTTGGGGGAGTTATCGTTACCAAGAACCGTTACTGG	CGLMITFGGVIVTKNRYW	IGHV3-30-3	IGHJ4
TGTACTAGAGCCATATTGTACTGGTGGTGTATGGAAGGTTGGTACAACTGGTTCGACCCCTGG	CTRAILYWWCMEGWYNWFDPW	IGHV3-49	IGHJ5
