TGTGCGAAAGTACACCCACTTAAACCTACCCACAGGGAAACGACATATTGTAGTAGTACCAGCTGCTATCAAGGTGACTACTGG	CAKVHPLKPTHRETTYCSSTSCYQGDYW	IGHV3-NL1	IGHJ4
TGTGCACACATCCCTATTGTAGTAGTACCAGCTGCTATATTTCTCTGCCCTTTTGGAGGGACGTACTGG	CAHIPIVVVPAAIFLCPFGGTYW	IGHV2-5	IGHJ4
TGTGCGAAATATTGTGGTACAGTGGCTGGTACCTTGTACTACTTTGACTACTGG	CAKYCGTVAGTLYYFDYW	IGHV3-23	IGHJ4
TGTGCACGGTATTACTATGATAGTAGTGGTTATGTCACTCCGGGGCTTGCTTTTGATATCTGG	CARYYYDSSGYVTPGLAFDIW	IGHV2-5	IGHJ3
TGTGCGAAAATCTCCACGACATTTGACTACTGG	CAKISTTFDYW	IGHV3-23	IGHJ4
TGTGCGAGAACATTCGAACGATTATTACGATTTTTGGAGTGGTTATTGGGGAAGTACTACTTTGACTACTGG	CARTFERLLRFLEWLLGKYYFDYW	IGHV5-10-1	IGHJ4
TGTGCGAGTCGTGTTAAGTATTACTATGATAGTAGTGGTTATTTGGCCCCTGACTACTGG	CASRVKYYYDSSGYLAPDYW	IGHV3-21	IGHJ4
TGTGCAAGAGATGACACAAGAATCTTTATGATTACATTTGGGGGAGTTATCGTTACGTACTTTGACTACTGG	CARDDTRIFMITFGGVIVTYFDYW	IGHV3-13	IGHJ4
TGTGCGAGAGTGATTACGAAGGTGTCTCTCTTTGACTACTGG	CARVITKVSLFDYW	IGHV1-18	IGHJ4
TGTGCGAGAGATATATACTCGCCCGGCAGTGGCTGGGACGTATACTACTGG	CARDIYSPGSGWDVYYW	IGHV4-59	IGHJ4
TGTGCGAGAGTTTTCTGCCTAGGATATTGTACTGGTGGCTACCCTGGGTGGTTCGACCCCTGG	CARVFCLGYCTGGYPGWFDPW	IGHV1-46	IGHJ5
TGTGCGAGAGACCGGGGGGAATATTACTATGGTTCAGGGAGTTACCTTGGGCCCCCAGCGGCCTACTACATGGACGTCTGG	CARDRGEYYYGSGSYLGPPAAYYMDVW	IGHV1-3	IGHJ6
TGTACTAGACGGGGGGAAAATATGATAGTAGTGGTTATTACATGCGTAAACTGGTTCGACCCCTGG	CTRRGENMIVVVITCVNWFDPW	IGHV3-73	IGHJ5
TGTGCGAGAGAGAGGGACCGGGTTTCCCATACCCATCTGATTGTAGTAGTACCAGCTGCTATGAAGTATTACTACTACTACATGGACGTCTGG	CARERDRVSHTHLIVVVPAAMKYYYYYMDVW	IGHV1-2	IGHJ6
TGTGCGTGGGGATTGTATATTGTGGTGGTGACTGCTATCAATCGGCCGGGGGAGAACTACTTTGACTACTGG	CAWGLYIVVVTAINRPGENYFDYW	IGHV1-46	IGHJ4
TGTGCGAGACCATCCATTAATTATACCAGCTGCTTGGCCTGG	CARPSINYTSCLAW	IGHV3-30	IGHJ4
TGTGCGAGAGATCGGGGGGTCTTCGTATTACTATGGTTCGGGGAGTTATTATTTAACTGGTTCGACCCCTGG	CARDRGVFVLLWFGELLFNWFDPW	IGHV3-11	IGHJ5
TGTGCGAGACGGCGGTGGTGCTGGTGCTACTACTACTACTACATGGACGTCTGG	CARRRWCWCYYYYYMDVW	IGHV1-3	IGHJ6
TGTGCGATCGTAGGTATAACTGGAACTACAGCGGAATGGTTCGACCCCTGG	CAIVGITGTTAEWFDPW	IGHV4-34	IGHJ5
TGTGCGAGAATTCGGGTTCTCTTACGTATTACTATGATAGTAGTGGGACCGGCCATCACCCTCTACTGG	CARIRVLLRITMIVVGPAITLYW	IGHV1-69	IGHJ4
TGTGCGAAAACGAAGAAGATAGTGGCTACGATTTCGAGGCTAATTGCCAGTGACTACTGG	CAKTKKIVATISRLIASDYW	IGHV3-NL1	IGHJ4
TGTGCGAGGGGTTGTATGAGGAATTACTATGATAGTAGTGGTTATTACACCCGCGATGCTTTTGATATCTGG	CARGCMRNYYDSSGYYTRDAFDIW	IGHV4-61	IGHJ3
TGTGCGAGCAGTGGCTGGTACACATTCCCCTCCTGGTACTTCGATCTCTGG	CASSGWYTFPSWYFDLW	IGHV5-51	IGHJ2
TGTGCAGCCGAACTTATTGTAGTAGTACCAGCTGCTATGTCGTACTACTACTACTACATGGACGTCTGG	CAAELIVVVPAAMSYYYYYMDVW	IGHV3-74	IGHJ6
TGTGCGAAAGCTCCATCAAATGATACACCCCAAGACCCCTTTGACTACTGG	CAKAPSNDTPQDPFDYW	IGHV3-NL1	IGHJ4
TGTGCAAGAGTGCCCGAGCACAGCCTTGACTACTGG	CARVPEHSLDYW	IGHV3-13	IGHJ4
TGTGCACGGAGGGCCTCATTACTATGGTTCGGGGAGTTAGTTACGTCGGGGCGCATTGACTACTGG	CARRASLLWFGELVTSGRIDYW	IGHV2-70	IGHJ4
TGTGCGAAAGTTGCCTGTGGTCCGTACTACTACTTTGACTACTGG	CAKVACGPYYYFDYW	IGHV3-NL1	IGHJ4
TGTGCGAAAGCCCATCTGTATAGCAGCAGCTGGTACGGCATCGCTGAATACTTCCAGCACTGG	CAKAHLYSSSWYGIAEYFQHW	IGHV3-23	IGHJ1
TGTGCGAGAAGTTTAATTACGATTTTTGGAGTGGTTATTATTCTGGCTGTTGACTACTGG	CARSLITIFGVVIILAVDYW	IGHV5-10-1	IGHJ4
TGTGCGAAAGGATCCTTTATGGGTATAGCAGTGGGTGACTACTGG	CAKGSFMGIAVGDYW	IGHV3-NL1	IGHJ4
TGTGCGAACAGTTTCCTTGACTGCCTGACGTACTACTACTACTACTACATGGACGTCTGG	CANSFLDCLTYYYYYYMDVW	IGHV3-23	IGHJ6
TGTGCGAAAGATCCCCTGAGTACGAGGTTGATTCGCCCACTAACTACGGTGACTAGATGTTTGGCTGATGCTTTTGATATCTGG	CAKDPLSTRLIRPLTTVTRCLADAFDIW	IGHV3-23	IGHJ3
TGTACTAGAGGGTTAGGAGGGCATGACTACAGTAACTACGTGGTAGTTTTTGGGCTCGACTACTGG	CTRGLGGHDYSNYVVVFGLDYW	IGHV3-49	IGHJ4
TGTGCAAGGGTTTATGCAGCAGCTGGTAAGAACTACTACTACTACTACATGGACGTCTGG	CARVYAAAGKNYYYYYMDVW	IGHV3-13	IGHJ6
TGTGCGAACTTAGGACTATGGTTCAGGGAGTTATTAAACTACTACTACTACATGGACGTCTGG	CANLGLWFRELLNYYYYMDVW	IGHV3-NL1	IGHJ6
TGTGCGAAAGATCCAGCGGAATCTTGGGCTTTTGGAGTGGTTTTATCCTACTGG	CAKDPAESWAFGVVLSYW	IGHV3-NL1	IGHJ4
TGTGCGAGAGATTCGTATTACGATATTTTGACTGGTAAAATCCAAGACATCTGG	CARDSYYDILTGKIQDIW	IGHV4-4	IGHJ3
TGTGCGAGAGATCGTTACTATGATAGTAGTGGTTATTACGGGTTTGACTACTGG	CARDRYYDSSGYYGFDYW	IGHV3-11	IGHJ4
TGTGCGAAAGCGGCGGGAGCCGATTACTATGATAGTAGTGGTTATGGTATTGGCTGGGAACTCTACTGG	CAKAAGADYYDSSGYGIGWELYW	IGHV3-NL1	IGHJ4
TGTGCGAGATCTTTTCCGACTTATAATATTATTGTAGTGGTGGTAGCTGCTACTCACCTCCCCTGGTTCGACCCCTGG	CARSFPTYNIIVVVVAATHLPWFDPW	IGHV3-11	IGHJ5
TGTGCAAGAGATGCAGTCTGCCGGGGTATAGCAGTGGCGCCCCACCACTACTACTACTACATGGACGTCTGG	CARDAVCRGIAVAPHHYYYYMDVW	IGHV6-1	IGHJ6
TGTGCGAGAGGGTGTATAGCAGCAGCTGGTTCCTGG	CARGCIAAAGSW	IGHV5-51	IGHJ4
TGTGCGAAGACCCCCAGTGGCTGGTACTTCTCTGCCGCTGACTACTGG	CAKTPSGWYFSAADYW	IGHV3-23	IGHJ4
TGTGCGAGAATGCGGTATTGTACTGGTGGTGTATGCTGCTTGGGGGGCTACTACTACTACTACATGGACGTCTGG	CARMRYCTGGVCCLGGYYYYYMDVW	IGHV4-38-2	IGHJ6
TGTGCGAGAGATGGATATTGTAGTGGTGGTAGCTGCTTCAATACCTATACTCCTCCTACCGGCGCACAGGGGAACTGGTACTTCGATCTCTGG	CARDGYCSGGSCFNTYTPPTGAQGNWYFDLW	IGHV3-53	IGHJ2
TGTGCGAGATGGGCTAGTACCAGCTGCTATAACAGAGCGTACTGG	CARWASTSCYNRAYW	IGHV5-10-1	IGHJ4
TGTGCGAAAGATAAAACCAAGCTAGGATATTGTAGTAGTACCAGCTGCTACCCATCATTTGACTACTGG	CAKDKTKLGYCSSTSCYPSFDYW	IGHV3-23	IGHJ4
TGTGTTAACCCTGGGCGGGGATATAGTGGCTACGAGCTCCCCACGTACGTCTACTACTACATGGACGTCTGG	CVNPGRGYSGYELPTYVYYYMDVW	IGHV3-30	IGHJ6
TGTGCAAGGGTCCGGGATGATTGTAGTAGTACCAGCTGCTATGTCCTATATAAGGAAAACTACTACTACTACATGGACGTCTGG	CARVRDDCSSTSCYVLYKENYYYYMDVW	IGHV6-1	IGHJ6
TGTGCGAGTCTAGGCGTGGATACAGCTATGGTTGACTACTACTACTACATGGACGTCTGG	CASLGVDTAMVDYYYYMDVW	IGHV3-53	IGHJ6
TGTGCACGGGACCCCACCCTGGGGTTTTGGAGTGGTTGGGACGACTACTGG	CARDPTLGFWSGWDDYW	IGHV2-70	IGHJ4
TGTGCGAGAACCGTAAAGCAGCAGCTGGTGGGGCCTACCCAGCTCTACTGGTACTTCGATCTCTGG	CARTVKQQLVGPTQLYWYFDLW	IGHV3-53	IGHJ2
TGTGCGAGAGATGCAAGTTGTAGTAGTACCAGCTATGTAAAGTTTGACTACTGG	CARDASCSSTSYVKFDYW	IGHV3-21	IGHJ4
TGTGCGAGCCAGATTTTTGGAGTGGTTATTATAACGGACTACTGG	CASQIFGVVIITDYW	IGHV3-21	IGHJ4
TGTGCGAGACGGGCTAGGTGGCTAAGGCTCAGGATATACTACTTTGACTACTGG	CARRARWLRLRIYYFDYW	IGHV5-51	IGHJ4
TGTGCGATGCATTCTTTTTGGAGTGGTTATTACAACTTCAACTGGTTCGACCCCTGG	CAMHSFWSGYYNFNWFDPW	IGHV3-23	IGHJ5
TGTGCGAAAGATCCGAACGGGTCTAGAACACCCACCGGCTGGCTCAGCTATGGATGGGGTAGTTTAGACTACTGG	CAKDPNGSRTPTGWLSYGWGSLDYW	IGHV3-NL1	IGHJ4
TGTGCGAGAGACCCCTCACAGCGTAGTAGTACCAGCTGCGCGAGTCGTTCGCTCCCGGCCCGAATTGACTACTGG	CARDPSQRSSTSCASRSLPARIDYW	IGHV7-4-1	IGHJ4
TGTGCGAGAGCGTTACCGAGGACGGATACAGCTATGGTTACCCTAGGTTTAAAGCGAGGGTACTACTACTACTACTACATGGACGTCTGG	CARALPRTDTAMVTLGLKRGYYYYYYMDVW	IGHV1-69	IGHJ6
TGTGCGAGAGTACCATACGATTTTTGGAGTGGTTATTCTTCAACCGGCTACTGG	CARVPYDFWSGYSSTGYW	IGHV1-46	IGHJ4
TGTGCGAAAGATCATGGGTGTACTGGTGGTGTATGCTATCAAAACTGGTTCGACCCCTGG	CAKDHGCTGGVCYQNWFDPW	IGHV3-23	IGHJ5
TGTGCGAAAGATAGGCGGGCGGGTTTTTGGAGTGGTTACAACTACTACTACTACTACATGGACGTCTGG	CAKDRRAGFWSGYNYYYYYMDVW	IGHV3-NL1	IGHJ6
TGTGCGAGAGAAAGTTGGTTCTTCGACCCCTGG	CARESWFFDPW	IGHV1-69	IGHJ5
TGTGCGAATCGAGAAGTGTGTATAGCAGCTCGTAGCCGTGCATGCTACTACTACTACTACATGGACGTCTGG	CANREVCIAARSRACYYYYYMDVW	IGHV3-NL1	IGHJ6
TGTGCGAGCCAAGTGCTGCGTCTAGGAGATAATATTGTAGTGGTGGTAGCTGCATACTTCCAGCACTGG	CASQVLRLGDNIVVVVAAYFQHW	IGHV4-59	IGHJ1
TGTGCGAAAGATCCTGCACCCGACCTATTAGGGCTAGTGGCTACGAGTTTTGACTACTGG	CAKDPAPDLLGLVATSFDYW	IGHV3-23	IGHJ4
TGTGCGAGAGGTAACTACACTACAGTGCTGAACTACTTTGACTACTGG	CARGNYTTVLNYFDYW	IGHV1-2	IGHJ4
TGTACTAGACAGTTGGGATGGGGGGGTATTGTACTGGTGGTGTATGCTACCACCGACTACTGG	CTRQLGWGGIVLVVYATTDYW	IGHV3-73	IGHJ4
TGTGCGAGAGCATTCCCCTATTACGATTTTTGGAGTGGTGATTTTGACTACTGG	CARAFPYYDFWSGDFDYW	IGHV5-10-1	IGHJ4
TGTACTAGAGCGACTACGGTGACTGCGAGGGAAATAGACTACTGG	CTRATTVTAREIDYW	IGHV3-49	IGHJ4
TGTGCAAGAAACCCGCCGGGAATTATTGTGGTGTCGGAATTTGGACCTTTTGACTACTGG	CARNPPGIIVVSEFGPFDYW	IGHV1-45	IGHJ4
TGTGCGAGAGACGTTGTAGTGGTGGTAGCTGCTACTCAGCATACCAGCTTTGATGATGCTTTTGATATCTGG	CARDVVVVVAATQHTSFDDAFDIW	IGHV4-59	IGHJ3
TGTGCGATGGGGTCTTGTGGTGGTGACTGCTATTGGCACGAAGTCTACCCCTTTGACTACTGG	CAMGSCGGDCYWHEVYPFDYW	IGHV1-18	IGHJ4
TGTGCGAGAGACCTCCTGTCGCACGATTTTTGGTGCAAGCCGTTTTACTGG	CARDLLSHDFWCKPFYW	IGHV3-53	IGHJ4
TGTGCGAGAAATTGCCCGTATGATTACATTTGGGGGAGTTATCCCCCCGACTGGTTCGACCCCTGG	CARNCPYDYIWGSYPPDWFDPW	IGHV4-28	IGHJ5
TGTACGTCTTCACGATTTTTGGAGTGGCTAGCCCCCGACTACTACTACTACATGGACGTCTGG	CTSSRFLEWLAPDYYYYMDVW	IGHV3-9	IGHJ6
TGTGGGGATATGATAGTAGTGGTTGGGTACTACTTTGACTACTGG	CGDMIVVVGYYFDYW	IGHV3-30	IGHJ4
TGTGCAAAAGATTTGAATCAGGTAGTGGTGGTAGCTGCTTCAAGCTACTGG	CAKDLNQVVVVAASSYW	IGHV3-43	IGHJ4
TGTGCGAGTCGCGTTGGGGGGGGATATTGTAGTAGTACCAGCTGCAACGCCTGGTTCGACCCCTGG	CASRVGGGYCSSTSCNAWFDPW	IGHV4-39	IGHJ5
TGTGCGAGAGAGGGGTCATATTGTAGTAGTACCAGCTGCTATGGCCACTGGTACTTCGATCTCTGG	CAREGSYCSSTSCYGHWYFDLW	IGHV3-7	IGHJ2
TGTGCGAGAGCCAATATTGTAGTAGTACCAGCTGCTCAGTTCTTCCAGCACTGG	CARANIVVVPAAQFFQHW	IGHV1-46	IGHJ1
TGTGCAAGAGGAAGGAAGAACTGGTTCGACCCCTGG	CARGRKNWFDPW	IGHV6-1	IGHJ5
TGTGCGAAATGCAGTGGCTGGTACGTCGCTGGGCGATACTTCCAGCACTGG	CAKCSGWYVAGRYFQHW	IGHV3-23	IGHJ1
TGTGCGAGAGCCCAGGTAGTAACTACGTTTAATTACTACTACTACTACTACATGGACGTCTGG	CARAQVVTTFNYYYYYYMDVW	IGHV1-69	IGHJ6
TGTGCGAGAGATAATATGAATTACGATATTTTGACTGGTTATTCTGGCACCTACTACTTTGACTACTGG	CARDNMNYDILTGYSGTYYFDYW	IGHV3-64	IGHJ4
TGTGCGAGAGACGGGTCACCGAGGTTCAGGGAGTTATTAAAAAACTATTCGTACTACTTTGACTACTGG	CARDGSPRFRELLKNYSYYFDYW	IGHV4-34	IGHJ4
TGTGCGAGATTGTATGGGTATGATTACGTTTGGGGGAGTTATCGTTATGGCCGTGGCCCTGACTACTGG	CARLYGYDYVWGSYRYGRGPDYW	IGHV4-34	IGHJ4
TGTGCGTTGGAAGGTATGATTACATTTGGGGGAGTTATCGTTAGATACTACTACTACTACTACATGGACGTCTGG	CALEGMITFGGVIVRYYYYYYMDVW	IGHV1-18	IGHJ6
TGTGCGAGAGATATGGCAGTGGTAGCTGCTACTCCGATCCCTATTATTGCAGGAGCAGACTACTACTTTGACTACTGG	CARDMAVVAATPIPIIAGADYYFDYW	IGHV3-53	IGHJ4
TGTGCGAGAGATTACGACCGGCCCTTGGGGTGTATAGCAGTGGCTGCATTGCCGGGTGCTTTTGATATCTGG	CARDYDRPLGCIAVAALPGAFDIW	IGHV3-11	IGHJ3
TGTGTCCGGTTTGTACTGGTGGTGTATGCTATCAGATTGTTCGAGGTTTACTACTACTACTACTACATGGACGTCTGG	CVRFVLVVYAIRLFEVYYYYYYMDVW	IGHV6-1	IGHJ6
TGTGCGAAAGATGGGTATTGTACTGGTGGTGTATGCCTAAGGAACTACTACTACATGGACGTCTGG	CAKDGYCTGGVCLRNYYYMDVW	IGHV3-NL1	IGHJ6
TGTGCCCGGATTGTAGTGGTGGTAGCTGCATTCTGCCGAAGAGGTCCGATGGTCCTTGACTACTGG	CARIVVVVAAFCRRGPMVLDYW	IGHV3-NL1	IGHJ4
TGTGCGAGAGTTCACCCGGACCAGGATATTGTACTGGTGGTGTATGCTAGGGAAATCATACCGTTAATCTACTACTACTACATGGACGTCTGG	CARVHPDQDIVLVVYAREIIPLIYYYYMDVW	IGHV3-48	IGHJ6
TGTGGGAGGGACCTGACCTATGGTTCAGTGGCTTACTACTACTACTACATGGACGTCTGG	CGRDLTYGSVAYYYYYMDVW	IGHV7-4-1	IGHJ6
TGTGCAAGAGTGCCTTTGGTAGTGGTGGTAGCTGGGGACTGGTTCGACCCCTGG	CARVPLVVVVAGDWFDPW	IGHV1-45	IGHJ5
TGTGCGAGAGATGAGGGAGCTCCCCGGGAATACGGTGACTACGTGTCGGTTAACGATAAGTGG	CARDEGAPREYGDYVSVNDKW	IGHV1-3	IGHJ4
TGTGCGAGAGACCAGTGGGATTGTAGTAGTACCAGCTGCTACTACTACTACTACTACATGGACGTCTGG	CARDQWDCSSTSCYYYYYYMDVW	IGHV3-53	IGHJ6
TGTGCGAGACATTGTGTAGTGGTGGTAGCTGCTACTCGGGGGGACTACTACTACTACTACATGGACGTCTGG	CARHCVVVVAATRGDYYYYYMDVW	IGHV5-51	IGHJ6
