TGTGCGAGCCGGGGAGATTGTAGTGGTGGTAGCTGCTACCCCCTTGATGCTTTTGATATCTGG	CASRGDCSGGSCYPLDAFDIW	IGHV4-59	IGHJ3
TGTACTAGACATCCCATGCCGATGGGCCTCTGCGTTTGGGGGAGTTATCACCCGGGTGATGCTTTTGATATCTGG	CTRHPMPMGLCVWGSYHPGDAFDIW	IGHV3-73	IGHJ3
TGTGCAAGCTCCCCGGGGGTTGCGCTCATAGTGGCTAGCTGGTTCGACCCCTGG	CASSPGVALIVASWFDPW	IGHV3-13	IGHJ5
TGTACCACAGTGGGGGGTACTATGGTTCAGGGAGTTATTCTTCCATACTACTACTACATGGACGTCTGG	CTTVGGTMVQGVILPYYYYMDVW	IGHV3-15	IGHJ6
TGTGCGAGACTTCCTATGATAGTAGTGGTTATTACTACACCGGTACGTCACTACTGG	CARLPMIVVVITTPVRHYW	IGHV5-10-1	IGHJ4
TGTGCGAGAATTGGGAGTTATTACTACTACTACTACATGGACGTCTGG	CARIGSYYYYYYMDVW	IGHV4-38-2	IGHJ6
TGTGCGAGAGTAATAATTCGCCTCTACGATTTTTGGAGTGGTTATTATTGTCGGGGTTGTGACTACTGG	CARVIIRLYDFWSGYYCRGCDYW	IGHV3-53	IGHJ4
TGTGCGAGACAAGTATGCTCACGTCTTGGATCGGGAGGTTACTACTACTACTACTACATGGACGTCTGG	CARQVCSRLGSGGYYYYYYMDVW	IGHV5-51	IGHJ6
TGTGCGAGAGGTTCTGGGTTGGTGTCGGATATTGTACTGGTAGGACTTGGCTACTGG	CARGSGLVSDIVLVGLGYW	IGHV1-2	IGHJ4
TGTGCGAGAGGGCCAAACCGGGGCGGAATAGCAGCTCGTCGCACACTATCCCCATCGGCAGGACCCCCAGACTACTGG	CARGPNRGGIAARRTLSPSAGPPDYW	IGHV3-30	IGHJ4
TGTGCGAGAGATGAAATACCCGGATATTGTAGTAGTACCAGCTGCTATTTCCCTTACGGTTACTACTACTACTACTACATGGACGTCTGG	CARDEIPGYCSSTSCYFPYGYYYYYYMDVW	IGHV1-2	IGHJ6
TGTGCGGGCGGGATAAATATTACTATGATAGTAGTGGTTATTACGGGGGTTATTGACTACTGG	CAGGINITMIVVVITGVIDYW	IGHV1-2	IGHJ4
TGTGCGAGAGATAACTTGTATAGCAGTGGGGGCGTTGACTACTGG	CARDNLYSSGGVDYW	IGHV3-53	IGHJ4
TGTGCGAGAAGTGGATATTGTAGTAGTACCAGCTGGGTTGCCCTACCCTACTGG	CARSGYCSSTSWVALPYW	IGHV4-61	IGHJ4
TGTGCGAGAACCCATTCTATAGCAGTGGCTGGTACGACCTACATTACTCTCTGCTTTGACTACTGG	CARTHSIAVAGTTYITLCFDYW	IGHV3-30	IGHJ4
TGTGCGAGAGATCCGGAGTTCGAGGGGTTCAGTGTATGGCTACCCGTCCGTGGCGGTGACTACCGCGATGACTACTGG	CARDPEFEGFSVWLPVRGGDYRDDYW	IGHV3-20	IGHJ4
TGTGCGAAACTGCCCATCATGACTACGGTGACTACGTCATATCCGGCTTATTCCTACTACTACATGGACGTCTGG	CAKLPIMTTVTTSYPAYSYYYMDVW	IGHV3-NL1	IGHJ6
TGTGCGAAAGATAATGAAATAATTTATAATTACTATGATAGTAGTGGTTATAACTGGGGGTTGCTATACTACTTTGACTACTGG	CAKDNEIIYNYYDSSGYNWGLLYYFDYW	IGHV3-23	IGHJ4
TGTGCGAGCCTGGATATCCGCCGGAAGTATAGCAGTGGCTGGTACCTCGACTACTGG	CASLDIRRKYSSGWYLDYW	IGHV1-2	IGHJ4
TGTGCGAGAGATCGACGCGGGGATGGGCGGGTCGACTGG	CARDRRGDGRVDW	IGHV1-69	IGHJ4
TGTGCGAGAGCGGAATATTGTAGTGGTGGCTTCGCTGAATACTTCCAGCACTGG	CARAEYCSGGFAEYFQHW	IGHV7-4-1	IGHJ1
TGTGCGAGACAGGGTATTACGATTTTTGGAGTGGTTATTATAACGAAACGGCCGGTCCTTGACTACTGG	CARQGITIFGVVIITKRPVLDYW	IGHV4-38-2	IGHJ4
TGTGCGAAAACTTTTGGAGTGGTTATCCTTCCGTTTCCCTACTGG	CAKTFGVVILPFPYW	IGHV1-3	IGHJ4
TGTGCACGGAAGGGTGATCGATATTGTAGTGGTGGTAGCCTGGGGGGGGACGTGTACTTCGATCTCTGG	CARKGDRYCSGGSLGGDVYFDLW	IGHV2-70	IGHJ2
TGTGCGAGAGATTTAGATGGGATAATGCCGGAGTCTATCATTATGATTACATTTGGGGGAGTTATCAAGGGATACCCTGATGCTTTTGATATCTGG	CARDLDGIMPESIIMITFGGVIKGYPDAFDIW	IGHV3-66	IGHJ3
TGTGCGCGAGAGCCAGAAGGATATAGTGGCTACGGGGCTAGGTATGATGCTTTTGATATCTGG	CAREPEGYSGYGARYDAFDIW	IGHV3-23	IGHJ3
TGTGCGAGAGATGCCGGGACGTACAGTAACTACGAGGGGTTAAACTACTACTACTACTACATGGACGTCTGG	CARDAGTYSNYEGLNYYYYYMDVW	IGHV4-59	IGHJ6
TGTGCGAGAGATGTTGATTACGATTTTTGGAGTGGCCCCTCGGGTCTGGTAAACTGG	CARDVDYDFWSGPSGLVNW	IGHV3-7	IGHJ5
TGTGCGAGAGGAACGCTAGCAGCTCGTTACTACTACTACTACTACATGGACGTCTGG	CARGTLAARYYYYYYMDVW	IGHV1-2	IGHJ6
TGTGCGAGAGATCCCTTACGGGGGTCAGAAGACTGGTTCGACCCCTGG	CARDPLRGSEDWFDPW	IGHV4-61	IGHJ5
TGTGCACACAGGCCGACCGCGGGGTGGGGGAGTTATCGTTACCCCCCATTTGACTACTGG	CAHRPTAGWGSYRYPPFDYW	IGHV2-5	IGHJ4
TGTGCGAAAGATGAGGGTGGGCCCCCGCGCGCCTATATTGTACTGGTGGTGTATGCTATTGCGAGCCCCTTTGGTCTGGGGTACTGG	CAKDEGGPPRAYIVLVVYAIASPFGLGYW	IGHV3-NL1	IGHJ4
TGTGCAAGAGATCCCGTCGAGATAGTACCAGCTGCTAGGGCCACGTACTACTACTACTACTACATGGACGTCTGG	CARDPVEIVPAARATYYYYYYMDVW	IGHV3-74	IGHJ6
TGTCTCTATTACGATTTTTGGAGGGGGGTTGACTACTGG	CLYYDFWRGVDYW	IGHV3-30-3	IGHJ4
TGTGCGAGAGATAGATATTGTAGTAGTACCAGCTGCTATGCCATCTGG	CARDRYCSSTSCYAIW	IGHV4-34	IGHJ3
TGTGCGAGACAACCTATAGCAGCAGCTGGCCCACCTGCCTACTGG	CARQPIAAAGPPAYW	IGHV5-51	IGHJ4
TGTGCAAGACTGGCCGGCTATTGTAGTGGTGGTAGCTGCTACTATGTCCTACGACCCGGAATTATCGGATACTACTTTGACTACTGG	CARLAGYCSGGSCYYVLRPGIIGYYFDYW	IGHV3-13	IGHJ4
TGTGCGAAAGATGAACCTACTATGATAGTAGTGGTTACAGTTGACTACTGG	CAKDEPTMIVVVTVDYW	IGHV3-23	IGHJ4
TGTGCGAAAGAGTATTACTATGATAGTAGTCCGACATTATCAAACCTTGACTACTGG	CAKEYYYDSSPTLSNLDYW	IGHV3-23	IGHJ4
TGTGCGAGAGTGCGGCCTGGGAAGATTACTATGGTTCAGGGAGCCGTTTTTTACCCCTACTTTGACTACTGG	CARVRPGKITMVQGAVFYPYFDYW	IGHV1-46	IGHJ4
TGTGCGAGAGATACTCGGCTTAGTATTGGCCTGGTCGGGGATATTGTAGTGGAGCTGGGGTCAGGGTACAACTGGTTCGACCCCTGG	CARDTRLSIGLVGDIVVELGSGYNWFDPW	IGHV1-3	IGHJ5
TGTGCGAACTTTGGTGGTAGCTGTAAAGGTGCATCTTTATACTACTTTGACTACTGG	CANFGGSCKGASLYYFDYW	IGHV3-23	IGHJ4
TGTGCAAAAGATGCCCATTGTAGTGGTGGTAGCTGCTACTCGTGGTTCGACCCCTGG	CAKDAHCSGGSCYSWFDPW	IGHV3-43	IGHJ5
TGTGCGAAACGGCGCTTTGGTGATATTGTAGTGGTGGTAGCTGCCGAGGCCATTGACTACTGG	CAKRRFGDIVVVVAAEAIDYW	IGHV3-23	IGHJ4
TGTGCGAGACTTAAGTATTACAGAGGCTCCTACGATTTTTGGAGTGGTTATGAGAGTCATGATGCTTTTGATATCTGG	CARLKYYRGSYDFWSGYESHDAFDIW	IGHV1-69	IGHJ3
TGTGCGAGAGGTGCAACTGGGGATGCTCTGGGAAATAGTGAGACGGACTGGTACTTCGATCTCTGG	CARGATGDALGNSETDWYFDLW	IGHV3-20	IGHJ2
TGTGCGAGACCGGGATCCGACCTCCTGATTACATTTGGGGGAGCCAGTGACTACTGG	CARPGSDLLITFGGASDYW	IGHV5-51	IGHJ4
TGTGGCACCGTGAGTGGTGGTAGCTGTCAAAACCGCGCCTGGTACTACTACTACTACATGGACGTCTGG	CGTVSGGSCQNRAWYYYYYMDVW	IGHV3-30-3	IGHJ6
TGTGCGAGACGGCTAAGGACTCGGAACTGGAACTACGACAATTTGTTCTCGAGATTCTATGACTACTGG	CARRLRTRNWNYDNLFSRFYDYW	IGHV7-4-1	IGHJ4
TGTGCGAGAGATGTGGGGGAGGCCGGGGGGTATAGCAGCAGCTGGTACTACGCCCCAGGATTTGACTACTGG	CARDVGEAGGYSSSWYYAPGFDYW	IGHV1-2	IGHJ4
TGTGCGAGAGACTTAAGAGCAGTGGCTGGTACTTTTTCTCTATCCTACTGG	CARDLRAVAGTFSLSYW	IGHV1-2	IGHJ4
TGTGCGAGAGTAACGATAGACCTGTATTACGATATTTTGACTGGTGTCTTTGACTACTGG	CARVTIDLYYDILTGVFDYW	IGHV3-7	IGHJ4
TGTGCAATCCATTGTAGTAGTACCTCCGTCGGTGACTACTGG	CAIHCSSTSVGDYW	IGHV6-1	IGHJ4
TGTGCGAGAGTGGACTTGAATTACGATTTTTGGAGTGGTTATTATATCTGG	CARVDLNYDFWSGYYIW	IGHV1-2	IGHJ4
TGTACTAGACATGACTCAGGGAAAATAAGGCCTTTTGACTACTGG	CTRHDSGKIRPFDYW	IGHV3-73	IGHJ4
TGTGCGTGGAAGGGTGATCTAGGGAACCTGGACGACCGTTGGAGTGGCGGCCCTAACTGGTTCGACCCCTGG	CAWKGDLGNLDDRWSGGPNWFDPW	IGHV1-3	IGHJ5
TGTGCAAGAGACCCAGCAAATGGCACCTACTGG	CARDPANGTYW	IGHV3-13	IGHJ4
TGTGCGAAAATTTGGGACCTTACATTTGGGGGAGTTATCGTTAATAAGTTTTTGGACTGG	CAKIWDLTFGGVIVNKFLDW	IGHV3-23	IGHJ4
TGTGCGAAAGGCCTGTATAACTGGAACTACTCACATCCGGGAATGGAGTCCTCGACCGAAGGGCAGTTGTTCGACCCCTGG	CAKGLYNWNYSHPGMESSTEGQLFDPW	IGHV3-NL1	IGHJ5
TGTGCGAGAGATAATCGGAGGTCTCAGAGTACCAGCTGCTATGGACTCAGTGGATTATACATGGACGTCTGG	CARDNRRSQSTSCYGLSGLYMDVW	IGHV4-61	IGHJ6
TGTGCGAGAGCAGCCCGGACAAGTATGGTTCAGGGAGTTATTATTTTTCGTGGCGACCCCTGG	CARAARTSMVQGVIIFRGDPW	IGHV3-11	IGHJ5
TGTGCGAGAGATGGTTTCGACTGGAACTACGAGATGGACGTCTGG	CARDGFDWNYEMDVW	IGHV3-53	IGHJ6
TGTGCGAAAGATCCTAAAACACCTAAGAATTGTAGTGGTGGTAGCTGCTGTCACCCAGATGCTTTTGATATCTGG	CAKDPKTPKNCSGGSCCHPDAFDIW	IGHV3-NL1	IGHJ3
TGTGCGAGACGGTTAAGACCAGCTGCTAGCGAACATTACTACTACTACATGGACGTCTGG	CARRLRPAASEHYYYYMDVW	IGHV5-51	IGHJ6
TGTGCACGGATAGCCGTGGTGGTAGCTGATTGGACCGACCACTACTACTACTACATGGACGTCTGG	CARIAVVVADWTDHYYYYMDVW	IGHV2-26	IGHJ6
TGTGCGAGAGTTAGACGGGATATTGTAGTGGTGGTAGCTGCTACGTTCGGTACCTCATCTGACTACTGG	CARVRRDIVVVVAATFGTSSDYW	IGHV3-30	IGHJ4
TGTGCGAATTCCCCCTCCAGCTGCTATAGGCCCTACTACTTTGACTACTGG	CANSPSSCYRPYYFDYW	IGHV3-23	IGHJ4
TGTGCGAGAGATTACGGGTGGCGGCTCGACTACTGG	CARDYGWRLDYW	IGHV4-59	IGHJ4
TGTGCGAGCCGTGTAGTGGTGGTAGCTGCTCACGATGCTTTTGATATCTGG	CASRVVVVAAHDAFDIW	IGHV5-10-1	IGHJ3
TGTGCGAGAGGAACGACCAGGTTCGGGGAGAGGTTTGTTGACTGGTTCGACCCCTGG	CARGTTRFGERFVDWFDPW	IGHV4-34	IGHJ5
TGTGCAGGGCAAGTGGGAGCTAACTTGGCAAACTTTGACTACTGG	CAGQVGANLANFDYW	IGHV3-13	IGHJ4
TGTGCGAGATGGGGGGTCCCTCCTAGGAGAGCCCGGACCTGGGTCCAAGGGGGTCGTACTATGATAGTAGTGGTTATTAAAGATGACTACTGG	CARWGVPPRRARTWVQGGRTMIVVVIKDDYW	IGHV1-69	IGHJ4
TGTGCGAGAGGAATAGACCGATTTGGGACCCTCATCGGTAACTGGTTCGACCCCTGG	CARGIDRFGTLIGNWFDPW	IGHV1-46	IGHJ5
TGTGCGAGAGGTATCGCTTCCAATTGTAGTGGTGGTAGCTGCTACTCCCGTCACTTTGACTACTGG	CARGIASNCSGGSCYSRHFDYW	IGHV3-7	IGHJ4
TGTGCGAGAGATCCGGTTACGATTTTTGGAGTGGTTCTTTGGACCTGGTTCGACCCCTGG	CARDPVTIFGVVLWTWFDPW	IGHV3-11	IGHJ5
TGTGCGAGAGAAAGTCGCCGGTTCAATATTGTAGTAGTACCAGCTGCTACCACCGCCTACTACTACTACTACATGGACGTCTGG	CARESRRFNIVVVPAATTAYYYYYMDVW	IGHV3-7	IGHJ6
TGTGCGAGACCGCCCGGAAAGTCAGACCCAAGTTGGAGTGGTTATTATCGGATAGTGAAAGAAGACTACTACTACTACTACATGGACGTCTGG	CARPPGKSDPSWSGYYRIVKEDYYYYYMDVW	IGHV5-51	IGHJ6
TGTGCAAGATCGGGTGGGAAAGCCCATGCAGGCCGGGCAGTGGCTGAGTCTGCTTTTGACTACTGG	CARSGGKAHAGRAVAESAFDYW	IGHV3-74	IGHJ4
TGTGCGAGCCCTGATATTGTAGTGGTGGTAGCTGCTACCCCCCTCTACTACTACTACTACTACATGGACGTCTGG	CASPDIVVVVAATPLYYYYYYMDVW	IGHV4-4	IGHJ6
TGTGCGAAAGGCTTTCAATCGGATGATTACGATTTTTGGAGTGGTTATTATACCTACTTTGACTACTGG	CAKGFQSDDYDFWSGYYTYFDYW	IGHV3-23	IGHJ4
TGTGCGAGACTCCCCTTGACTACGGTGCGCCTAAGGCCATTATACTGGGTCCTCTGGATGCCTCTAAGGGACTACTGG	CARLPLTTVRLRPLYWVLWMPLRDYW	IGHV5-51	IGHJ4
TGTGCCACCCGTTGCCAGCTGCTACGATCGGACTACTGGTACTTCGATCTCTGG	CATRCQLLRSDYWYFDLW	IGHV6-1	IGHJ2
TGTGCGAGAGATCCGGGTGTACAGTGGCTGGTACGGCCTTGG	CARDPGVQWLVRPW	IGHV3-11	IGHJ5
TGTGCGGAGTGCTCCCGTATTACGATTTTTGGAGTGGTTATTGACATCTGGTTCGACCCCTGG	CAECSRITIFGVVIDIWFDPW	IGHV3-66	IGHJ5
TGTGCGAAAGTCCCCTGGGGCTACGGTGGTCTTCGTTCTAACTGGTTCGACCCCTGG	CAKVPWGYGGLRSNWFDPW	IGHV3-NL1	IGHJ5
TGTGCGAGCCTTGTAATATTGTACTGGTGGTGTATGCTAGGCAACTGGTTCGACCCCTGG	CASLVILYWWCMLGNWFDPW	IGHV3-20	IGHJ5
TGTGCGAGAGGCTCCCCCGGCAGCAGCTGGGTGAAGGGCCGGTACTACTACTACTACTACATGGACGTCTGG	CARGSPGSSWVKGRYYYYYYMDVW	IGHV4-34	IGHJ6
TGTGCGACGACGGGGCGCACCGCCCCGGTTCGGGGAGTTGACCGATTGACCCACAACTGGTTCGACCCCTGG	CATTGRTAPVRGVDRLTHNWFDPW	IGHV3-23	IGHJ5
TGTACTAACATCCAGCACGGCTACGTGGGATCCTTTGACTACTGG	CTNIQHGYVGSFDYW	IGHV3-73	IGHJ4
TGTGCGAGAGATGCGGAATCTCCAAGAGCAGCAGGGAACGACTACTGG	CARDAESPRAAGNDYW	IGHV1-69	IGHJ4
TGTGCGAGAGATGGGGTCAGACATCGAGATTGTAGTGGTGGTAGCTGCAGGGATGCTTTTGATATCTGG	CARDGVRHRDCSGGSCRDAFDIW	IGHV1-46	IGHJ3
TGTGCGAGAGAGTTGAAAAATCATTGTAGTAGTACCAGCTGCTATGAAAGGTGGATGGACGTCTGG	CARELKNHCSSTSCYERWMDVW	IGHV1-3	IGHJ6
TGTGCACGGATACGCCCGGGGGTTTGTAGTAGTCGTATAACCAACTGGTTCGACCCCTGG	CARIRPGVCSSRITNWFDPW	IGHV2-70	IGHJ5
TGTACCAATGGGACCTCCAGCCCCCTGATAGCAGCGGGCAGCCCAGCTTTTGATATCTGG	CTNGTSSPLIAAGSPAFDIW	IGHV3-15	IGHJ3
TGTGCGAAAGCCTGTGTGGATATTGTACTGGTGGTGTATGCTATAAGGCCAAGGGGCTTGAACTGGTTCGACCCCTGG	CAKACVDIVLVVYAIRPRGLNWFDPW	IGHV3-NL1	IGHJ5
TGTGCGAAAGATCGCAGCGCTCGGAACACGGCCCTGTATAGCAGCAGCTGGTACCCCTACTGG	CAKDRSARNTALYSSSWYPYW	IGHV3-NL1	IGHJ4
TGTGCAAGAGGGAGTTTCGGTCGTATTACTATGATAGTAGTGGTTATTACGGGGCCCTTTGACTACTGG	CARGSFGRITMIVVVITGPFDYW	IGHV3-13	IGHJ4
TGTGCGAGACGGACTACGATTTTTGGAGTGGTTACGCGGGTCGACGATGGAACACTGTACACCATTATTGCCCTTGCGTTCCACTACTACTACTACATGGACGTCTGG	CARRTTIFGVVTRVDDGTLYTIIALAFHYYYYMDVW	IGHV1-2	IGHJ6
TGTGCGAGAGAGGATGGATATTGTAGTAGGAAAGGTAGCTACTGG	CAREDGYCSRKGSYW	IGHV7-4-1	IGHJ4
TGTGCGAGGCGGTCTTTTGTAGTAGTACCAGCTGCTATATGCTACTGG	CARRSFVVVPAAICYW	IGHV1-18	IGHJ4
